#setName = words_en_da_cc
#sideOneTitle = ENG
#sideTwoTitle = DAN
cabaret = kabaret
cabbage = kål
cabin = hytte, kahyt
cabinet = skab
cable = kabel
cactus = kaktus
café = café
cage = bur
cake = kage
calculate = beregne, kalkulere
calendar = kalender
calf = kalv, læg
call = kalde, råbe
call on = besøge
calm = rolig
camel = kamel
camera = kamera
camping ground = camping
camping site = camping
canal = kanal
canary = kanariefugl
cancel = abbestellen, sende afbud, aflyse
candidate = ansøger, kandidat
cannon = kanon
can opener = dåseoplukkner
canteen = feltflaske
cap = kasket, hue
capable = dygtig
captain = kaptajn
capture = fange
car = bil, automobil
carburettor = karburator
cardboard = karton
cardiac = hjerte-, hjertelig
care = sorg
care about = bryde sig om
care for = behandle
careful = forsigtig
caress = stryge
carnival = karneval
carousel = karrusel
carp = karpe
carpet = gulvtæppe, tæppe
carriage = vogn, waggon
carrot = gulerod
carrousel = karrusel
carry = bære
cartridge = patron
case = affære, anliggende, tilfælde
casino = kasino
casserole = kasserolle
cassette = kassette
castle = slot, tårn
cat = kat
catalogue = katalog
catarrh = katar
catastrophe = katastrofe
catch = fange, fangst
caterpillar = kålorm
cathedral = domkirke, katedral
cauliflower = blomkål
cause = årsag
caution = advare, forsigtighed
cautious = forsigtig
cave = grotte
caviar = kaviar
cease = ophøre
cede = give efter
ceiling = loft
celebrate = fejre
celebrating one's birthday = fejre fødselsdag
celebration = fest, højtid
celebrity = star
cell = celle
cellar = kælder
cement = cement
cemetery = kirkegård
censor = censur
censure = kritisere
centennial = århundrede
centimetre = centimeter
central = central
central heating = centralvarme
centre = centrum
century = århundrede
ceremony = ceremoni
certain = sikker
certainly = nok
certificate = aktstykke, attest
chain = kæde
chair = stol
chairman = præsident
chalice = bæger
chalk = kridt
challenge = udfordre
chamber = værelse
chamois = vaskeskind
chamois leather = vaskeskind
champagne = champagne
chance = tilfældig, tilfælde, anledning, lejlighed
change = ændring, småpenge, forandre, veksle, ændre
channel = kanal, rør
chaos = rod
chapter = kapitel
character = karakter, natur, tegn
characteristic = ejendommelig
charge = byrde, last
charity = almisse, barmhjertighed
charm = ynde
charming = fortryllende, rar
chase = forfølge, jage
chasm = afgrund
chat = sludre, snakke
chatter = sludre, snakke
chauffeur = chauffør, fører
cheap = billig
cheat = bedrage
check = kontrolere, bankanvisning
checkers = damspil
check up on = kontrolere
cheek = kind
cheerful = alvorlig, munter
cheers = skål
cheese = ost
chemist = apoteker, kemiker
chemistry = kemi
chemist's shop = apotek
cheque = bankanvisning
cherry = kirsebær
chess = skak
chest = bryst, kiste, kommode
chestnut = kastanie
chew = tygge
chicken = høne
chicory = julesalat
chief = chef, overordnet
child = barn
chilly = kold
chimney = skorsten
chin = hage
China = Kina
Chinaman = kineser
Chinese = kinesisk, kineser
chisel = mejsel
chlorine = klor
chocolate = chokolade
choice = valg
choke = kvæle
cholera = kolera
choose = vælge
chord = akkord
chorus = kor
Christian = kristen
Christianity = kristendom
Christian name = fornavn
Christmas = jul
chromium = krom
chuck = stryge
church = kirke
church-building = kirke
cider = æblevin
cigar = cigar
cigarette = cigaret
cinder = aske
cinema = biograf
circle = cirkel, selskab
circumference = omfang
circumstances = tilstand
circus = cirkus
citadel = citadel
cite = citere
citizen = statsborger
city = by
city hall = rådhus
civil = civil
civilian = civil
civil status = civilstand
clarify = forklare
class = klasse, kursus
classic = klassisk
classical = klassisk
claw = klo
clay = ler
clean = ren, gøre rent, rense
cleanliness = renhed
cleanse = gøre rent, rense
clear = lys, klar, tydelig
clergyman = gejstlig, præst
clerk = kontorist
client = køber, kunde
climate = klima
climb = klatre
climber = Alpinist
climber's hut = alpehytte
clip = klippe
cloakroom = garderobe
clock = ur
close = lukke, intim, nær, nærheden
closed = lukket
closet = skab
clothes = klæder, tøj
clothespeg = tøjklemme
clothespin = tøjklemme
clothing = klæder, tøj
cloud = sky
clown = klovn
club = klub, selskab
clutch = gribe, kobling
coach = vogn, waggon
coach-work = karosseri
coal = kul
coarse = ru
coast = kyst
coat = frakke
cock = hane
cocoa = kakao
coconut = kokosnød
cod = kabliau, torsk
coddle = forkæle
codfish = kabliau, torsk
coffee = kaffe
coffee-house = café
coffee-pot = kaffekande
cognac = cognac
cogwheel = tandhjul
cohabit = bo sammen
coir = kor
cold = kold, kulde, forkølelse
collar = flip
colleague = kollega
collect = samle
collection = gruppe, kollekt, samling
colony = koloni
colossal = kolossal
colour = farve, kulør
column = kolonne
comb = kæmme, kam
combination = kombination
combustion = forbrænding
come = afstamme, komme
come about = blive, forekomme, ske
come across = møde, træffe
comedy = komedie
come to a halt = standse
comfort = komfort, trøste
comfortable = bekvem, komfortabel
comforter = støvsuger
comic = komisk, sjov
comical = komisk, sjov
comma = komma
command = befaling, kommando
commence = begynde
commencement = begyndelse
commend = rose, anbefale
commerce = handel
committee = komité
commodity = artikel
common = fælles, almindelig, ordinær, vanlig, sædvanlig, vulgær
communication = beretning, bekendtgørelse
communication-cord = nødbremse
companion = kammerat, samlever
company = firma, kompagni, selskab
compare = jævnføre, sammenligne
comparison = sammenligning
compartment = afdeling, fag, kupé
compass = kompas
compassion = medlidenhed
compatriot = landsmand
compel = tvinge
compensate = belønne
compensation = belønning
compete = konkurrere
competition = konkurrence
complain = klage
complaint = besvær
complete = fuldstændig, fuld
composer = komponist
composing = montage
comprise = indeholde
compulsory = nødt
comrade = kammerat
concave = hul
conceal = gemme, skjulle
concede = indrømme
conceited = forfængelig
concentrated = tæt
concept = begreb, opfattelse
concern = angå, koncern, sorg
concerned = pågældende
concerning = verdrørende, af, om, over, til, vid
concert = koncert
concert-room = koncertsal
conclusion = resultat, udfald
concord = akkord
concrete = beton
concurrence = akkord
condemn = dømme
condition = betingelse, tilstand
condolences = deltagelse
condom = kondom
conduct = føre, opførsel
conduct oneself = opføre sig
conductor = chauffør, fører
confectionery = konditori
confess = bekende, skrifte, tilstå
confession = bekendelse, skriftemål
confidence = tillid
confine = indskrænke
confirm = bekræfte
conform = passe
confuse = forvirre
confusion = rod
congratulate = gratulere, lykønske
congregate = forsamles
congress = kongres
connect = forbinde, koble til, binde
connection = forbindelse
connect up = forbinde, koble til
conquer = erobre
consciousness = bevidsthed
consent = samtykke, enighed
consequence = følge
conservative = konservativ
conserve = beholde, konservere
consider = tage hensyn til, betragte, se på
consignee = modtager
consistency = følge
consolation = trøst
console = trøste
constant = stadig
construct = bygge, konstruere
consul = konsul
consulate = konsulat
contact = kontakt
contain = indeholde
container = beholder, potte
contempt = foragt
contented = tilfreds
contention = påstand
contents = indhold
continent = fastland, kontinent, verdensdel
continual = stadig
continuation = fortsættelse
continue = vare, fortsætte
continuous = uafbrudt
contractor = bygmester
contradistinction = modsætning
contrary = modsat
contrast = modsætning
contribute = bidrage
control = styre, beherske, regere
control oneself = beherske sig
convention = kongres
converge = løbe sammen
conversance = bekendtskab
conversation = konversation
conversion = ændring
conviction = overbevisning
convince = overbevise, overtyde
co-occupant = samlever
cook = koge, kokkepige
cookie = kiks
cool = afkøle, kølig
cool down = afkøle
cooling = afkøling
Copenhagen = København
copper = kobber
copy = eksemplar, afskrive, kopiere, kopi
cord = reb, snor
cordial = hjertelig, hjerte-
core = kærne
cork = prop
corkscrew = proptrækker
corn = majs
corner = hjørne
corporation = fagforening
corpulent = tyk
corral = hestestald
correct = korrigere, rette, rigtig
corridor = gang, korridor
corridor train = eksprestog
corroborate = bekræfte
cost = koste
costly = dyr, værdifuld
costume = dragt
cotton = bomuld
cotton-wool = vat
couch = sofa
cough = hoste
counsel = advokat, sagfører, råde, råd
count = greve, beregne, kalkulere, tælle
countermand = abbestellen, sende afbud
count in = addere
country = land
countryside = land
coupé = kupé
couple = ægtepar
coupon = kupon
courage = mod
courageous = modig, tapper
courier = ilbud
course = kursus, fad
court = elske, gårdsplads
courteous = høflig
courtyard = gårdsplads
cousin = kusine, fætter
cover = indbinding, dække, låg, gennemse
cow = ko
cowardice = fejghed
crab = krabbe
crack = spalte
cradle = fødested
crawl = krybe
crayfish = krebs
crazy = sindssyg
cream = fløde
credit = kredit
creep = krybe
crevice = spalte
crew = mandskab
crime = forbrydelse
criticism = kritik
criticize = kritisere
crockery set = service
crocodile = krokodille
cross = vred, kors
cross roads = korsvej
crow = krage
crowd = mængd
crown = krone
crucifix = krucifiks
cruel = grusom
crush = knuse
cry = råb, græde
cry out = skrige
crystal = krystal
cube = terning
cuckoo = gøg
cucumber = agurk
cuff = manchet
culture = kultur
cultured = klog
cup = kop
cupboard = skab
cure = behandle
curious = nysgerrig
currant = ribs, solbær
currency = valuta
current = aktuel, strøm, nærværende
currently = nu for tiden, nu til dags
curse = bande
curtail = forkorte
curtain = gardin
curve = sving
curved = bøjet
cushion = pude
cuss = bande
custom = vane, sædvane
customary = almindelig, vanlig, sædvanlig
customer = kunde
customs = told
cut = slå, afbryde, koble fra, klippe, skære
cut a connection = afbryde, koble fra
cutlet = karbonade
cycle = cykel
cylinder = cylinder
cynical = kynisk
cypres = cypres