#setName = words_en_es_cc
#sideOneTitle = ENG
#sideTwoTitle = SPA
cabaret = cabarét
cabbage = col
cabin = cabana, camarote
cabinet = armario
cable = cable
cab-stand = aparcamiento de taxis
cactus = cacto
café = café
cafetaria = cafetería
cake = queque
calabash = calabaza
calculate = calcular, computar
calf = ternero, pantorrilla
call = llamar
call box = cabina telefónica
call on = visitar
calm = quieto, silencio, sosegado, tranquilo, calmar, sosegar
calm down = calmarse, sosegarse
calorie = caloría
cambric = batista
camel = camello
camera = cámara, cámara de películas
camp = acampar
camping ground = campamento, camping, terreno del camping
camping site = campamento, camping, terreno del camping
camp of tents = campamento
camp out = acampar
can = lata
Canada = Canadá
canal = canal
Canary Islands = Islas Canarias
cancel = anular, contramandar
Candlemas = Candelaria, Purificación
candlestick = candelero
cane = palo, junco
can opener = abrelatas
Cantabrian = cantábrico
cap = gorro, birrete
capability = capacidad, disposición
capable = capaz, hábil
capital = capital
capital city = capital
capitulate = capitular
capsule = cápsula
capture = asir, coger
car = automóvil, coche
carafe = garrafa
carburettor = carburador
card = tarjeta
care = cuidar, cuidado
care about = cuidarse de
career = carrera
care for = curar
careful = circunspecto, precavido, prudente
careless = descuidado
caress = acariciar , caricia
caressing = mimoso, zalamero
carnation = clavel
carnival = carnaval, carnestolendas
car park = aparcamiento
carpet = alfombra
carriage = coche
carrier cycle = tricar
carrier tricycle = tricar
carrion = carroña
carrot = zanahoria
carry = llevar
cart = carro
case = asunto, particular, caso
cash = contante
cashier's stand = caja
casserole = cacerola
Castile = Castilla
Castillian = castellano
castle = castillo, torre
cat = gato
catalogue = catálogo
catch = asir, coger, acertar
catching = contagioso
catechism = catecismo
catering = abastacimiento
caterpillar = oruga
cathedral = catedral
cathode tube = tubo receptor
catholic = católico
Caucasus = Cáucaso
cauliflower = coliflor
cause = causar, instigar, maquinar, ocasionar, producir, causa, dar lugar a
cause pain = afligir, entristecer
cause pain to = afligir, entristecer
cause to take place = dar lugar a, ocasionar
caution = avisar
cautious = circunspecto, precavido, prudente
cavalier = caballero
cavalry = caballería
cave = cueva, bache, hueco
cavern = cueva
cavity = bache, hueco
ceaselessly = continuamente
cede = abandonar, ceder
celebrate = celebrar, celebrar una fiesta
celebrating one's birthday = celebrar su cumpleaños
celebration = fiesta
celery = apio
cell = célula
cellar = sótano
cello = violoncelo
cemetery = campo santo, cementerio
censor = censurar, censura
censurable = censurable, reprobable
censure = censurar, criticar, desaprobación, reprobación
centennial = siglo
centimetre = centímetro
central = central
central heating = calefacción central
centre = centro
century = siglo
ceremony = ceremonia
certain = cierto
certainly = ciertamente
certificate = acta, certificado, certificación
chain = cadena
chain of mountains = cordillera, sierra
chair = silla
chalk = greda
chamber = cuarto, habitación
chamber pot = orinal
champagne = champaña
chance = acaso, acontecimiento, suerte
change = monedas, cambiar, mudar, combiar, cambio
channel = canal
chaos = caos
chaotic = caótico
character = indole, naturaleza, seña
charcoal = carbón
charge = gastos, acusación, cargo, carga
chariot = carro
charitable = misericordioso
charity = limosna, misericordia
charm = embelesar, encantar, encanto, gracia
charming = bonito, encantador, lindo
chase = perseguir, cazar
chasm = abismo, despeñadero, precipicio
chastity = virtud
chat = charlar
chatter = charlar
chauffeur = chauffeur, chófer, mecánico
cheap = barato
cheat = embustero, engañar
check = contener, reprimir, controlar, registrar, revisar, cheque
checked = a cuadros
checker = inspector
checkers = damas, juego de damas
check up on = controlar, registrar, revisar
cheek = mejilla
cheer = animar, incitar
cheers = a su salud
cheese = queso
chef = jefe
chemist = boticario, farmacéutico, químico
chemistry = química
chemist's shop = botica, farmacia
cheque = cheque
cheque-book = talonario
chequered = a cuadros
cherry = cereza
cherry-tree = cereso
chest = pecho, arca, caja, aparador
chestnut = castaña
chestnut-tree = castaño
chew = masticar
chewing-gum = chicle
chic = elegante
chick = pollo
chicken = pollo, gallina
chicory = achicoria
chief = amo, capitán, caudillo, comandante, dueño, jefe, patrón, principal
chief- = archi-, arzo-
chiefly = sobretodo, principalmente
child = niño
child's bed = camita de niño
Chile = Chile
Chilean = chileno
Chilean woman = chilena
chilli = ají
chilly = frío
chimerical = hueco
chin = barba
China = China
Chinaman = chino
Chinese = chino
chippings = cascajo
chisel = cincel
chive = cebollana
chlorine = cloro
chocolate = chocolate
choice = elección
choke = sofocar
cholera = cólera
choose = elegir, escoger
chord = acorde, acuerdo, concordación, convenio
Christ = Cristo
Christian = cristiano
Christianity = cristianismo
Christmas = Navidad
chuck = acariciar, caricia
chunk = bola
church = iglesia
church-building = iglesia
cider = sidra
cigar = cigarro
cigarette = cigarillo
cinder = ceniza
Cinderella = Cenicienta
cinema = cine
cipher = cifra
circle = círculo
circuit = circuito
circular = circular
circumcision = circuncisión
circumference = perímetro
circumstance = condición
circus = circo
cistern = tanque
citadel = ciudadela
citation = cita, citación
cite = citar, mencionar
city = ciudad, población
city hall = ayuntamiento
civil = civil
civilian = civil
civilization = civilización
claim = derecho, pretensión
clap = aplaudir
clapper = badajo
clarify = desarrollar, explicar
class = clase, cursillo, curso
classify = clasificar
clause = cláusula
claw = garra
clay = arcilla
clean = limpio, puro, limpiar
cleanliness = limpieza
cleanse = limpiar
clear = claro, evidente
clear away = recoger la mesa
clergyman = cura
clerk = dependiente, empleado
clever = ágil, experto, diestro, hábil
client = cliente, comprador, parroquiano
clientèle = clientela
climate = clima
climb = trepar, subir, ascender, escalar, subir a
climber's hut = refugio
clip = cortar
clippings = desechos, detrito
clique = trinquete
cloak = abrigo
cloakroom = guardarropa
clock = reloj
clod = bola
close = cerrar, cómodo, estrecho, entrante, próximo, cerca
closed = cerrado
closet = armario
cloth = tela
clothe = vestir
clothes = ropa
clothes-press = armario ropero
clothing = ropa
cloud = nube
club = club
clutch = agarrar, asir, coger
coach = coche
coach-work = carrocería
coarse = áspero, desigual
coast = costa
coat = abrigo
cocaine = cocaína
cock = gallo
cockroach = cucaracha
cocoa = cacao
cod = bacalao
code = código
codfish = bacalao
coffee-house = café
coffee-pot = cafetera
cognac = coñac
coin = moneda
cold = frío, resfriado
collar = cuello
colleague = colega, compañero
collect = recoger
collection = grupo, colecta
college = colegio
collide = atropellar
collide with = abordar, chocar kun
collision = abordaje, atropallamiento, choque, colisión
Cologne = Colonia
Colombia = Colombia
colony = colonia
colossus = monstruo
colour = color
Columbus = Colón
column = columna
comb = peinar, peine
combination = combinación
come = descender, venir
come about = acontecer, hacerse, realizarse, tener lugar
come across = hallar, encontrar
come afterwards = venir después
come back = volver
come close = acercarse, aproximarse
come closer = acercarse, aproximarse
come later = venir después
come on = acercarse, aproximarse
come to a halt = parar
come to an end = expirar, terminarse
come together = juntarse
come up to = corresponder al
comfort = anchas, consolar
comfortable = agradable
coming = natural, originario, proveniente
coming from = procedente de
command = capitanear, mandato, mando
commander = comandante
commence = comenzar, decentar, empezar, enteblar, principiar
commencement = comienzo, origen, principio
commend = alabar, certificar, encarecer, ensalzar, recomender
commerce = comercio
commission = comisión
commit aggression = acometer, atacar
committee = comité
commodity = artículo
common = común
commonplace = común, trivial
commotion = escandálo
communicate = comunicar, informar, contagiar, inficionar
communication = communicación, noticia, noticias, publicación
communication-cord = freno de emergencia
communion = comunión
communist = comunista
community = municipio
company = firma, compañía
compare = comparar
compartment = departamento
compass = brújula
compel = forzar, obligar
compensate = compensar, indemnizar, recompensar
compensation = recompensa
compete = competir
competition = competencia, concurso
complain = quejarse
complaint = acusación, cargo, pleito, queja
complete = cabal, completo, completar, llenar, lleno
completed = acabado, terminado
completely = completamente
complex = complekso
compliment = cumplimiento
component = ingrediente
composed = dueño de sí mismo
composer = compositor
comprise = contener
compulsory = obligatorio
computer = computador, ordenador
concave = hueco
conceal = ocultar
conceited = hueco
concept = idea, noción
concern = importancia, concernir, cuidado
concerned = dicho, en cuestón
concerning = en cuanto a, por lo tocante a, respecto de
concert = concierto
concise = conciso, sucinto
conciseness = concisión
conclude = despachar
conclusion = conclusión
concord = acorde
concrete = hormigón
concurrence = acorde, acuerdo, concordación, convenio
condemn = condenar, desaprobar, reprobar
condemnable = censurable, reprobable
condemnation = desaprobación, reprobación
condition = condición
condom = condom, preservativo
conduct = guiar, conducir, dirigir
conduct oneself = conducirse
conductor = chófer
confectioner = pastelero
confectionery = pastelería
conference = conferencia
confess = confesar, declarar
confession = confesión, declaración
confidence = confianza
confine = limitar
confined = limitado
confined to one's bed = encamado
confirm = confirmar
confirmation = confirmación
confiscate = confiscar, embargar
conflagration = incendio
conflict = conflicto
confront = oponerse
congenital = innato
congentital = innato
congratulate = felicitar
congress = congreso
connect = comunicar, liar, ligar
connection = comunicación, enlace, empalme, cinta, lazo
connect up = comunicar
conquer = conquistar
consecutively = sucesivamente
consent = acordar, declarar, declaración
consequence = consecuencia
conservation = conservación
conservative = conservador
conserve = conservar, guardar
consider = considerar, contemplar, tomar en consideración, mirar, observar, ver
considerable = considerable, notable
consideration = consideración, contemplación
consignee = destinatario
consistency = consecuencia
consistent = consecuente
consist of = componerse
console = consolar
constant = continuo
constantly = continuamente, siempre
constipation = constipado
constitution = constitución
construct = construir, edificar
consul = cónsul
consulate = consulado
consultation = reflexión, consulta
consume = consumir
consumer = consumidor
contact = contacto
contagious = contagioso
contain = contener
container = caja, estuche, jarro, olla
contaminated = contagiado
contempt = desprecio
contented = contento
contest = concurso
continual = continuo
continually = continuamente, siempre
continue = continuar, durar
continuous = continuo
continuously = continuamente, siempre
contract = contrato, destajo
contractor = destajista
contradict = contradecir
contralto = alto
contralto voice = alto
contrast = contraste
control = contener, gobernar, subyugar, refrenar, reprimir
controller = inspector
convention = congreso
conversance = notoriedad
converse = conversar
conversion = conversión
convert = convertir
convey = alargar, entregar
convince = convencer
cook = cocinar, cocinera, cocinero
cookie = bizcocho, galleta
cool = enfriar, fresco
cool down = enfriar
copper = cobre
copy = copiar, trasladar, copia, traslado
cord = cuerda
cork = corcho
corkscrew = sacacorchos
corn = callo, maíz
corner = esquina
corpulent = grueso
Corpus Christi = día del Corpus
correct = correcto, corregir, preciso
correspond = cartearse, empalmar
correspond to = corresponder al
corridor = pasillo
corridor train = tren corrido
corroborate = confirmar
corruption = corrupción, deterioración, putrefacción
Corsica = Córcega
cosmetic powder = polvos
cost = costar, gastos
Costa Brava = Costa Brava
Costa Rica = Costa Rica
costly = caro
costume = traje
cot = camita de niño
coterie = trinquete
cotton = algodón
couch = dyschatell, canapé
cough = toser
counsel = abogado, anunciar, aconsejar, consejo
counsellor = consejero
count = entrar en cuenta, calcular, computar, contar
count down = deducir
counter = mostrador
countermand = anular, contramandar
counterpane = colcha de cama
count in = sumar
country = campo, país
countryside = campo
coupé = departamento
couple = embragar
coupon = cupón
courage = valor, virtud
courageous = bravo
courgette = calabacín
course = cursillo, curso, plato
court = grave, patio
courteous = cortés
courtyard = grave, patio
cousin = prima, primo
cover = encuadernación, cubrir, tápa, neumático, forrar, vestir, recorrer
covered = cubierto de verdor
covered with blood = ensangrentado
coverlet = colcha de cama
covet = codiciar
covetousness = deseo
cow = vaca
crab = cangrejo
crack = grieta, hendedura, quebraja
cradle = cuna, patria
craft = astucia
craftiness = astucia
cramped = estrecho
crash into = abordar, chocar kun
crayfish = cangrejo
ccream = fla, crema, desnatar
create = creer
credit = haber
credit card = tarjeta de crédito
Crete = Creta
crevice = grieta, hendedura, quebraja
crew = tripulación
crime = crimen
crisis = crisis
criticism = censura, crítica, reparo
criticize = censurar, criticar
crockery = cerámica, loza
crocodile = cocodrilo
cross = cruz, atravesar
cross roads = cruce
crown = coronar
crude = crudo
crude oil = petróleo
crumble = derruirse, desmoronarse
crumble away = derruirse, desmoronarse
crumble off = derruirse, desmoronarse
cry = grito, llorar
cry out = gritar
Cuba = Cuba
Cuban = cubano
cubic = cubano
cucumber = pepino
cuddlesome = mimoso, zalamero
cuddly = mimoso, zalamero
cul-de-sac = camino sin salida
cultivate = cultivar
culture = cultura
cunning = astucia
cup = taza
cupboard = armario
Curaçao = Curazao
cure = curar
curious = curioso
currant = grosella
currant juice = jugo de grosellas
currency = valuta
current = actual, corriente, contemporáneo
currently = ahora, al presente, hoy día
curry = arrurruz
curse = jurar
curtain = cortina
curve = curva
cushion = almohada
cuss = jurar
custom = costumbre
customer = cliente, comprador, parroquiano
customs = aduana
cut = cortar
cut into = decentar, encentar
cutlet = chuleta
cut off = cortar
cuttings = desechos, detrito
cycle = bicicleta, ciclo
cycle-bag = bolsa para bicicletas
cyclone = ciclón
cylinder = cilindro
cymbal = címbalo, platillo
cynical = cínico
cypres = ciprés
Czech = checo
Czechoslovakia = Checoeslovaquia