#setName = words_en_fr_cc
#sideOneTitle = ENG
#sideTwoTitle = FRE
cabbage = chou
cabin = cabane, chaumière, hutte, cabine, cabine de bateau
cabinet = armoire
cable = câble
cactus = cactus
cadaver = cadavre
cadger = parasite
cadre = cadre
Caesar = César
caesium = césium
café = café
cage = cage
Cain = Caïn
Cairo = Le Caire
cake = gâteau
Calabria = Calabre
calamity = fléau, plaie
calamus = calame, jonc odorant, lis des marais
calcium = calcium
calculate = calculer, compter
calendar = calendrier
calf = veau, mollet
California = Californie
Californian = Californien
call = nommer, appeler
call at = faire escale à, s'arrêter à, toucher à
call at ...'s house = passer chez
call box = cabine téléphonique
caller = visiteur
call on = passer chez, visiter
calm = quiet, repos, calme, paisible, tranquille, abattre, rassurer
calmness = repos
Calvary = Calvaire
Calvin = Calvin
Cambodia = Cambodge
Cambodian = khmer, khmer, Cambodgien, Khmer
Cambodian woman = Cambodgienne
cambric = batiste
camel = chameau
camera = caméra
Cameroon = Cameroun, camerounais
campaign = campagne
camping ground = camp
camping site = camp
camp of tents = camp
Canaan = Chanaan
Canada = Canada
Canadian = Canadien, Canadien
Canadian woman = Canadienne
canal = canal
canary = canari
Canary Islands = îles Canaries
cancel = abroger, annuler, supprimer
cancer = cancer
candidate = candidat
Candlemas = Chandeleur
candy = friandise
cane = bâton, canne, roseau
canker = cancer
cannon = canon
canopy = baldaquin
cap = casquette, bonnet, toque
capable = apte à, capable
cape = cap
caper = gambader
capital = capital, fonds
capital letter = majuscule
caprice = caprice
Capricorn = Capricorne
captain = capitaine
capture = attraper, capturer, saisir
car = auto, automobile
carbon = carbone
card = carte
cardboard = carton
cardiac = cordial
care = avoir soin de, se soucier de, s'occuper, veiller à, soin, souci
care about = se soucier de, s'occuper de
care for = guérir, soigner
careful = prudent
careless = étourdi, négligent, distrait
carelessness = négligence
caress = caresser, caresse
caressing = tendre
carnation = oeillet
carp = carpe
carp at = chicaner
Carpathian mountains = Carpates
Carpathians = Carpates
carpet = tapis
carriage = wagon
carrot = carotte
carry = porter
carry away = entraîner
cart = char, chariot, charrette
Carthage = Carthage
Carthaginian = Carthaginois
carve = buriner, ciseler, tailler
case = affaire, chose, cas
cashier = trésorier
cashier's stand = caisse
Caspian Sea = mer Caspienne
Cassandra = Cassandre
casserole = casserole
cassette = cassette
cast = fondre
Castile = Castille
Castilian = Castillan
Castillian = castillan
castle = château, tour
cast off = précipiter
cat = mégère, peau de vache, rosse, chat
catarrh = rhume
catastrophe = catastrophe, désastre
catch = s'allumer, attraper, capturer, atteindre, frapper, parvenir, saisir
category = catégorie
catering = ravitaillement
caterpillar = chenille
cathedral = cathédrale
Cato = Caton
Caucasus = Caucase
cauldron = chaudron
cauliflower = chou-fleur
cause = faire, rendre, déterminer, entraîner des conséquences, cause, causer, procurer, situer
cause to take place = causer, procurer, situer
caution = alerter, avertir
cautious = prudent
cavalier = chevalier
cave = grotte, creux
cavity = creux
caw = croasser
cease = cesser
ceaselessly = continuellement
cedar = cèdre
cede = abandonner, abdiquer, céder, reculer
ceiling = plafond
celebrate = célébrer, fêter
celebration = fête
celebrity = star, vedette
celery = céleri
cell = cachot, prison, cellule
cellar = cave
cello = violoncelle
Celt = Celte
Celtic = celte, celtique
cement = ciment
cemetery = cimetière
censor = censurer
censure = critiquer, reprendre
centennial = siècle
centipede = myriapode
Central African Republic = République centraficaine
Central America = Amérique centrale
centre = centre
century = siècle
Cerberus = Cerbère
ceremonious = solennel
ceremony = cérémonie
Ceres = Cérès
certain = assuré, certain, sûr
certainly = assurément, certainement, sûrement, d'abord, certes, si
certainty = assurance
certificate = acte, document, pièce, titre, témoignage
cession = abandon
Ceylon = Ceylan
Ceylonese = Ceylanais
Chad = Tchad
chain = chaîne
chair = chaise, siège
chairman = président, speaker
Chaldea = Chaldée
Chaldean = Chaldéen
chalk = craie
challenge = contester, disputer
chamber = chambre, local, pièce, salle
chamois = chamois
champagne = champagne
champion = champion
chance = accidentel, hasard, occasion, chance
change = changer, monnaie, transformation
change of address = changement d'adresse
channel = canal, tube, tuyau
Channel Islands = Iles normandes
chanson = chanson
chaos = chaos
chap = individu
chaperon = accompagnatrice, chaperonner
chaplain = aumônier
chapter = chapitre
character = caractère, nature, personnage, signe, témoignage
charge = accusation, plainte, charger
chariot = char, chariot, charrette
charitable = sensible, indulgent
charity = aumône, compassion
charlatan = charlatan
charm = amulette, ravir
charming = charmant, gentil, mignon, ravissant
Charybdis = Charybde
chase = amener à, faire avancer, pourchasser, pousser, poursuivre, chasser
chase away = renvoyer, repousser
chasm = abîme, gouffre
chaste = chaste, continent
chat = babil, babilage, bavardage, babiller, bavarder
chatter = babiller, bavarder
chatterbox = babillard, bavard
chauffeur = chauffeur
cheat = tricher, tromper, mystifier, rouler
cheated = déçu
check = réprimer, retenir, bride, surveiller, vérifier, chèque
check up on = surveiller, vérifier
cheek = joue
cheerful = gai, joyeux
cheers = à la vôtre, à votre santé
cheese = fromage
chef = chef
chemist = apothicaire, pharmacien, chimiste
chemistry = chimie
chemist's shop = pharmacie
cheque = chèque
cherry = cerise
cherry-tree = cerisier
chess = échec
chest = poitrine, sein, bac, caisse, coffre, commode
chestnut = châtaigne, marron
chestnut-tree = châtaignier, marronnier
chew = mâcher
chewing-gum = chewing-gum
chew the cud = ruminer
chick = poussin
chicken = poulet, poussin, poule
chief = dominant, principal, chef
chiefly = particulièrement, principalement, surtout
child = enfant
childbed = lit d'accouchement
Chile = Chili
Chilean = Chilien
chilly = froid
chimera = chimère
chin = menton
China = Chine
Chinaman = Chinois
Chinese = Chinois, Chinoise
Chinese lady = Chinoise
Chinese woman = Chinoise
chirp = gazouiller, pépier
chisel = buriner, ciseler, tailler, ciseau
chive = ciboulette
chlorine = chlore
chocolate = chocolat
choice = choix
choke = étouffer, suffoquer
cholera = choléra
choose = adopter, choisir, désigner, opter
chop = hacher, tailler
chord = accord
chorus = choeur
chrestomathy = anthologie
Christ = Christ
christen = baptiser
christening = baptême
Christian = chrétien
Christian name = prénom
chromium = chrome
chuck = caresser, caresse
chunk = boule
chunk of wood = bûche
church = église
church-building = église
churn = baratter
Cicero = Cicéron
cider = cidre
cigar = cigare
cigarette = cigarette
cinder = cendre
Cinderella = Cendrillon
cinema = cinéma
cipher = chiffre
circle = cercle, rond, ronde
circular = circulaire
circulate = circuler
circulation = circulation
circumflex = accent circonflexe
circumstance = circonstance
circumstances = situation
circumvent = circuler
circus = cirque
cistern = citerne
citation = citation
cite = citer, rapporter des propos
citizen = citoyen
city = cité, ville
city hall = hôtel de ville
civil = civil
civilian = civil
claim = aspirer à, prétendre à
clamp = parenthèse
clap = applaudir, claquer
clarify = développer, expliquer
clarion = clairon
clasp = agrafer, agrafe
class = classe, cours, leçon
classic = classique
classical = classique
claw = griffe
clay = argile
clean = propre, pur, affinier, purifier
cleanliness = propreté
cleanly cut = net
cleanse = affinier, purifier
clear = clair, limpide, net
Cleopatra = Cléopâtre
clergyman = abbé, curé, prêtre
clever = adroit, habile, artificieux, astucieux, malin, rusé
click = claquer
client = acheteur, acquéreur, client
cliff = falaise
climate = climat
climb = gravir, grimper, monter
climber = alpiniste
clip = couper avec des ciseaux, découper, tondre
cloak = manteau
cloakroom = vestiaire
clock = horloge, pendule
clod = boule
clog = boucher, raccommoder
close = fermer, intime, prochaine, proche, près, auprès
closet = armoire
cloth = linge, étoffe, tissu
clothe = habiller, vêtir, revêtir
clothes = vêtements
clothing = vêtements
cloud = brouiller, rendre confus, rendre trouble, nuage
clown = clown
club = club
cluster = grappe
clutch = agripper, saisir
co- = ensemble
coach = entraîner, wagon
coal = charbon
coarse = grossier, rude, rustique, vulgaire
coast = bord, côte, côte rivage
coat = paletot, capote, manteau, pardessus
cobra = cobra
cock = bitte, zob, coq
cockroach = blatte, cafard
cocoa = cacao
cod = morue
coddle = choyer, dorloter
codfish = morue
coffee = café
coffee-house = café
coffee-pot = cafetière
coffin = cercueil
cognac = cognac
coherent = cohérent
coil = bobine
coincide = coïncider, concorder, convenir, correspondre
coir = choeur
cold = froid, rhume
collar = col, faux-col
colleague = collègue
collect = collectionner, ramasser, rassembler, recueillir
collection = are, bande, collection, ensemble, troupe, collection
collide with = aborder
collision = choc, collision
Cologne = Cologne
Colombia = Colombie
Colombian = Colombien
colonel = colonel
colonial = colonial
colony = colonie, possession
colossal = énorme, formidable, immense
colour = couleur, teinte
colour-blind = daltonnien
columbine = ancolie
Columbus = Colomb
column = pilier, colonne, colonne de journal, file, rubrique
comb = peigner, peigne
come = provenir, s'abouler, venir
come about = devenir, arriver, avoir lieu, intervenir
come across = rencontrer
come back = revenir
come close = s'approcher
come closer = s'approcher
come on = s'approcher, aborder, commencer
comet = comète
come to a halt = s'arrêter
come to an agreement = se mettre d'accord
come to an end = finir, prendre fin, se terminer
come together = s'accoupler
comfort = confort, consoler
comfortable = confortable
comfortably = agréablement
comforter = aspirateur, soucette, sucette
comic = comique, drôle
comical = comique, drôle
Comine = Comines
comma = virgule
command = commandement, commander, enjoindre, ordonner, sommer
commence = aborder, commencer, débuter
commencement = début, commencement, inauguration
commend = glorifier, recommander
commerce = commerce
commission = groupe de travail, commission
commit adultery = tromper
commit aggression = agresser, attaquer
commit suicide = se suicider
committee = comité
commodity = article, denrée, marchandise, produit
common = commun, ordinaire, vulgaire
commonplace = banal, trivial
commotion = agitation, scandale
communicate = communiquer
communication = communication, faire-part, renseignement
communication-cord = frein de secours, frein de sûreté
communicative = abordable
communion = communion
community = commune
commute = aiguiller, commuter
companian = accompagnateur
companion = camarade, compagnon
company = compagnie
compare = comparer
comparison = comparaison
compartment = domaine, spécialité, compartiment
compass = boussole
compassion = apitoiement, compassion, pitié
compatible = correspondant
compel = imposer, obliger, obliger à
compensate = compenser, récompenser
compete = concourir, rivaliser
competent = compétent, qualifié
competition = concours
complain = porter plainte, se plaindre
complaint = accusation, plainte
complete = compléter, remplir, complet, entier
completely = complètement, entièrement
complexion = teint
complicate = compliquer
compliment = compliment
compose = se résoudre à, composer, écrire
composing = montage
composition = composition
composure = repos
comprise = contenir, renfermer
compulsory = obligatoire
computer = ordinateur
comrade = camarade
conceal = cacher
conceited = frivole, vain, vaniteux
conceive = concevoir
concentrated = dense
concern = importance, intérêt, intéresser, regarder, concerner, être en relation avec, soin, souci
concerned = concerné
concerning = au sujet de, concernant, quant à
concert = concert
concise = concis
conclude = se résoudre à
conclusion = résultat
concord = accord
concrete = béton, concret
concurrence = accord, concordance, convention, entente
condemn = condamner, repousser
condition = condition, situation, état, manière d'être
condom = condom, préservatif
conduct = guider, régler, aboutir, conduire, diriger, mener, procédé
conduct oneself = se conduire
cone = pomme de pin
confectioner's = pâtisserie
confectioner's shop = pâtisserie
confess = confesser, avouer, confesser, reconnaître
confession = aveu, confession, confession
confide = confier, se fier à
confidence = foi, confiance
confine = limiter
confirm = confirmer
confiscate = confisquer, saisir
conflagration = incendie
conflict = conflit
conform = concorder, correspondre
conforming = conforme
confront = affronter
confuse = confondre, troubler
confusion = désordre
congenital = inné, naturel
congentital = inné, naturel
congestion = afflux, afflux de sang, congestion
Congo = Congo
congratulate = féliciter
congregate = réunir
congress = congrès
congruent = correspondant
conjecture = conjecturer, se douter de, prévoir
connect = allier, rellier, aboucher, connecter, associer, joindre, réunir, attacher, nouer, relier
connected = cohérent
connection = ligue
connect up = aboucher, connecter
conquer = conquérir
conscience = conscience
conscious = conscient
consciousness = connaissance, conscience
consecutively = de suite, successivement
consent = admettre, consentir, donner son accord, être d'accord
consequence = aboutissement, conséquence, répersussion, suite
consequently = ensuite
conservation = garde
conserve = conserver, maintenir, retenir
consider = considérer, contempler, regarder
considerable = considérable, imposant, majeur
consignee = destinataire
consist = consister
consistency = aboutissement, conséquence, répersussion, suite, composition
consistent = cohérent, logique
consist of = être composé de
consolation = consolation
console = consoler
constant = constant, invariable, permanent, continuel, perpétuel
constantly = constamment, continuellement
consternation = abasourdissement, abattement, stupeur, stupéfaction
constringent = astringent
construct = bâtir, construire, poser
consulate = consulat
consult = consulter
consume = consommer, consumer
consumer = consommateur
contact = s'aboucher avec, contact
contain = contenir, renfermer
container = bac, baquet
contemplate = contempler
contented = content, satisfait
contention = assertion
contents = contenu
contest = concours
continent = continent
contingent = éventuel
continual = continuel, constant, invariable, permanent
continually = continuellement
continuation = suite
continue = durer, continuer, maintenir, reconduire
continuous = continuel, permanent
continuously = continuellement
contort = tordre
contralto = alto
contralto voice = alto
contrary = contradictoire, opposé
contribute = contribuer
control = commandement, gouvernement, règne, tenue, gouverner, régner, surveiller
control oneself = se surveiller
controversy = polémique
convenient = commode, convenable, opportun
convention = congrès
conversation = conversation
converse = intervenir
conversion = transformation, transformation
convert = convertir
conviction = conviction
convince = convaincre
cook = cuire, cuisiner, cuisinière, cuisinier
cookie = biscuit
coop = poulailler
Copenhagen = Copenhague
coping = arête
copious = abondant
copper = cuivre
copulation = accouplement
copy = copier
coquettish = coquet
cord = corde
cordial = cordial
core = centre, noyau
Corinth = Corinthe
Corinthian = corinthien
cork = liège, bouchon de liège
corkscrew = tire-bouchon
cormorant = cormoran
corn = maïs
corner = accaparer, monopoliser, coin
cornflower = barbeau, bleuet
corpse = cadavre
corpulent = épais, gros
Corpus Christi = fête-Dieux
correct = corriger, rectifier, redresser, exact, juste
correspond = correspondre
corridor = corridor, couloir
corroborate = confirmer
corrugate = onduler
Corsica = Corse
Corsican = Corse
Corsican woman = Corse
cosmetic powder = poudre
cosmos = cosmos
cost = coûter, revenir à
Costa Rica = Costa Rica
Costa Rican = Costaricien
costly = cher, coûteux
costume = complet, costume
cotton = coton
cotton-wool = ouate
couch = canapé
couch-grass = chiendent
cougar = puma
cough = tousser
counsel = défenseur, avocat, conseiller, avis, conseil
counsellor = conseilleur, guide
count = comte, calculer, compter
count down = retrancher
count in = additionner
countless = incalculable
country = campagne, contrée, pays
countryman = paysan
countryside = campagne
coupé = compartiment
couple = couple, époux, mari et femme, coupler, accoupler, apparier
coupon = coupon, ticket
courage = abattage, courage
courageous = courageux, vaillant
courgette = courgette
courier = courrier, messager
course = piste, cours, leçon, met, plat, trivial
court = faire la cour, cour
courteous = courtois, poli
Courtrai = Courtrai
courtyard = cour
cousin = cousine, cousin
cover = couvrir, couverture, recouvrir, revêtir, tapisser, abattre, parcourir
covetousness = avidité
cow = vache
coward = peureux
cowardice = faiblesse, lâcheté
cower = être accroupi
cow parsnip = berce
coyote = coyote
crab = crabe
crack = craquer, craquement
Cracow = Cracovie
crane = grue
crane's-bill = géranium
crash into = aborder
crawl = ramper
crayfish = écrevisse
craziness = aberration, affolement, aliénation
crazy = aberrant, agité, fou
creak = grincer
cream = crème
crease = froisser
create = créer, composer, écrire
creature = créature
credential = lettre de créance
creep = ramper
Crete = Crète
cricket = grillon
crime = crime
Crimea = Crimée
crippled = infirme
crisis = crise
criticize = critiquer, reprendre
croak = croasser
Croat = Croate
Croatia = Croatie
Croatian = croate
crockery set = service
crocodile = crocodile
cross = croiser, croix, maussade, passer, dépasser
cross out = barrer, biffer, rayer, supprimer
crossways = en largeur
crouch = être accroupi
crow = corbeau
crowbar = levier
crowd = amas, foule, masse, multitude, tas
crown = couronner, couronne
crucifix = crucifix
crude = brut, cru, grossier, rude, rustique, vulgaire
cruel = atroce, cruel, méchant
cruise = croiser
crumb = miette
crumble = froisser
crush = foule, presse, briser, fracasser, réduire en miettes, broyer, piler
cry = cri, pleurer
cry down = abaisser, aboyer à
cry out = crier
crystal = cristal
Cuba = Cuba
Cuban = Cubain
cube = cube
cubic = cubain
cuckoo = coucou
cucumber = concombre
cuddlesome = tendre
cuddly = tendre
cuff = manchette
cult = culte
cultivate = cultiver
cultivation = culture
culture = culture
cultured = cultivé
cunning = artificieux, astucieux, malin, rusé
cunt = chatte, con
cup = tasse
cupboard = armoire
Cupid = Cupidon
Curaçao = Curaçao
cure = soigner, guérir, assainir
curiosity = curiosité
curious = curieux, intéressant, singulier
curl = coiffer, friser, battre, faire tournoyer
currant = groseillier, groseille
currant bush = groseillier
current = actuel, courant
currently = actuellement
curry = panser
curse = blasphémer, maudire
curtail = abréger
curtailment = abaissement, réduction
curtain = rideau
curved = courbe
cushion = coussin
cuss = blasphémer
custom = habitude, coutume
customary = accoutumé, habituel
customer = client
customs = douane
cut = faucher, hacher, couper avec des ciseaux, découper, tondre, couper, tailler, trancher, balafre
cut into = entamer
cutlet = côtelette
cut off = abattre, tailler, retrancher
cut up = abaisser, aboyer à
Cyclades = Cyclades
cycle = bécane, bicyclette, vélo, cycle
cyclone = cyclone
cylinder = cylindre
cylinder phonograph = phonographe
cynical = cynique
cypres = cyprès
Cyprian woman = Chypriote, Cypriote
Cypriot = Chypriote, Cypriote
Cypriote = chypriote
Cyprus = Chypre
Czech = tchèque, langue tchèque
Czechoslovak = Tchécoslovaque
Czechoslovakia = Tchécoslovaquie
Czechoslovakian = Tchécoslovaque
Czech woman = Tchèque