#setName = words_en_fr_.a
#sideOneTitle = ENG
#sideTwoTitle = FRE
.. ago = il y a ...
agog = curieux
agonize = agoniser, être à l'agonie, tourmenter
agony = abois, agonie, angoisse
agoraphobia = agoraphobie
agrarian = agricultuer, agrarien, agriculteur, agriculteur
agree = s'harmoniser, s'accorder, admettre, consentir, donner son accord, être d'accord
agreeable = agréable
agreeably = agréablement
agreed = ça va, soit
agreement = atmosphère, réglage, accord, concordance, convention, entente, accommodement, pacte
agricultural = agrarien, agronomique
agricultural exhibition = exposition agricole, foire agricole
agricultural product = produit agricole
agricultural school = école d'agriculture
agriculture = agriculture, agronomie
agriculturist = agronome
agronomics = agriculture, agronomie
ague = fièvre
ah = ah
aha = ah
ahead = auparavant, autrefois, devant, en avant
aid = adjoint, aider, assister, secourir, aide
aide-de-camp = adjudant
AIDS = sida
ailment = infirmité, maladie
aim = avoir pour but, viser, but, dessein, se démener, peiner
air = air, air de musique, aria, mélodie
air-balloon = aérostat, ballon
air bridge = pont aérien
air conditioned = climatisé
aircraft = aéronef
air cushion = coussin d'air
air-defence = défense anti-aérienne
airdrome = aérodrome
airfield = aérodrome
air-filter = filtre à air
air-fleet = flotte aérienne
air-grid = grille d'aération
air gun = fusil à air comprimé
air-gun = fusil à air comprimé
air hostess = hôtesse de l'air
airless = étouffant
air letter = aérogramme
airlift = pont aérien
airline-pilot = pilote de ligne
airmail = poste aérienne
air-mail stamp = timbre de poste aérienne
airman = aviateur
air out = aérer
airplane = aéroplane, avion
air pocket = trou d'air
air-pollution = pollution atmosphérique
airport = aéroport
air-pressure = pression atmosphérique
air-resistance = résistance à l'air
airship = dirigeable
airsick = ayant le mal de l'air
airsickness = mal de l'air
air-squadron = escadron aérien
air-valve = valve
airway = route aérienne
airy-fairy = malin
Aix-la-Chapelle = Aix-la-Chapelle
Ajax = Ajax
alacrity = avidité, enthousiasme
alarm = alarmer, alerter, sirène, timbre, alarme, alerte, abasourdir, consterner, stupéfier, abasourdissement, abattement, stupeur, stupéfaction, préoccuper, effroi, terreur, redouter, réveil, réveil-matin
alarmclock = réveil, réveil-matin
alas = malheureusement
Albania = Albanie
Albanian = Albanais
albatross = albatros
Albert = Albert
Alberta = Alberta
albino = albino
album = album
albumen = albumen
alburnum = aubier
alchemist = alchimiste
alchemy = alchimie
alcohol = alcool
alcoholic = alcoolique
alcoholism = alcoolisme
alcove = alcôve
aldehyde = aldéhyde
alder = aulne
alderman = adjoint au maire
Alderney = Aurigny
ale = bière
Aleppo = Alep
alert = actif, alerte, vif, vigilant
Alexander = Alexandre
Alexandria = Alexandrie
alga = algue
algebra = algèbre
algebraic = algébrique
Algeria = Algérie
Algerian = Algérien
Algiers = Alger
alibi = alibi
alien = abject, abominable, hideux, horrible, odieux, étranger, contradictoire, opposé
alike = pareil, semblable
alimony = pension alimentaire
a little = une certaine quantité, légerement
alive = vivant
alkali = alcali
alkaline = alcalin
all = toute espèce de, toute sorte de, tout, toutes les fois, tout le monde
all about = partout
allegedly = il paraît que
allegoric = allégorique
allegory = allégorie
allergic = allergique
allergy = allergie
alley = ruelle
All Hallows = Toussaint
alliance = alliance
alligator = alligator
alliteration = allitération
all of a sudden = soudainement, subitement, tout à coup
all of it = toutes les fois
all over again = de nouveau, encore
allow = laisser, permettre
alloy = alliage
All Saints' Day = Toussaint
all the = tout le
all the time = dans l'intervalle, continuellement
all the while = dans l'intervalle
allude = faire allusion, insinuer
Allumette Lake = lac aux Allumettes
almanac = almanach, annuaire
almond = amande
almoner = aumônier
almost = presque
alms = aumône
aloe = aloès
alone = seul, ne ... que, seulement
a long time = longtemps, longuement
Alost = Alost
a lot = beaucoup
a lot of = beaucoup, maint, beaucoup de
alpaca = alpaga
Alpenrose = rhododendron
alpha = alpha
alphabet = abc, alphabet, alphabet
alphabetical = alphabétique
alpine = alpestre, alpin
Alpinist = alpiniste
Alps = Alpes
already = déjà
Alsace = Alsace
Alsatian = Alsacien
also = aussi
altar = autel
alteration = transformation, transformation
alternate = alterner
alternative = alternative
although = quoique
altitude = altitude, hauteur
altogether = tout
altruism = altruisme
altruist = altruiste
altruistic = altruiste
alum = alun
aluminium = aluminium
aluminum = aluminium
Alva = Albe
always = en tous temps, toujours
always harp on one string = revenir toujours sur la même chapitre
always harp on the same string = revenir toujours sur la même chapitre
amaranthus = amarante
amass = entasser, ramasser, rassembler
amateur = amateur
amaze = étonner
Amazon = amazone
ambassador = ambassadrice, ambassadeur
amber = ambre, ambre gris, ambre jaune
ambiguous = ambigu, amphibologique
ambition = ambition, souhait
ambitious = ambitieux
ambivalence = ambivalence
Amboina = Amboine
ambrosia = ambroisie
ambulance = ambulance, ambulance
amen = ainsi soit-il
America = Amérique
American = américain
American Indian = Indien
Americanize = américaniser
amethyst = améthyste
amidst = au milieu de, parmi
ammonia = ammoniaque
ammunition = munitions
amnesty = amnistie
amoeba = amibe
among = entre, au milieu de, parmi
amorphous = amorphe
amount = nombre, montant, somme
ampère = ampère
amphetamine = amphétamine
amphibian = amphibie
amphitheatre = amphitéâtre
amphora = amphore
ample = ample, étendu, large
amplitude = amplitude
amputate = amputer
amputation = amputation
Amsterdam = Amsterdam
amuck = amok
amulet = amulette
amuse = amuser
amusement = amusement, détente, distraction, récréation
amusing = amusant, drôle
an = un, une
anabaptism = anabaptisme
anachronism = anachronisme
anaconda = anaconda
anaemia = anémie
anaemic = anémique
anaesthesia = anesthésie
anaesthesist = anesthésiste
anagram = anagramme
anal = anal
analogous = analogue, analogique
analogy = analogie
analyse = analyser
analysis = analyse
analyst = analyste
analytical chemist = analyste
anapaest = anapeste
anarchic = anarchique
anarchical = anarchique
anarchism = anarchisme
anarchist = anarchique, anar, anarchiste
anarchy = anarchie
anathema = anathème
anatomical = anatomique
anatomist = anatomiste
anatomy = anatomie
anchor = ancre, relâcher
anchovy = anchois
ancient = antique
and = et
and also = d'ailleurs, en prime, et puis
Andalusia = Andalousie
Andalusian = Andalou
Andalusian woman = Andalouse
and ... as well = d'ailleurs, en prime, et puis
Andorra = Andorre
Andorrian = andorran
anecdotal = anecdotique
anecdote = anecdote
anemone = anémone
anew = de nouveau, encore
angel = ange
angelic = angélique
angelica = angélique
anger = colère
angina = angine
angle = angle
angler = pêcheur à la ligne
Anglican = anglican
Anglo-Saxon = Anglo-Saxon
Angolan = angolais
Angolese = Angolais
anguish = angoisse
angular = anguleux
aniline = aniline
animal = animal, bête
animate = animer
ankle = cheville
Ann = Anne
anniversary = anniversaire
annotation = note
announce = annoncer, introduire, publier
announcement = faire-part, renseignement
announcer = speaker
annoy = agacer, indigner, chagriner
annoyance = désolation, peine
annual = annuel
annul = abroger, annuler, supprimer
Annunciation = Annonciation
anode = anode
anoint = enduire, étaler, étendre
anonymity = anonymat
anonymous = anonyme
anonymous writer = inconnu
another = autre, autrui, supplémentaire
another man = autrui
answer = correspondre à, respondre, réponse
ant = fourmi
Antarctic = antarctique
Antarctic Ocean = océan Antarctique
antecedent = précédent, antécédent
antelope = antilope
antenna = antenne
anthem = hymne
anthology = anthologie
anthracite = anthracite
anthropologist = anthropologiste, anthropologue
anthropology = anthropologie
anti-aircraft defence = défense anti-aérienne
anti-aircraft defences = défense anti-aérienne
anti-aircraft guns = artillerie anti-aérienne
antibiotic = antibiotique
antibody = anticorps
Antichrist = antéchrist
anticipate = anticiper
anticipation = anticipation
Anticosti Island = Ile d'Anticosti
antidote = antidote
antifreeze = antigel
Antilles = Antilles
Antillian = Antillais
antimony = antimoine
Antioch = Antioche
antipode = antipode
antique = antique
anti-Semite = antisémite
anti-Semitic = antisémitique
anti-Semitism = antisémitisme
antiseptic = antiseptique
antisocial = antisocial
anti-tank gun = bazooka
antithesis = antithèse
Antony = Antoine
Antwerp = Anvers, anversois
anus = anus
anvil = enclume
anxiety = anxiété
anxious = agité, inquiet
any = un, quelqu'un, quelques
anybody = un, quelqu'un
anything = quelque chose
anyway = de façon ou d'autre, d'une façon ou d'une autre
anywhere = quelque part
aorta = aorta
apache = apache
apart = particulier, particulièrement
apart from = en outre, hormis, sauf
apartheid = apartheid
apartment = appartement
apathetic = apathique
apathy = abattement, apathie
ape = singe
Apennines = Apennins
aperture = orifice, ouverture
aphasia = aphasie
aphorism = aphorisme
Aphrodite = Aphrodite
apiarist = apiculteur
apiary = rucher
aplomb = aplomb
apocalyptic = apocalyptique
apocryphal = apocryphe
Apollo = Apollon
apology = apologie
apoplectic fit = apoplexie
apostate = apostat
apostle = apôtre
apostleship = apostolat
apostolate = apostolat
apostolic = apostolique
apostrophe = apostrophe
apotheosis = apothéose
appal = abasourdir, consterner, stupéfier
Appalachian Mountains = Appalaches
apparatus = appareil
apparently = évidemment, apparemment
appeal = faire appel, recours
appeal to = invoquer
appear = apparaître, surgir, avoir l'air de, paraître, sembler
appearance = allure, aspect, spectacle, air, apparence
appear to be = paraître, sembler
appease = abattre, rassurer
appellation = nom
appendicitis = appendicite
appendix = appendice
appetite = appétit
applaud = acclamer, applaudir
apple = pomme
apple-tree = pommier
apply = appliquer, pratiquer
apply to = recourir à, s'adresser à
appointment = rencontre, rendez-vous
appointment book = agenda
appraise = apprécier, estimer, évaluer, taxer
appreciate = aimer, apprécier, estimer
apprehension = arrestation
approach = aborder, s'avancer, approche, abord
approachable = abordable
appropriate = convenable, raisonnable
appropriately = proprement
approval = acclamation, agrément, approbation
approve = approuver, donner son accord
approximately = à peu près, aux bords de, environ
apricot = abricot
apricot-tree = abricotier
April = avril
apron = tablier
aptitude = aptitude, don, talent
Apulia = Pouille, Pouilles
aquarium = aquarium
Aquarius = Verseau
aquatic = aquatique, aqu-, d'eau
aqueduct = aqueduc
aquiline nose = nez aquilin
Aquitaine = Aquitaine, Guyenne
aquittal = acquittement
Arab = Arabe
arabesque = arabesque
Arabia = Arabie
Arabian = arabe, arabique
Arabian woman = Arabe
Arabic = arabe, arabique
arbiter = arbitre
arbitrary = arbitraire
arbitrator = arbitre
arbor = tonnelle
arbutus = arbousier
arbutus fruit = arbouse
arc = arc
Arcadia = Arcadie
archaeological = archéologique
archaeologist = archéologue
archaeology = archéologie
archaism = archaïsme
archangel = archange
archbishop = archevêque
archduchy = archiduché
archduke = archiduc
Archimedes = Archimède
archipelago = archipel
architect = architecte
architectonic = architectonique, architectural
architectural = architectonique, architectural
architecture = architecture
architrave = architrave
archive = archives
archivist = archiviste
Arctic = arctique
Arctic Ocean = océan Glacial du Nord, océan Arctique
Ardennes = Ardennes
ardent = ardant
are = bande, collection, ensemble, troupe, are
area = aire
arena = arène, piste
Argentina = Argentine
Argentine = Argentin
Argentinean = argentin
argon = argon
argue = se disputer
argument = argument
Argus = Argus
aria = air de musique, aria, mélodie
Ariadne = Ariane
arise = se soulever, naître
aristocracy = aristocratie
aristocrat = aristo, aristocrate
aristocratic = aristocratique
Aristotle = Aristote
arithmetic = arithmétique
arm = armer, accotoir, accoudoir, bras
armchair = fauteuil
Armenia = Arménie
Armenian = Arménien
Armenian woman = Arménienne
Armorica = Armorique
armour = armure
armoury = arsenal
armpit = aisselle
arm-rest = accotoir, accoudoir
Armstrong Creek = ruisseau Armstrong
army = armée, armée militaire
army chaplain = aumônier
arnica = arnica
aroma = arôme
aromatic = aromatique
around = autour de, parages
arouse = réveiller
arrack = arack
arrange = accommoder, arranger, disposer, ordonner, ranger, régler
arrangement = construction, disposition
Arras = Arras
arrest = arrêter, arrestation
arrival = arrivage, arrivée, venue, fourniture, ravitaillement
arrivals = fourniture, ravitaillement
arrive = arriver
arrogant = arrogant, arrogant
arrow = flêche
arse = anus
arsenal = arsenal
arsenic = arsenic
art = art
arteriosclerosis = artériosclérose
artery = artère
artesian = artésien
arthritis = arthrite
artichoke = artichaut
article = article, chose, objet
article of dress = habit
artificial = affecté, artificiel
artillery = artillerie
artilleryman = artilleur
artisan = artisan
artist = artiste
arum = arum
Aryan = Aryen
as = d'après, selon, si, aussi, attendu que, car, comme, parce que, puisque, vu que
asbestos = asbeste
ascend = se soulever, monter
ascertain = constater
as far as I am concerned = quant à moi
as for the rest = d'ailleurs, et puis
ash = cendre, frêne
ashtray = cendrier
Asia = Asie
Asia Minor = Asie Mineure
Asian = Asiate, Asiatique
Asian woman = Asiate, Asiatique
as if = comme, presque
as is being said = il paraît que
ask = poser une question, demander, prier
ask for = demander, prier
ask for alms = demander l'aumône
ask for an alms = demander l'aumône
ask for charity = demander l'aumône
ask forgiveness = s'excuser
asparagus = asperge
aspect = air, allure, apparence, aspect, spectacle
aspen = tremble
asphalt = asphalter, asphalte
asphodel = asphodèle
aspiration = souhait
aspire = aspirer
aspire to = aspirer
aspirin = aspirine
as regards = concernant, quant à
ass = âne, baudet
assailant = attaquant
assault = assaillir, attaquer, attenter, attentat, donner l'assaut, assaut
assemblage = réunion, montage
assemble = réunir, monter
assembly = accumulation, assemblée politique, assemblée, montage
assent = affirmer, affirmation
assert = affirmer
assertion = assertion
asset = acquisition
assets = actif
assign = adjuger, allouer, assigner, attribuer
assigned job = devoir, tâche
assimilate = assimiler
assimilation = assimilation
assist = aider, assister, secourir
assistant = adjoint
associate = s'accoupler
association = association
assure = assurer, certifier, garantir
Assyria = Assyrie
Assyrian = Assyrien
aster = aster
asterisk = astérisque
asteroid = astéroïde
asthma = asthme
asthmatic = asthmatique
as though = comme, presque
as to = concernant, quant à
astringent = astringent
astrologer = astrologue
astrology = astrologie
astronaut = astronaute
astronomer = astronome
astronomic = astronomique
astronomical = astronomique
astronomy = astronomie
Asturias = Asturies
astute = avisé, sagace
as well as = d'ailleurs, en prime, et puis
asylum = abri, asile, refuge
asymmetric = asymétrique
asymmetrical = asymétrique
as you wish = à volonté
at = vers, près de, de, en, à, à raison de, par, au bord de, chez, parmi, sur, tous près de
at all = n'importe, complètement, entièrement, totalement, tout
at a strech = de suite, successivement
atavism = atavisme
atelier = atelier, studio
at first = d'abord
Athabasca = Atabasca, rivière Atabasca
atheism = athéisme
atheist = athée
Athena = Athènes
Athene = Athènes
Athenian = Athénien
Athens = Athènes
athlete = athlète
athletic = athlétique
athletics = athlétisme
Atlantean = atlantique
Atlantic = océan Atlantique, atlantique
Atlantic Ocean = océan Atlantique
Atlantis = Atlantide
atlas = atlas
at last = enfin, finalement
at least = au moins
at long last = enfin, finalement
atmosphere = atmosphère, ambiance
atmospheric = atmosphèrique
at most = tout au plus
atoll = atoll
atom = atome
atom bomb = bombe atomique
atomic = atomique
at once = directement, tout d'abord, aussitôt, d'abord, immédiatement, sitôt, tout de suite
at present = maintenant
atrocity = abomination, atrocité, horreur
atrophy = atrophie
at some time = jadis, un jour
attach = appliquer, apposer, attacher, fixer
attachement = dévouement
attachment = attachement
attack = assaillir, attaquer, accès, assaut, attaque
attacker = attaquant
attain = acquérir, aboutir, atteindre, parvenir, remporter
attempt = se démener, démarche, effort, peine, requête, peiner, essayer, essai
attend = soigner, visiter, assister, assister à, être présent
attention = attention
attentive = attentif
attentively = attentivement
attest = attester, démontrer, témoigner
at that place = là, y
at the outset = d'abord
at the rate of = à, à raison de, par
at the right time = à temps
at the same time = en même temps
attic = mansarde
Attica = Attique
attitude = attitude
attitudinize = agir avec affectation
attitudinizer = faiseur d'embarras, poseur
attract = allécher, appâter, solliciter, attirer
attraction = appât
attractive = affriolant, alléchant, attachant, attirant, attrayant
attribute = attribut
attune = adapter
at will = à volonté
aubade = aubade
aubergine = aubergine
auction = vente aux enchères
audacious = audacieux
audacity = audace
audience = audience, auditoire
audit = surveiller, vérifier
auditory = auditorium, audience, auditoire
Augeas = Augias
augment = accroître, agrander, amplifier, étendre, augmenter, redoubler
August = août
Augustus = Auguste
aunt = tante
aura = aura
aureole = auréole
aurochs = aurochs
aurora = aurore
Australia = Australie
Australian = Australien
Australian woman = Australienne
Austria = Autriche
Austrian = Autrichien
autarky = autarcie
authentic = authentique
author = auteur
authorative = autoritaire
authority = autorité
authorization = autorisation
authorize = autoriser
autism = autisme
autistic = autistique
autobiographical = autobiographique
autobiography = autobiographie
autobus = autobus
autocracy = autocratie
autocrat = autocrate
autocratic = autocratique
autodidact = autodidacte
autogenous = autogène
automate = automatiser
automatic = automatique
automatically = automatiquement
automobile = auto, automobile
automoton = automate
autonomic = autonome
autonomous = autonome
autonomy = autonomie
autopsy = autopsie
autumn = automnal, arrière, saison, automne
auxilary = auxiliaire
avalanche = avalanche
avant-garde = avant-garde
avarice = avarice
avaricious = avare, avaricieux
avenge = venger
avenge oneself = venger
avenue = allée, avenue
average = intermédiaire, moyenne, centre, milieu
aversion = antipathie
aviation = aviation
aviator = aviateur
avidity = avidité
avoid = éviter, parer, s'abstenir de
await = attendre
awaken = réveiller
aware = conscient
awareness = connaissance, conscience
away = loin
awful = abject, abominable, hideux, horrible, odieux
awfully = affreusement
awkward = maladroit
axe = hache
axiom = axiome
axis = axe
axle = axe
azalea = azalée
azimuth = azimut
Azores = Açores
Aztec = aztèque