#setName = words_en_fr_hH
#sideOneTitle = ENG
#sideTwoTitle = FRE
habit = coutume, habitude
hack = hacher, tailler
haddock = aiglefin
haemorhoids = hémorrhoïdes
haemorrhoid = hémorrhoïde
haggle = marchander
hail = grêle
hair = chevelure, cheveu, poil, cheveux
hairdresser = coiffeuse, coiffeur
hairpiece = perruque
hairs = cheveux
hairy = velu, poilu
Haiti = Haïti
halcyon = martin-pêcheur
half = demi, moitié
halo = auréole
halt = s'arrêter
ham = jambon
Hamburg = Hambourg
hamlet = hameau
hammer = marteau
hand = ouvrier, main
handbook = guide
handful = poignée
handicraft = métier
hand in = déposer
handkerchief = mouchoir
handle = tâter, manier, traiter
handlebars = gouvernail
handshake = poignée de main
handsome = beau
handy = commode, convenable, opportun
hang = pendre, retomber, suspendre
hang onto = tenir
Hannibal = Annibal, Hannibal
Hanover = Hanovre
happen = devenir, arriver, avoir lieu, intervenir
happy = heureux, joyeux
harbor = port
harbour = port
hard = difficile, penible, dur
harden = durcir, tremper
hardly = à peine, ne ... guère, difficilement, lourdement, péniblement
hardworking = appliqué, assidu, laborieux
hare = lièvre
haricot = haricot
harm = nuire, préjudice
harmful = nuisible
harmonious = harmonieux
harness = atteler
harrow = herser
harsh = acerbe, astringent, maussade, grossier, rude, rustique, vulgaire
harvest = récolter, recueillir, moisson, récolte
haste = hâte
hastily = à la hâte
hat = chapeau
hate = haïr
haul = tirer
Havana = La Havane
have = avoir, accueillir, recevoir
have a bath = se baigner
have a good time = se réjouir
have an accident = avoir un accident
have a subscription = s'abonner, s'abonner à
have at one's disposal = disposer, disposer de
have compassion on = avoir pitié, compatir, plaindre, s'apitoyer
have confidence in = confier, se fier à
have effect = agir, être efficace, opérer
have faith = se fier, se fier à
have faith in = se fier, se fier à
have got = avoir
have sex = baiser
have sexual intercourse = s'accoupler
have to = devoir, être obligé
Hawaii = Hawaii
Hawaiian = hawaiien, langue hawaiienne
hawk = autour
hay = foin
hazard = hasard, aventurer, oser, risquer, aléa, peril, risque
hazardous = périlleux
haze = chicaner
hazelnut = noisette
he = il, lui
head = guider, régler, tête, tête
header = rubrique
heading = intitulé, titre
headlight = phare
head of cattle = tête de bétail
heal = guérir, assainir
health = santé
healthy = sain
heap = accumuler, entasser, ramasser, rassembler, amas, foule, masse, multitude, are, bande, collection, ensemble, troupe, tas
hear = entendre
hearsay = réputation, rennomée
heart = coeur
heart- = cordial
hearth = foyer, cheminée
hearty = cordial
heat = ardeur, chauffer
heath = bruyère
heating = chauffage
heaven = ciel
heavenly body = astre
heavy = lourd
Hebrew = hébraïque, hébreu, langue hébraïque
Hebrew language = hébreu, langue hébraïque
Hebrides = Hébrides
hectolitre = hectolitre
hectometre = hectomètre
hedge = haie
hedge clippers = taille-haie
hedge shears = taille-haie
heel = talon
he-goat = bouc
height = altitude, hauteur
heighten = aggraver, amplifier
Helen = Hélène
helium = hélium
helix = hélice
Hellas = Hellade
Hellespont = Dardanelles
hello = allô
helm = gouvernail
help = aider, assister, secourir, aide
helper = adjoint
helpless = abandonné
Helvetia = Helvétie
Helvetian = Helvète
hemorrhoid = hémorrhoïde
hen = poulet
Henegovia = Hainaut
her = à lui, lui, leur, elle, sa, son, la, l'
Heracles = Hercule
herald = héraut
herb = herbe
Hercules = Hercule
herd = are, bande, collection, ensemble, troupe, troupeau
here = ici
here are = voici, voilà
here is = voici, voilà
heresy = hérésie
Hermes = Hermès
hero = héros
heroic = héroïque
heroin = héroïne
heroine = héroïne
heroism = héroïsme
heron = héron
herring = hareng
herself = même
hesitate = barguigner, hésiter
hiccup = avoir le hoquet, hoqueter, sanglot
hide = fourrure, peau, pelage, poil d'animal, cacher, s'abriter
hide oneself = s'abriter
hideous = repoussant, abject, abominable, hideux, horrible, odieux
high = haut
high school = collège
high tide = afflux, marée haute
highway = chaussée, route
hill = colline, butter, terrer
hillside = côte, pente
hill up = butter, terrer
him = à lui, il, lui, le, l'
Himalayas = Himalaya
himself = même
hind = biche, suivant
hinder = déranger, gêner
hindmost = suivant
Hindu = hindou
hinge = charnière
hinny = bardot
hint = faire allusion, insinuer
hip = hanche
hippo = hippopotame
Hippocrates = Hippocrate
hippopotamus = hippopotame
hire = embaucher, louer
his = sa, son, leur
hiss = siffler
history = histoire
hit = battre, heurter, heurter, atteindre, frapper, parvenir, saisir
hitch on = aborder, accrocher, monter à l'abordage, sauter à l'abordage
hoarse = rauque
hoax = mystifier
hoe = houe
hog = cochon, porc
hogweed = berce
hold = tenir
hold back = réprimer
hole = fossé, trou
holiday = jour férié, vacance
Holland = Hollande, Pays-Bas
Hollander = Hollandais
holly = houx
holy = sacré, saint
homage = hommage
home = domicile
Homer = Homère
Honduran = Hondurien
Honduran woman = Hondurienne
Honduras = Honduras
honest = honnête
honey = miel
honeysuckle = chèvrefeuille
Hongkong = Hong Kong
honor = honorer, honneur
honour = honorer, honneur
hood = apache, couverture
hoof = sabot
hook = agrafe, hameçon, crochet, accrocher
hooker = fille, fille publique, prostituée, putain
hook on = aborder, accrocher, monter à l'abordage, sauter à l'abordage
hooks and eyes = agrafe de vêtement, fermoir
hoopoo = huppe
hooter = corne, avertisseur
hop = houblon, sautiller
hope = espérer, souhaiter, espérance, espoir
hope for = aspirer
hops = houblon
horizon = horizon
horizontal = horizontal
horn = corne, avertisseur
hornbeam = charme
hornet = taon
horoscope = horoscope
horrible = repoussant, abject, abominable, hideux, odieux, atroce, féroce, désagréable, maussade, épouvantable, horrible, affreux, terrible, formidable, sinistre
horror = atrocité, horreur, abomination, aversion, dégoût, répulsion
horse = cheval
horse-chestnut = châtaigne
horse-fly = taon
horseradish = raifort
horse-radish = raifort
hospital = hôpital
host = aubergiste, amphitryon, hôte
hostage = otage
hostel = auberge
hostess = aubergiste
hostile = ennemi, hostile
hotel = hôtel
hour = heure
house = maison
housefly = mouche
house of ill fame = bordel
house of worship = église
hover = planer
how = comment, comment, de quelle manière, comme
however = cependant, néanmoins, pourtant, tout de même
howl = hurler, gronder, mugir
how long = pour combien de temps
how many = combien, combien de
how much = combien, combien de
hub = moyeu
Hudson Bay = baie d'Hudson
Hudson Strait = détroit d'Hudson
hue = nuance, teinte
huge = gigantesque, énorme, énorme, formidable, immense
hum = bourdonner, ronronner
human being = être humain, homme
humane = charitable, humain
humble = humble
humble oneself = s'humilier
humility = modestie
hummingbird = oiseau-mouche
humour = humeur, humour
hump = bosse
humus = humus
hunchback = bossu
hunch-backed = bossu
hundred = cent
Hungarian = Hongroise, Hongrois
Hungarian woman = Hongroise
Hungary = Hongrie
hunger = faim
hunt = chasser
hunter = chasseur
hurricane = ouragan
hurried = hâtif
hurriedly = à la hâte
hurry = se dépêcher, être urgent, presser
hurt = blesser
husband = époux, mari
husk = coque, écorce
hut = cabane, chaumière, hutte
hyaena = hyène
hybrid = hybride
hygiene = hygiène
hygienic = hygiénique
hymn = hymne
hypnosis = hypnose
hypnotic trance = hypnose
hypnotize = hypnotiser
hypocrite = hypocrite
hypocritical = hypocrite
hypothesis = hypothèse
hypothetical = hipothétique
hysteria = hystérie
hysterical = hystérique