#setName = words_en_fr_ss
#sideOneTitle = ENG
#sideTwoTitle = FRE
sack = suspendre, licencier, renvoyer
sacred = sacré, saint
sacrifice = consacrer, faire offrande, offrir, sacrifier
sad = affligé, désolé, peiné, triste, maussade, sombre
saddle = selle
sadness = affliction, désolation, souci, abattement
safety = sécurité
sagacious = intelligent, raisonnable, sage, sensé
sage = sauge, raisonnable, sage, sensé
Sagittarius = Sagittaire
Sahara = Sahara
sail = voile
sailor = marin
Saint Helena = Sainte-Hélène
Saint Nicholas = Saint-Nicolas
Saint Petersburg = Saint-Pétersbourg
salad = salade
salami = salami
salary = appointements, gaine, salaire
sale = abattement
sales activity = marché
salesman = marchand
saliva = bave, salive
salivate = baver
sallow = pâle
salmon = saumon
salon = salon
salt = saler, sel
salute = accueillir, saluer
salvage = salut
salvation = salut
Samaria = Samarie
same = identique, même
sample = spécimen
sanction = sanction
sand = arène, sable
sandal = sandale
sandwich = sandwich
San Marino = Saint-Marin
sap = jus, sève, suc
sap-wood = aubier
Sardina = Sardaigne
sardine = sardine
Sardinia = Sardaigne
Sardinian = Sarde
Sassenach = Anglais
Satan = Satan
satellite = satellite
satisfactory = satisfaisant
satisfied = content, satisfait, rassasié
satisfy = contenter, satisfaire
saturate = saturer
Saturday = samedi
Saturn = Saturne
sauce = sauce
saucepan = casserole
saucer = soucoupe
sausage = andouille, saucisse
savage = sauvage
save = préserver, sauver, économiser, épargner
saw = scier, scie
Saxe = Saxe
Saxon = Saxon
Saxony = Saxe
saxophone = saxophone
say = dire
say goodbye = faire ses adieux, dire adieu
say goodbye to = faire ses adieux, dire adieu
say yes = affirmer
scald = échauder, saisir
scale = échelle, écaille, monter
scandal = agacement, scandale
Scandinavia = Scandinavie
Scandinavian = Scandinave
Scandinavian woman = Scandinave
scanty = insuffisant
scar = balafre, cicatrice
scarce = insuffisant
scarcely = à peine, ne ... guère
scatter = disperser, répandre, verser
scene = scène
scenery = paysage
scent = odeur
Scheldt = Escaut
scheme = projet, schéma
scholar = savant
school = école
school desk = pupitre
science = science
scientist = homme de science
scissors = ciseaux
scold = admonester, exhorter, sommer, reprendre, réprimander, reprocher, gronder, sermonner
score = adapter, orchestrer
scorpion = scorpion
Scot = Ecossais
Scotland = Ecosse
Scotsman = Ecossais
Scotswoman = Ecossaise
scoundrel = canaille, gredin
scourge = fléau, plaie
scout = reconnaissance
scrap = chiffon, lambeau
scrape = effacer en grattant, gratter
scratch = griffer, effacer en grattant, gratter
scream = clameur, crier
screw = baiser, foutre, vis
screwdriver = tournevis
screw up = gâcher
script = scénario
scuffle = bataille, combat, bagarre, baroud
Scylla = Scylla
scythe = faux
sea = marin, mer
sea- = marin
sea-anemone = actinie
sea-dog = phoque
seagull = mouette
seal = phoque, sceller, sceau
seam = joint
search = recherche
seasickness = mal de mer
seaside = bord, côte, côte rivage
season = saison
seat = siège
seaweed = algue
seclude = isoler
second = deuxième, second, seconde
secondary = accessoire, auxiliaire, secondaire
second cousin = arrière-cousine, arrière-cousin
secret = arcane, secret
secretary = secrétaire
sect = secte
section = domaine, spécialité, branche, section, service
sector = secteur
secure = attacher, fixer
security = sécurité
seduce = détourner, dévoyer, entraîner hors du droit chemin
see = rencontrer, voir, visiter, avoir soin de, se soucier de, s'occuper, veiller à
see again = revoir
seed = graine, semence
seek = chercher, railler
seem = paraître, sembler
seemingly = apparemment
seemly = convenable, raisonnable
Sein = Seine
seize = agripper, saisir
seized with emotion = ému
seizure = apoplexie
seldom = rarement
self = même
self-assurance = aplomb
selfless = affectueux, attaché, dévoué
self-sufficiency = autarcie
self-taught man = autodidacte
sell = vendre
Semite = Sémite
Semitic = sémitique
send = adresser, envoyer
sender = envoyeur
send off = expédier
Senegal = Sénégal
Senegalese = Sénégalais
sensation = sentiment
sense = signification, sens, sentir, ressentir
sensible = prudent, raisonnable, sage
sensitive = sensible
sentence = phrase, condamner
sentiment = sentiment
sentry = sentinelle
separate = particulier, trier, disperser, dissiper, séparer, débiter, diviser, partager
separately = particulièrement
separation = abandon
September = septembre
septic = septique
Serb = Serbe
Serbia = Serbie
serene = serein
serfdom = servage
sergeant = sergent
series = série
serious = considérable, grave, important, majeur, sérieux
sermon = sermon
serpent = serpent
servant = servante, domestique, serviteur
serve = être de service, servir
service = office religieux, office, service
servitude = servage
session = session
set = appareil, are, bande, collection, ensemble, troupe, série, se coucher
set a trap = comploter, tendre un piège
set a trap for = comploter, tendre un piège
set in = aborder, commencer
settle = se résoudre à, s'abaisser, s'abattre
settlement = colonie, possession
seven = sept
seventeen = dix-sept
seventy = soixante-dix
several = plusieurs
several times = parfois, quelquefois
severe = austère, sévère
severity = austérité
sew = coudre
sewer = cloaque, égout
sex = sexe, bagatelle
sexual love = amour charnel, bagatelle
sexual pleasure = volupté
Seychelles = Seychelles
shack = baraque, cabane, chaumière, hutte
shackle = chaîne
shade = nuance, teinte, ombre
shadow = ombre
shaft = puits de mine
shaggy = velu, poilu
shah = schah, shah
shake = secouer, ébranler
shallow = superficiel
shallowly = rapidement
shame = pouah
shanty = baraque
shape = former, forme
share = action, débiter, diviser, partager, participer, prendre part, partie, contingent, part, portion, ration, parti aux bénéfices, participation aux bénéfices
share-capital = portefeuille d'actions
shareholder = actionnaire
share to bearer = action au porteur
shark = requin
sharp = acéré, âcre, aigre, percant, piquant, rude, coupant, tranchant, aigu, à l'heure, justement, précisément
sharp-edged = anguleux
sharpen = affiler, aiguiser
sharpness = acuité
sharp-toned = perçant
shatter = briser, fracasser, réduire en miettes
shave = raser
shawl = châle
she = elle
sheaf = gerbe
shear = couper avec des ciseaux, découper, tondre
she-ass = ânesse
she-bear = ourse
shed = baraque, échoppe, kiosque, stand, abri, verser, hangar
sheep = mouton
sheet = feuille, drap, drap de lit, plaque
sheet metal = fer-blanc, tôle
she-goat = chèvre
shelf = étagère, planche, tablette, rayon, rayon de rangement
shell = conque, coquille, dépouiller, coque, écorce
shelter = refuge, abri, gîte, abriter, garantir, s'abriter, se mettre à l'abri, se retrancher
shepherd = pasteur, pâtre
sheriff = shérif
she-wolf = louve
shield = enseigne
shine = briller, être lumineux, luire
ship = expédier, bateau, navire
ship = -té
shipping share = action de compagnie maritime
shipwreck = naufrage
shirt = chemise
shiver = trembler
shock = secouer, choquer, heurter, choc
shoe = chaussure, soulier
shoe-lace = lacet
shoemaker = cordonnier
shoo = amener à, faire avancer, pourchasser, poursuivre, pousser
shoot = tirer
shoot dead = fusiller, abattre
shop = boutique, magasin
shore = rive, bord, côte, côte rivage
short = court
shortage = défaut, insuffisance, manque, privation, vice
shortcoming = défaut, insuffisance, manque, privation, vice
shorten = raccourcir, raccourcir, abréger
shortness of breath = asthme
short pants = culotte
shorts = culotte
short-sighted = myope
short story = nouvelle
should = devoir, être obligé
shoulder = accotement, épaule
shoulderblade = omoplate
shout = crier, cri
shove = faire glisser, fourrer
shovel = pelleter, pelle
show = manifester, indiquer, montrer, désigner, marquer, spectacle
showcase = vitrine
shower = douche
show window = vitrine
shrewd = avisé, sagace
shrill = aigu, criard, strident, perçant
shrink = se racornir, se ratatiner
shrivel up = se racornir, se ratatiner
shrub = arbrisseau, arbuste
shrug = hausser les épaules
shuffle = mélanger, mêler, retourner
shut = fermer
shut up = serrer
shy = timide
Siam = Siam, Thaïlande
Siamese = siamois, thaïlandais
Siberia = Sibérie
Siberian = sibérien
Sicilian = Sicilien
Sicilian woman = Sicilienne
Sicily = Sicile
sick = malade, malsain
sickle = serpe
side = auxiliaire, côté, flanc, parti
sideboard = armoire
side-issue = accessoire, appendice
sideral = astral
sidewalk = trottoir
siege = siège
sift = tamiser
sight = air, allure, apparence, aspect, spectacle, vue
sightless person = aveugle
sightseeing trip = excursion, randonnée
sign = augure, preuve, signal, signe, témoignage, signer
signal = signaler, signal, signe, témoignage
signature = signature
sign-board = enseigne
signify = signifier
silence = repos
silent = silencieux
Silesia = Silésie
silhouette = silhouette
silk = soyeux, soie
silk- = soyeux
silken = soyeux
sill = seuil
silver = argent
similar = pareil, semblable
simple = pur, simple
sin = commetre yne faute, pécher, péché
since = à partir de, depuis, dès, attendu que, car, comme, parce que, puisque, vu que
sincere = sincère
sincerity = sincérité
sing = chanter
Singapore = Singapour
Singaporean = singaporien, Singapourien
singer = chanteuse, chanteur
single = célibataire
sink = forer, rencontrer, toucher
sip = absorber
sir = monsieur
sister = soeur
sit = couver, être assis, sièger
sit down = asseoir
sit down to table = s'attabler
sitting-room = salon
situation = situation
six = six
sixteen = seize
sixtieth = soixantième
sixty = soixante
sizable = considérable, imposant, majeur
size = ampleur, importance, taille, grandeur
skate = patin, raie
skeleton = squelette
skeptical = sceptique
sketch = esquisser, esquisse
ski = ski
skilfulness = adresse, habileté
skill = adresse, habileté
skillful = adroit, habile
skillfulness = adresse, habileté
skimpy = maigre
skin = fourrure, pelage, poil d'animal, peau, dépouiller
skinny = maigre
skirt = jupe
skull = crâne
sky = ciel
sky blue = azur
skyjacker = pirate de l'air
skylight = lucarne
slab = plaque
slander = calomnier, diffamer, salir
slanting = oblique
slaughter = abattre
slaughterhouse = abattoir
Slav = Slave
slave = esclave
Slavic = slave
Slavonian = Slavon
slay = abattre, rectifier, tuer
sleep = dormir, sommeil
sleeping-accomodation = dortoir
sleeping-place = dortoir
sleeve = manche
slender = mince
slice = balafre, couper, tailler, trancher
slime = boue, bourbe, limon, vase
slip = glisser, fiche
slipper = pantoufle
slippery = glissant
slippery as an eel = glissant comme une anguille
slope = côte, pente
slot = cannelure, sillon, rainure
Slovak = Slovaque
Slovakia = Slovaquie
Slovak woman = Slovaque
Slovene = Slovène
Slovenia = Slovénie
Slovenian = Slovène
slow = lent
slowly = lentement
slug = limace
sluice = écluse
slut = roulure
sly = artificieux, astucieux, malin, rusé
sly joke = blague
smack = faire du bruit avec les lèvres, faire un bruit de succion
small = petit
small bench = banquette
small letter = minuscule
small room = cabinet noir
smart = artificieux, astucieux, malin, rusé
smash = briser, fracasser, réduire en miettes
smear = enduire, étaler, étendre
smell = flairer, odorat, embaumer, exhaler un odeur, sentir, odeur
smile = sourire
smith = forgeron
smock = blouse longue
smoke = fumer, fumée
smooth = plat, lisse, uni
snail = escargot, limaçon, colimaçon
snake = serpent
snappy = perçant
snare = piège
sneer = ricaner
sneeze = éternuer
snifter = apéritif, apéro
snore = ronfler, vrombir
snorter = apéritif, apéro
snow = neiger, neige
snowdrop = perce-neige
snowflake = flocon de neige
so = donc, afin de pour, afin que, pour que, ensuite, ainsi, comme, comme cela, aussi, si, tant, tellement
soak = tremper
soap = savon
sober = sobre
soccer = foot, football
soccer ball = ballon, ballon de football
social = social
socialism = socialisme
society = club, société
sock = chaussette
sodium = sodium
sofa = canapé
Sofia = Sophie
soft = doux, gentil, suave, sucré, moelleux, mou, tendre
soften up = forcer
soil = sol, salir, salir, souiller, terre
soiled = sale
solair = ensoleillé
solder = braser, souder
soldier = soldat
sole = pur, plante, plante du pied, semelle, seul, sole
solely = ne ... que, seulement
solemn = solennel
solicitor = défenseur, avocat, avocat conseil
solid = solide
solidarity = solidarité
solitary = pur, seul
so long = au revoir
solution = réponse d'un problème
solve = résoudre
Somali = Somalien
Somalia = Somalie
Somalian = Somalien
somber = maussade, sombre
some = une certaine quantité, un, quelqu'un, quelques uns, quelques
somebody = un, quelqu'un
somehow = de façon ou d'autre, d'une façon ou d'une autre
some kind of = quelconque
someone = un, quelqu'un
some one = un, quelqu'un
someone's = de quelqu'un
something = quelque chose
sometime = jadis, un jour
sometimes = parfois, quelquefois
somewhat = une certaine quantité
somewhere = quelque part
son = fils
son-in-law = beau-fils, gendre
sonorous = sonore
sonourous = sonore
sons and daughters = enfants, <garçons et filles>
soon = bientôt, tout à l'heure
soot = suie
soothe = abattre, rassurer
sorcerer = sorcier
sorcery = charme, enchantement, sortilège
sore = ulcère
sorrel = bai
sorrow = abattement
sort = acabit, espèce, genre, sort
so so = comme ci, comme ça
so that = afin de pour, afin que, pour que
so to speak = pour ainsi dire
soul = âme
sound = sonner, résonner, son
sound the alarm = alarmer, alerter
soup = potage, soupe
sour = acerbe, acide, aigre, s'acidifier, s'aigrir, astringent, maussade
source = fontaine, source
Sout-East Asia = Asie du Sud-Est, Sud-Est asiatique
south = austral, sud
South Africa = Afrique du Sud
South African = Sud-Africain
South America = Amérique du Sud
South American = sud-américain
southern = austral
Southern Cross = Croix du Sud
South Korea = Corée du Sud
souvenir = souvenir
sovereign = souverain
sow = coche, truie, semer
space = espace
spaceman = astronaute
spacious = ample, étendu, large
spade = creuser, bêche
spades = piqûre
Spain = Espagne
Spaniard = Espagnol
Spanish = hispanique, espagnol, langue espagnole
Spanish language = espagnol, langue espagnole
Spanish woman = Espagnole
spanner = clef
spare = être indulgent, économiser, épargner
spare time = congé, loisirs, vacances
spark = étincelle
spark plug = bougie, bougie électrique
sparrow = moineau, passereau
Sparta = Sparte
speak = parler
speaker's platform = tribune
special = particulier, spécial
speciality = domaine, spécialité
specially = particulièrement, spécialement, surtout
species = espèce, espèce biologique
specimen = spécimen
spectacle = spectacle
spectacles = lunettes
spectator = spectateur
speech = langage, discours, parole
speechless = muet
speed = hâte, allure, rapidité, vitesse
speed up = accélerer, hâter, presser
speedwell = véronique
speedy = prochain, prompt, rapide
spend = dépenser, donner, passer
spend the night = passer la nuit
sperm = semence, sperme
sphere = sphère
spice = assaisonner, épice
spider = araignée
spiked = pointu
spin = filler la laine
spinach = épinard
spine = colonne vertébrale, épine, épine dorsale
spinster = célibataire
spiral = spirale
spirit = esprit, vigueur
spit = cracher, jeter, vomir
Spitsbergen = Spitzberg
splash = barboter, clapoter
splender = pompe, splendeur
splinter = écharde, éclat
split = fendre
spoil = détériorer, gâcher, abîmer, gâter
sponge = éponge
sponger = parasite
spontaneous = spontané
spool = bobine
spoon = cuiller, cuillère
sport = sport
spot = déstination, endroit, lieu, localité, place, salir, souiller, tache, point
spray gun = pistolet
spread = enduire, étaler, étendre
spread out = déployer, étendre
spring = émaner, sortir de, fontaine, source, printemps, ressort, sauter
springtime = printemps
sprinkle = joncher
spruce = épicéa
spruce-fir = épicéa
spur = inciter
spur on = inciter, pousser à
spurt = jaillir
spurt out = jaillir
spy = espion
spy on = épier, guetter
squad = compagnie
square = carré, droit, rectangle, esplanade, place, rond-point
square decametre = are
squash = potiron
squat = être accroupi
squeeze = appuyer en écrasant, presser, serrer
squint = loucher
squire = chaperonner
squirrel = écureuil
squirt = projeter un liquide
stab = piquer
stable = ferme, stable, écurie, étable
stack = accumuler, ramasser, rassembler, entasser, tas
stadium = étape, stade
stage = tenue, phase, gare, station, étape, stade
stagnate = stagner
staid = sérieux, sobre
stain = salir, souiller
stair = marche
staircase = escalier
stairs = escalier
stake = poteau, échalas, pieu
stale = rassis, purin
stalk = chaume, faire les cent pas, tige, queue
stall = écurie, étable
stallion = cheval entier, étalon
stammer = bafouiller, balbutier, bégayer
stamp = timbre, timbre-poste, estampiller
stamped = affranchi
stanchion = pieu, poteau
stand = échoppe, kiosque, stand, surgir, sursauter, être debout, se dresser
standard = drapeau, étendard, pavillon
standing on end = ébouriffé, hirsute
standing together = solidaire
stand up = surgir, sursauter
stand up to = affronter, oser attaquer
staple = parenthèse
star = astral, étoile, star, vedette
star- = astral
start = activer, sursauter, prendre l'initiative, aborder, commencer, débuter, début, commencement, inauguration
starting point = point de contact
start off = démarrer, partir
start out = partir
state = affirmer, déclarer, puissance, règne, manière d'être, état, état politique
statement = déclaration
statement of policy = programme
station = gare, station
statue = statue
stature = stature, taille
statute = statut
stay = séjour, rester
stay on = rester en arrière, ne pas s'éteindre
stay over = rester
steak = bifteck
steal = d'acier, dépouiller, dérober, voler
steam = vapeur
steel = acier
steep = abrupt, à pic, escarpé, raide
steer = conduire, diriger, piloter
steering = direction
steering-wheel = gouvernail, volant
stem = tige, queue, tronc
stencil = modèle, patron
step = faire les cent pas, pas, marche
step out = presser le pas
steppe = steppe
sterness = austérité
stevedore = arrimeur
stew = ragoût
stewardess = hôtesse de l'air
stewardship = économat, intendance
stick = s'agglutiner, bâtonnet, bâton, canne, coller
stick to the pan = attacher
stiff = raide, rigide
stiffling = étouffant
still = encore, abattre, rassurer
stimulate = agacer, irriter, pousser à, inciter, stimuler
stimulus = incitation
sting = piquer, piquant, piqûre
stinginess = avarice
stingray = raie
stingy = avare, avaricieux
stipulation = condition
stir = affecter, émouvoir, remuer, battre, faire tournoyer, vigueur
stir up = agiter, débattre, émouvoir, troubler, exciter, hérisser, agacer, irriter, inciter, stimuler
stitch = coudre, piquer
St. Nicholas = Saint-Nicolas
stock = stock
stocking = bas, chaussette
stodgy = maussade, ennuyeux
stoke = chauffer
stomach = estomac
stone = pierre
stool = banquette, tabouret
stoop = pencher, s'incliner
stop = halte, s'arrêter, gare, station, cesser, arrêter, faire cesser, interrompre, terminer
stopper = bouchon, prise de courant mâle
stop up = boucher, raccommoder
storage battery = accu, accumulator, accumulateur
storage room = réserve
store = boutique, enlever, ôter, magasin
store-cupboard = buffet
storey = étage
stork = cigogne
storm = donner l'assaut, orage, tempête
storming = assaut
story = étage, histoire, récit, relation
stove = cuisinière, four, fourneau
stow = serrer, fourrer, introduire, mettre, arrimer
straigh ahead = debout, directement, sans détour
straight = direct, droit
straightforward = pur, simple
straight past = au-delà de
strait = détroit
strange = étranger, drôle, étrange, singulier
stranger = inconnu
strap = courroie, lanière
Strasbourg = Strasbourg
strategy = stratégie
straw = paille
strawberry = fraise
strawberry tree = arbousier
streak = raie, rayure
stream = courant, ruisseau
strech = bander, raidir, remonter, serrer, tendre
strech out = étendre
street = rue
streetcar = tramway
strength = puissance, force
stress = accentuer, souligner, accent
stress-mark = accent
strew = joncher
strict = austère, sévère
stride = faire les cent pas, pas
strike = battre, heurter, forer, rencontrer, toucher, s'allumer, heurter, en imposer à, grève, atteindre, frapper, parvenir, saisir
strike off = débattre
strike out = barrer, biffer, rayer, supprimer
string = défiler, corde
stringent = rigoureux
strip = bandeau, se déshabiller, bande, raie, rayure
stripe = bande, raie, rayure
strive for = se démener, s'efforcer
stroke = apoplexie, caresser, caresse, raie, rayure
stroke of apoplexy = apoplexie
stroll = promenade, se promener
stroller = promeneur
strong = fort, puissant
strongly = fortement
strontium = strontium
strop = cuir à rasoir
structure = structure
struggle = se débattre, se démener, batailler, combattre, luter, bataille, combat, lutter
stubborn = obstiné, tenace, têtu
student = étudiant
studio = atelier, studio
study = étude, étudier
stuff = affaires, choses, trucs, fourrer, rembourrer, substance
stumble = achopper, trébucher
stupid = bébête, idiot, sot, stupide
stupidly = stupidement
sturdy = robuste
sturgeon = esturgeon
stutter = bafouiller, balbutier, bégayer
sty = écurie, étable
style = style
Styria = Styrie
Styx = Styx
subdue = soumettre
subject = composition, sujet, thème
subjugate = soumettre
submit = soumettre, abdiquer
subordinate = inférieur, subordonné
subscribe = s'abonner
subscriber = abonné
subscribe to = s'abonner
subscription = abonnement, cotisation
subsequently = après, puis, ensuite
subsidiary subject = sujet secondaire
subsidy = subvention
substance = substance
substitute = mettre en place de, remplacer, substituer
subterfuge = artifice
subtle = fin, subtil
subtract = retrancher, soustraire
subtraction = soustraction
subversion = abattage
subvert = saper, miner
subway = métro
succeed = abouter, arriver, parvenir, réussir
success = prospérité, aboutissement, gain, succès
successor = descendant, successeur
such = autant, tel, ainsi, comme, comme cela, tellement
such a = comme, autant, tel
such as = comme
suck = sucer
suckle = allaiter
Sudan = Soudan
Sudanese = Soudanais
sudden = soudain, subit
suddenly = soudainement, subitement, tout à coup
suffer = endurer, souffrir, subir
suffice = suffire
sufficient = suffisant
sufficiently = assez, passablement, plutôt, suffisamment
suffix = suffixe
suffocate = étouffer, suffoquer
sugar = sucre
sugary = doucereux
suggest = désigner, indiquer, proposer, inspirer, suggérer
suit = complet, costume, être bon à, convenir
suitable = raisonnable, apte à, convenable, propice
suitcase = valise
suite = clique, cortège, escorte, suite
sulphur = soufre
sultry = étouffant
sum = montant, somme
summarize = abréger, résumer
summer = été
summery = abrégé, réduction de texte
summit = bout, cime, pointe, comble, faîte, haut, sommet, summon
summon = appeler
sun = ensoleillé, soleil
sun- = ensoleillé
sunbeam = rayon de soleil
Sunday = dimanche
superb = grandiose, magnifique
superficial = superficiel
superior = dominant, supérieur, suprème, surplombant
superscription = inscription
supersign = accent
superstition = superstition
supervise = surveiller, vérifier
supper = dîner, souper
supply = fournir, livrer, fourniture, ravitaillement, munir, pourvoir, provision, réserve
support = accoter, appui, appuyer, maintenir
supporter = affilié, adhérent, partisan
supporters = adhérents, parti, suite
suppose = supposer
supposing that = supposé que
supposition = hypothèse
suppress = réprimer, étouffer, suffoquer
sure = assuré, certain, sûr
surely = d'abord, certes, si
surface = comble, faîte, haut, sommet, summon, surface
surgeon = chirurgien
surgery = chirurgie
surgical operation = opération
Surinam = Surinam
Surinamer = Surinamien
Surinamese = Surinamien
Surinamese woman = Surinamienne
surly = maussade
surmise = conjecturer, se douter de, prévoir, supposer
surpass = dépasser, dominer, maitriser, surmonter
surprise = surprendre, surprise
surrender = abandon
surround = entourer
surroundings = abords, alentours
susceptibility = recevabilité
suspect = se méfier, soupçonner, suspecter
suspenders = bretelles
suspicion = méfiance
suspicious = méfiant, sinistre
sustain = accoter, appuyer, maintenir
sustained = constant, invariable, permanent, continuel, perpétuel
swallow = avaler, aronde, hirondelle
swamp = marais, marécage
swan = cygne
swap = échanger
swarm = fourmiller, grouiller
swear = blasphémer, jurer, prêter serment
swear off = abjurer
sweat = transpirer, suer, sueur
Swede = Suédois
Sweden = Suède
Swedish = suédois
sweep = balayer
sweet = doux, gentil, suave, sucré, friandise
swell = gonfler
swift = prompt, rapide
swiftly = rapidement, vite
swim = nager
swimming-bath = piscine
swimming-pool = piscine
swimming trunks = slip de bain
swindle = frauder
swine = cochon, porc
swing = balancer, agiter, brandir
swirl = tourbilloner
swish = sussurer
Swiss = Suisse
switch = badine, baguette, allumer, tourner, interrupteur
Switzerland = Suisse
swoon = s'évanouir
swotch on = activer
sycamore = érable, platane
symbol = symbole
sympathetic = sympa, sympathique
sympathy = sympathie
syndicate = syndicat
Syria = Syrie
Syrian = Syrien
syrup = sirop
system = système