#setName = words_en_zu_S
#sideOneTitle = ENG
#sideTwoTitle = ZUL
Sabbath = uMgqibelo
sack = isaka, isikhwama
salad = ilisaladi, isaladi
salt = usawoti
sandwich = ilisendiwishi, isendiwishi
Sassenach = iNgisi, umNgisi
Saturday = uMgqibelo
sausage = isositshi
Saviour = uMsindisi
say = ukuthi
say goodbye = ukuvalelisa
say goodbye to = ukuvalelisa
scatter = ukuthela
school = isikolo
Scot = isiKoshi
Scotsman = isiKoshi
sea = ulwandle
see = ukuhlangana, ukubona, ukuvakashela
sell = ukuthengisa
send = ukuthumela
sentence = umusho
sergeant = ilisayini, isayini
serious = -phakeme
seven = isikhombisa
seventeen = ishumi nesikhombisa
shape = ifomu, ilifomu
shed = ukuthela
shelf = ilishalofu, ishalofu
shine = ukukhanya
ship = isikebhe
shirt = ihembe, ilihembe
shoe = isicathulo
shop = isitolo
should = ukufanele
show = ukukhombisa
shut off = ukuvala
sick = -gulayo
sign = ukusayina
signature = isayini
since = ngoba
sing = ukuhlabelela
sir = ubaba
sister = udade, usisi
sit = ukuhlala
six = -isithupha
sixteen = ishumi nesithupha
size = usayizi
skirt = ingubo
sky = ilizulu, izulu
slay = ukubulala
slice = ukusika
slow = -ephuzayo
small = -ncane
smoke = inthuthu
snack = ilantshi, ililantshi, indlamini
so = kanjalo
sole = -dwa
solicitor = ummeli
solitary = -dwa
something = into, noma yini
son = indodana
soon = masinya
sort = umhlobo
Sotho = isiSuthu, umSuthu
Sotho language = isiSuthu
soup = isobho
speak = ukukhuluma
spear = umkhonto
spectacles = izibuko
spinster = inkosazana
spoon = isipunu
spot = indawo
spring = entwasahlobo
springtime = entwasahlobo
stamp = isitembu
stand = ukusukuma, ukuma
stand up = ukusukuma
start = ukuqala
station = isiteshi
stay = ukuhlala, ukusala
stay over = ukuhlala, ukusala
steal = ukueba
stomach = isisu
stop = ukuvala
store = isitolo
storm = isiphepho
street = isitaladi
strength = amandla
strike = ukungqongqoza
string = intambo
student = isitshudeni
study = ukufunda
such = kanjalo
such a = kanjani
such as = kanjani
suffer = ukuhlupheka
suffice = ukuanele
sugar = ushukela
suggest = ukuphakamisa
summer = ihlobo
summon = ukubiza
sun = ilanga, ililanga
Sunday = iliSonto, iSonto
supermarket = ilisupamakethe, isupamakethe
supervise = ukuhlola
supply = ukudiliva
supporter = lilunga, ilunga
Swazi = isiSwati, umSwati
Swazi language = isiSwati
sweep = ukushanela
swiftly = ngokushesha
swim = ukubhukuda
swine = ingulube
switch off = ukuvala
table = ilitafula, itafula
take = ukuamukela, ukuthatha
take in = ukuamukela
take leave = ukuvalelisa
take leave from = ukuvalelisa
take off = ukukhumula
take over = ukuthenga
talk = ukukhuluma
tank = ilitanki, itanki
tardy = -phuzileyo
tasty = -mnandi
taxi = ilithekisi, ithekisi
tea = ilitiye, itiye
teach = ukufundisa
teacher = uthisha
telegram = ilitelegilamu, itelegilamu
telephone = ucingo, ulucingo, uthelefoni
television set = umabonwakude
tell = ukuthi, ukutshela
temperature = ithemperetsha
tempest = isiphepho
ten = ishumi
tender = ukuazisa, ukuethula, ukuphakamisa
tent = itende
terminate = ukuqeda
test = ukuzama
thanks = ngiyabonga, siyakubonga
thank you = ngiyabonga, siyakubonga
that = -ni, -phi, ubani, kanjalo
that's all right = akunandaba
that's okay = akunandaba
that way = kanjalo
the day before yesterday = kuthangi
there = lapho
there are = kukhona
there is = kukhona
these days = okwamanje
thief = izigebengu
thing = into
thirteen = ishumi nantathu
thirty = amashumi amathathu
thou = wena
three = -thathu
throat = umphimbo
Thursday = uLwesine
thus = kanjalo
ticket = ilithikithi, ithikithi
time = ihora, isikhathi
tin = ilithini, ithini
tip = umbhanselo
tobacco = ugwayi
today = namhlanje
toilet = ilithoyilethe, ithoyilethe
tomato = utamatisi
tomorrow = kusasa
tongue = ulimi, ululimi
too = futhi
tooth = ilizinyo, izinyo
tortoise = ufudu, ulufudu
town = idolobha, ilidolobha
tradition = ilisiko, isiko
train = isitimela
transmit = ukuthumela
travel = ukuhamba
treatment = impatho
trouble = inkinga
trousers = ibhulukwe, ilibhulukwe
trust = ukuethemba
truth = iliqiniso, iqiniso
try = ukuzama
Tsonga = isiTsonga, umTsonga
Tsonga language = isiTsonga
Tuesday = uLwesibili
turkey = ikalkuni
turn off = ukuvala
TV set = umabonwakude
twelve = -yishumi nambili
twenty = amashumi amabili
twice = kabili
two = -bili
ultimately = ekugcineni
uncle = umalume
under = phansi kwa-
underneath = phansi, phansi kwa-
understand = ukuqonda
unfortunately = ngeshwa
university = iliyunivesithi, iyunivesithi
unmarried woman = inkosazana
upon = phezu kwa-
use = ukusebenzisa
vegetable = uhlaza
vend = ukuthengisa
Venda = isiVenda, umVenda
Venda language = isiVenda
verify = ukuhlola
vessel = isikebhe
view = ukubukela
vigour = amandla
village = umuzi
visit = ukuvakashela
vote = ukuvota
wait = ukulinda
waiter = uweta
wait for = ukulinda
wake = ukuvuka
wake up = ukuvuka
walk = ukuhamba
want = ukufuna
warrant = igaranti, iligaranti
wash = ukugeza
watch = iliwashi, iwashi, ukubukela
water = amanzi
way = ilisiko, isiko, indlela, umgwaqo
weather = ilizulu, izulu
Wednesday = uLwesithathu
week = iliviki, iviki
well = kahle
wench = intombazane, intombi
what = -ni
what a = inhloboni, kanjani
what for = yini ndaba
what kind of = inhloboni
what sort of = inhloboni
wheel = ilisondo, isondo
wheelbarrow = ibhala, ilibhala
when = nini
where = -phi, kuphi
wherefore = yini ndaba
which = -phi, ubani
while = isikhathi
whiskey = uwiski
whisky = uwiski
white = -mhlophe
white man = umlungu
who = -phi, ubani
why = yini ndaba
wife = inkosikazi, umfazi
win = ukuhola, ukuwina
wind = umoya
window = ifasitela, ilifastela
winter = ubusika
wireless = ilirediyo, irediyo, umsakazo
wish = ukufisa, ukufuna
woman = umfazi
wonderful = -mangalisayo
word = igama
work = ukusebenza, umsebenzi
worker = isisebenzi
working man = isisebenzi
workman = isisebenzi
wrench = isikhiye, ukhiye
wrist-watch = iwashi
write = ukubhala
Xhosa = isiXhosa, umXhosa
Xhosa language = isiXhosa
yard = iyaladi, iliyaladi
ye = wena
year = umnyaka, unyaka
yes = yebo
yesterday = izolo
yet = nokho
yon = lapho
yonder = lapho
you = wena
young = -sha
youngster = insizwa
your = -kho
you're welcome = akunandaba
youth = insizwa
Yule = uKhisimuzi
zoo = ilizu, izu
Zulu = isiZulu, umZulu
Zululand = KwaZulu
Zulu language = isiZulu