#setName = words_en_fi_ab.txt
#sideOneTitle = ENG
#sideTwoTitle = FIN
a = -ssa, joku, kohti
abandon = alistua
abashment = pula
abbey = luostari
abdomen = vatsa
aberration = virhe
abet = kiihottaa, ‰rsytt‰‰
abide = odottaa, pysy‰, k‰rsi‰
able = kykenev‰, p‰tev‰
abnormity = s‰‰nnˆttˆmyys
abode = asuinpaikkakunta
abortive = turha
about = noin, -sta, ymp‰rill‰
above = yli, yl‰puolella
above all = etenkin
above-board = rehellinen
abrasive = ter‰v‰
abroad = ulkomailla
abrupt = jyrkk‰, ‰killinen
absence = poissaolo
absent = poissaoleva
absolute = t‰ydellinen
absolutely = ehdottomasti
absorb = ime‰
abstract = abstraktinen, tehd‰ johtop‰‰tˆs, tehd‰ yhteenveto
absurd = j‰rjetˆn
abundant = runsas
abuse = kiduttaa
academy = akademia
academy of music = musiikiopisto
accede = suostua
accelerate = kiihdytt‰‰
accelerator = kaasupoljin
accelerator pedal = kaasupoljin
accent = mahtipontisuus
accept = ottaa vastaan
acceptance = hyv‰ksyminen
accidence = sattuma
accident = onnettomuus, tapaturma
accidental = muu
acclaim = taputtaa k‰si‰‰n
acclivity = rinne
accomodate = lopetta, auttaa
accompany = saattaa
accomplish = saavuttaa
accomplished = p‰tev‰, kokenut
accord = sopimus, sallia
accordance = sopimus
according as = pitkin
accordingly = siis
according to = pitkin
accordion = harmonikka
account = syy, harkita, tili, uskoa, vaikutin, arvella
accredit = uskoa
accrue = kasvaa
accumulation = kasa
accurate = t‰sm‰llinen, tarkka
accuse = syytt‰‰, antaa ilmi
acerbic = ter‰v‰
ache = kaivata
achieve = hankkia, saavuttaa, tehd‰
achievement = teko
acid = happo, ter‰v‰
acknowledge = vahvistaa
acme = huippukohta
acolyte = j‰sen
acquire = hankkia, ostaa
acquisitive = ahne
acrid = ter‰v‰
acrimonious = ter‰v‰
across = poikki
across from = vastaan
act = toimia, teko, vaikuttaa, tehd‰, esitt‰‰, menetell‰
action = teko
actor = n‰yttelij‰
actual = todellinen
actuate = liikuttaa
acute = ter‰v‰, voimakas
ad = ilmoitus, mainos
add = laskea yhteen, lis‰t‰
additional = muu
addled = tyhm‰
address = osoite
add up = laskea yhteen
adept = mestari, kokenut
adieu = hyv‰sti
adjective = adjektiivi
ad-lib = improvisoida
admission = hyv‰ksyminen
admit = sallia
admonish = kehottaa
adroit = taitava
adult = aikuinen
advance = edisty‰
advantageous = suopea, hyˆdyllinen
adverb = adverbi
advert = mainos
advertisement = ilmoitus, mainos
advice = neuvoa
advise = neuvoa
aeroplane = lentokone
affable = yst‰v‰llinen
affair = asia, sija
affirm = myˆnt‰‰
affix = kiinnitt‰‰
affluent = rikas
afford = sallia, tuottaa
afresh = j‰lleen
Africa = Afrikka
African = afrikkalainen
after = j‰lkeen
afternoon = iltap‰iv‰
afterwards = sitten
again = j‰lleen
against = vastaan
age = ik‰, ajanjakso
agent = agentti, koje
agitate = kiihottaa, ‰rsytt‰‰, pudistaa
agitation = mellakka
agonize = kiduttaa
agony = tuska
agree = suostua
agreeable = miellytt‰v‰
agreement = sopimus
ague = kuume
aid = auttaa
aim = maali, p‰‰m‰‰r‰, ponnistella, koettaa
air = ilma
airplane = lentokone
airport = lentokentt‰
alacrity = innostus
alarm = ‰llistytt‰‰, kauhu
alas = surukseni
album = albumi
ale = olut
alien = vieras
alike = yht‰l‰inen
a little = jonkin verran
all = kaikenlainen, kaikki
all about = kaikkialla
allergy = herkistym‰
all over again = j‰lleen
allow = j‰tt‰‰, sallia
all the = jokainen
allude = viitata
almost = melkein
alone = yksin, ainoastaan, vain
a lot of = moni
already = jo
also = myˆs
although = vaikka
altitude = korkeus
altogether = kaikki
always = aina
America = Amerikka
American = amerikkalainen
among = kesken
amount = summa
amuse = huvittaa
anchor = ankkuri
and = ja
anew = j‰lleen
angel = enkeli
anguish = tuska
animal = el‰in
annotation = muistiinpano
anoint = voidella
anomaly = s‰‰nnˆttˆmyys
another = toinen
answer = vastata
any = joku
anybody = joku
anything = jokin
anyway = jotenkin
anywhere = jossakin
apart = eri
apart from = paitsi
ape = apina
appal = ‰llistytt‰‰
apparatus = koje
appear = tulla n‰kyviin, n‰ytt‰‰
appear to be = n‰ytt‰‰
appellation = nimi
appetite = ruokahalu
applaud = taputtaa k‰si‰‰n
apple = omena
appraise = arvioida
appreciate = arvostaa
approve = hyv‰ksy‰
approximately = noin
April = huhtikuu
aptitude = kyky
Arab = arabi
Arabian = arabialainen
Arabic = arabialainen
arbitrary = mielivaltainen
arc = kaari
architect = arkkitehti
argument = perustelu
arise = synty‰
arm = k‰sivarsi
armchair = nojatuoli
army = armeija, sotajoukko, sotav‰ki
around = -sta, ymp‰rill‰
arouse = her‰tt‰‰
arrange = j‰rjest‰‰
arrive = saapua
art = taide
article = esine
as = milloin, miten, pitkin, siten, koska
ascertain = todeta
ash = tuhka
Asia = Aasia
Asian = aasialainen
Asiatic = aasialainen
as if = ik‰‰nkuin
ask = kysy‰, pyyt‰‰
ask for = pyyt‰‰
asparagus = parsa
aspen = haapa
aspire = pyrki‰
aspire to = pyrki‰
ass = aasi
assault = hyˆk‰t‰
assemblage = kokous
assemble = asentaa
assent = myˆnt‰‰
assist = auttaa
associate = liitty‰
as though = ik‰‰nkuin
at = -lle, vieress‰, kohti, luona
at all = tahansa, aivan
Atlantic = Atlantti
Atlantic Ocean = Atlantti
at least = ainakin
atmosphere = ilmapiiri
at once = heti
at present = nyt
at some time = jolloinkin
attach = kiinnitt‰‰
attack = hyˆk‰t‰
attain = hankkia, saavuttaa
attempt = ponnistella, koettaa
attend = hoitaa, k‰yd‰ vieraissa
attentive = tarkkaavainen
attest = todistaa
at that place = siell‰
at the rate of = kohti
attitudinize = olla olevinaan
attract = houkutella
audit = tarkastaa
auditor = tarkastaja
August = elokuu
aurora = aamurusko
Australia = Australia
Australian = australialainen
authority = arvovalta
automobile = auto
autumn = syksy
avaricious = saita
avenge = kostaa
avenge oneself = kostaa
average = keskiarvo, keskipiste
avoid = v‰ltt‰‰
await = odottaa
awaken = her‰tt‰‰
away = pois
baby = vauva
bachelor = poikamies
back = selk‰
background = tausta
back of the neck = niska
bacon = ihra
badger = m‰yr‰
bag = s‰kki
bairn = lapsi
bake = leipoa
ball = tanssiaiset, pallo
ball-bearing = pallo
band = orkesteri
bank = ranta
banner = lippu
bar = aidata
bare = alaston
barely = tuskin
bark = pursi, haukkua
barque = pursi
barrel = putki
barrier = aidata
base = alusta
basement = kellari
basin = vati
basis = alusta
bass = ahven
bathe = kylvett‰‰
baton = keppi
be = olla
be able to = voida
be acquainted with = tuntea
be afraid of = pel‰t‰
beak = nokka
be alive = el‰‰
beam = s‰de, hirsi
be angry = suuttua
be appropriate = sopia
bear = synnytt‰‰, tuottaa, k‰rsi‰
beard = parta
bear witness of = todistaa
be asleep = nukkua
beast = el‰in
beat = lyˆd‰
beautiful = kaunis
be aware of = tajuta
be bored = ik‰vˆid‰
be born = synty‰
be called = olla nimelt‰‰n
because = koska
because of = vuoksi
become = tulla joksikin
be conscious of = tajuta
bed = vuode
be delirious = hourailla
be different = erota
bee = mehil‰inen
be effective = vaikuttaa
beer = olut
befit = sopia
be fitting = sopia
before = edess‰
beg = pyyt‰‰
beget = siitt‰‰
begin = alkaa, aloittaa
beginning = alku
behave = k‰ytt‰yty‰
behind = j‰lkeen
behold = t‰ss‰
be indignant = n‰rk‰sty‰
be in labour = synnytt‰‰
be lacking = puuttua
be lenient with = armahtaa
believe = uskoa
belles-lettres = kaunokirjallisuus
bellow = ammua
belly = vatsa
below = alla
belt = vyˆ
be missing = puuttua
bench = pulpetti, alusta
bend = taivuttaa, kallistaa
beneath = alla
bent = k‰yr‰
be on duty = p‰ivyst‰‰
be quiet = vaieta
be right = olla oikeassa
beside = vieress‰, luona
besides = paitsi
be situated = sijaita
be sorry about = valittaa
be suitable = sopia, kelvata
bet = lyˆd‰ vetoa
be tired of something = ik‰vˆid‰
betray = pett‰‰
between = kesken
be vacant = olla avoinna
be willing to = tahtoa
bewitch = taikoa
be worthy of = ansaita
beyond = ohi, poikki
bicycle = polkupyˆr‰, jakso
bid = pyyt‰‰
big = iso
bike = polkupyˆr‰, jakso
bill = nokka, lippu
bind = sitoa
binding = nauha
binocular = kiikari
binoculars = kiikari
birch = koivu
bird = lintu
bit = pala
bite = purra
black = musta
blade = ter‰
blame = syytt‰‰, moittia
blank = valkea
blaspheme = herjata
bleat = ammua
blend = sekoittaa
bless = siunata
blind = sokea
blond = vaalea
blood = veri
bloom = kukka
blot = tahra
blotter = imupaperi, imuri
blotting paper = imupaperi, imuri
blouse = pusero
blow = puhaltaa
blue = sininen
blueberry = mustikka
blunt = tylpp‰, tyls‰
blushing = punainen
board = taulu
boat = soutuvene, pursi
body = ruumis
boil = kiehua
bold = paksu
bolt = lukita
bomb = pommi
bone = luu
book = kirja, tilata
bookcase = kirjakaappi
book-keeper = kirjanpit‰j‰
bookshop = kirjakauppa
bookstore = kirjakauppa
boot = saapas
border = ranta, reuna
bore = porata, ik‰vystyy‰‰
borrow = lainata
bosom = rinta
boss = is‰nt‰, p‰‰llikkˆ
botch = hutiloida
both = molemmat
bother = vaivata
bottle = pullo
bottom = pohja
bough = oksa
boundary = raja
boutique = myym‰l‰
bovine = h‰rk‰
bovine animal = h‰rk‰
bow = kaari
bowl = vati
box = rasia, s‰iliˆ
boy = poika
boyscout = partiolainen
boy scout = partiolainen
brain = aivot
brake = jarru
branch = oksa, lokero
brandish = heiluttaa
brandy = konjakki
brave = uljas, rohkea
Brazil = Brasilia
Brazilian = brasilialainen
bread = leip‰
break = tauko, s‰rke‰
breakfast = aamiainen
bream = lahna
breast = rinta, nis‰
breathe = hengitt‰‰
breed = kasvattaa, rotu
bridge = silta
bright = loistava, vaalea
brilliant = loistava
brim = reuna
bring up = kasvattaa
brink = reuna
Britain = Iso-Britannia
British = brittil‰inen
broad = leve‰
brother = veli
brown = ruskea
brush = harja
bucket = ‰mp‰ri
buffet = tarjoiluhuone
bug = hyˆnteinen
build = rakentaa, veist‰‰
build from wood = veist‰‰
bulk = laajuus
bullet = kuula
bump = kyttyr‰
bungle = hutiloida
buoy = poiju
burden = lasti
burn = palaa
burst = haljeta
business = asia, kauppa
business deal = asia
but = mutta, kuitenkin
butcher = teurastaa
butter = voi
butterfly = perhonen
button = nappi
buy = ostaa, ostaa, ostaa
buzz = surista
by = vieress‰, -lta, pitkin, -lla, ohi
bye = hyv‰sti
by means of = -lla
by no means = ei kuinkaan
by now = jo