#setName = words_fi_en_os
#sideOneTitle = FIN
#sideTwoTitle = ENG
odottaa = abide, expect, wait, await, wait for
ohi = beyond, by, past, straight past
ohjelmoida = programme
oikea = correct, exact, proper, right
oikeanpuolinen = right, righthand
oikeudenmukainen = fair, just, righteous
oikeus = right
oikku = caprice, whim
ojentaa = extend, strech out
oksa = bough, branch
olemus = essence, gist
olettaa = guess, presume, suppose, surmise
oliivi = olive
oliiviˆljy = oil of olives, olive-oil
olio = chap, guy, fellow, person
olkavarsi = upper arm, upper-arm
olla avoinna = be vacant
olla k‰velyll‰ = go for a walk, stroll
olla nimelt‰‰n = be called
olla oikeassa = be right
olla olemassa = exist
olla olevinaan = attitudinize, pose, put on airs
olla velkaa = owe
olla v‰litt‰m‰tt‰ = ignore, leave out of account
olut = ale, beer
oma = own, personal
omatunto = conscience
omena = apple
ominaisuus = property, quality
omistaa = have, have got, own, possess
onnellinen = fortunate, happy
onnetar = fortune
onnettomuus = accident
onnitella = congratulate
ooppera = opera
opastaa = conduct, direct, guide, head, lead
opettaa = teach
opiskella = study
oppia = learn
orava = squirrel
orkesteri = band
orvokki = violet
osa = part, piece, share, destiny, fate, fortune, luck
osake = share
osanen = element, fragment, item, particle
osoite = address
ostaa = buy, purchase, take over
osua = striking
otaksua = conjecture, surmise
ottaa = get, lay hold of, pick up, take
ottaa vastaan = accept, receive, take, take in
ovi = door
paeta = flee, run away
paikka = location, place, spot, position
painaa = weigh, print
painia = struggle, wrestle
painos = edition
paistaa = roast, toast
paita = shirt
paitsi = apart from, besides, except, except for
pakastaa = freeze
pakata = pack
Pakistan = Pakistan
pakistanilainen = Pakistani
paksu = bold, corpulent, fat, thick
pala = bit, lump, piece
palaa = burn
paljonko = how many, how much
palkata = employ, hire
palkinto = premium, prize
palkka = salary, wage, wages
pallo = ball, ball-bearing, globe, ball
palopommi = incendiary bomb
palvella = serve
panna = lay down, place, put, put down
pannu = frying-pan, frying pan
paperi = paper
papukaija = parrot
parantaa = care for, cure, treat
pari = pair
parsa = asparagus
parta = beard
partiolainen = scout, boyscout, boy scout
parveke = gallery
passi = passport
pato = dike, embankment
patsas = statue
pehme‰ = soft
peili = looking-glass, mirror
peitt‰‰ = cover
pelastaa = keep, save, rescue
pelti = sheet metal, tin, tin plate
pelto = field, field
pel‰t‰ = be afraid of, fear
peninkulma = mile
pensasaita = hedge
perhe = family
perhonen = butterfly
perinne = tradition
peri‰ = inherit
perjantai = Friday
persikka = peach
persilja = parsley
peruna = potato
perustaa = erect, establish, found
perustelu = argument, plea
pest‰ = wash
pes‰ = den, nest
pett‰‰ = betray, cheat, deceive
peukalo = thumb, thumb
piano = piano
pidin = holder, socket
piha = court, yard, courtyard
piikki = thorn
piilottaa = conceal, hide
piippu = pipe
piirre = feature, trait
piirt‰‰ = design, draw
piki = pitch
pikkuinen = tiny
pilata = damage, injure, spoil
pilkata = jeer at, make fun of, mock
pilvi = cloud
pinaatti = spinach
piparjuuri = horse-radish, horseradish
pippuri = pepper
piste = dot, period, point, spot
pist‰‰ = pick, stab, sting
pitkin = according as, according to, as, by
pitk‰ = long
pit‰‰ = hang onto, hold
pit‰‰ parempana = prefer
pizza = pizza
pohja = bottom, foundation, ground
pohjoinen = north, North
pohtia = discuss
poiju = buoy
poika = son, boy, lad, laddie
poiketa = turn
poikki = across, beyond, on the other side of
pois = away
poissaoleva = absent, absent
poissaolo = absence, non-attendance, absence
poljin = pedal
polkka = polka
polku = path
polkupyˆr‰ = bike, cycle, bicycle
polttoaine = fuel
polvi = knee
pommi = bomb
ponnistella = aim, attempt, endeavour, take steps, undertake
porata = bore, drill
porkkana = carrot
porras = stair, step, rung
porvari = middleclass citizen
poski = cheek
posti = mail, post
postilaatikko = letterbox, mailbox
postimaksu = postage
postimerkkeily = philately, stamp-collecting
potkuri = helix, propeller
proomu = ferry
protestanttinen = Protestant
pudistaa = agitate, shake, shock
pudota = drop, fall
puhaltaa = blow
puhdas = clean, pure, pure, clean
puhelin = telephone
puhemies = chairman, president
puhua = speak, talk
puida = thresh
puisto = park
puku = costume, outfit, suit, dress, gown, robe
pula = abashment, embarrassment, perplexity
pullo = bottle
pulpetti = bench
pumpata = pump
punainen = red, red
Punainen Risti = Red Cross
puolalainen = Pole
puolikas = half
puoliso = husband
puoskari = charlatan, imposter, quack
puristaa = press, oppress, squeeze
purje = sail
purra = bite
pursi = bark, barque, boat, ship's boat, shallop, sloop
pusero = blouse
putki = barrel, channel, pipe, tube
puu = tree, timber, wood
puuro = gruel, mess, mush
puutarha = garden
puuttua = be lacking, be missing
puuvilla = cotton
pylv‰s = column, pillar
pyrki‰ = aspire, aspire to, hope for, strive for
pysyv‰ = constant, continual, permanent, sustained
pysy‰ = abide, persevere, persist
pys‰hty‰ = halt, come to a halt, stop
pyydyst‰‰ = capture, catch, grapple
pyyt‰‰ = ask, ask for, beg, bid, request
pyˆre‰ = round
pyˆrty‰ = faint, swoon
pyˆr‰ = wheel
p‰hkin‰ = nut
p‰ivyst‰‰ = be on duty, serve
p‰iv‰ = day
p‰iv‰m‰‰r‰ = date
p‰iv‰ntasaaja = equator
p‰ssi = sheep
p‰tev‰ = able, accomplished, competent, valid
p‰‰ = head, pate, head, pate
p‰‰llikkˆ = boss, chief, leader, chief, boss
p‰‰m‰‰r‰ = aim, goal, purpose, target
p‰‰ryn‰ = pear
p‰‰si‰inen = Easter
p‰‰skynen = swallow
p‰‰st‰ karkuun = escape, flee
p‰‰tt‰‰ = decide
pˆly = dust
pˆyt‰ = table
raaka = crude, raw, rough
raapia = scrape, scratch
radio = radio, wireless
raesade = hail
raha = money
rahasto = fund
raihnas = decayed, decrepit, dilapidated, lapsed, rickety
raitiovaunu = streetcar, tram
raivoisa = furious
raja = boundary, frontier, limit
rakastaa = love
rakentaa = build, construct
rangaista = punish
ranskalainen = French, Frenchman
ranta = bank, border, edge, shore
rasia = box
rasva = fat, grease
ratsastaa = ride
rauha = peace
rauta = iron
rautatie = railroad, railway
rautatieasema = station
ravintola = restaurant
ravita = feed, nourish
rehellinen = above-board, honest
reik‰ = hole
reisi = thigh
rengas = ring
repale = rag, scrap
repi‰ = rip, tear
retiisi = radish
reuna = border, brim, brink, edge, edging, fringe, rim
riimi = rhyme
riippua = droop, hang
riisi = rice
riitt‰‰ = suffice
rikas = affluent, rich, wealthy, well-off
rimpuilla = flounder, struggle, writhe
rinne = acclivity, hillside, slope
rinta = bosom, breast, chest
risteill‰ = cruise
risti = cross
ristiriita = conflict
risuaita = grid, hash, number sign, pound sign, sharp
riuku = lath, slat
rivi = file, line, rank, row, turn
rohkea = brave, courageous, valiant
roisto = cheat, crook, rogue
romanssi = romance
romantiikka = romanticism
rommi = rum
rotta = rat
rotu = breed, race
rukoilla = pray
rumpu = drum
runotar = muse
runsas = abundant, copious, plentiful, profuse
ruoho = grass, herb, grass
ruokahalu = appetite
ruokalista = menu
ruoste = rust
ruotsalainen = Swedish, Swede
Ruotsi = Sweden
ruskea = brown
ruukku = jug, pot
ruumis = cadaver, corpse, body
ruusu = rose
ruuvi = screw
ryhm‰ = group
ryp‰le = grape
rytmi = rhythm
ryˆst‰‰ = plunder, rob
r‰j‰ht‰‰ = explode
saada = get, have, receive
saakka = until, till
saalis = prey
saapas = boot
saapua = arrive, end up, get
saari = island
saattaa = accompany
saavuttaa = accomplish, achieve, attain, get, reach
sade = rain
sahata = saw
saippua = soap
saita = avaricious, miserly, stingy
Saksa = Germany
saksalainen = German, German
saksanp‰hkin‰ = walnut
salama = lightning
sallia = accord, admit, afford, allow, permit
samanlainen = same
sammakko = frog
sammuttaa = extinguish, put out
sana = word
sangen = quite, very, very much
sankari = hero
sanoa = say, tell
sanoma = errand, message
sanomalehti = gazette, magazine, newspaper, periodical
sata = hundred, one hundred
sataa = rain
satama = harbor, harbour, port
sattuma = accidence, chance, hazard
savi = clay
savuke = cigarette
savuta = smoke
se = that, that over there, those, that, that one, yonder, it
seikkaper‰inen = detailed
sein‰ = wall
seisoa = stand
seitsem‰n = seven
seitsem‰nkymment‰ = seventy
seitsem‰ntoista = seventeen
seitsem‰s = seventh
sekoittaa = blend, mingle, mix, shuffle
sekunti = second
selk‰ = back
selk‰ranka = spine
sello = cello
selostaa = give an account, report, review
selv‰ = clear, distinct, plain
sentti = cent
set‰ = uncle
seura = circle, club, society
seurakunta = parish, parish
seurata = follow
sianliha = pork
sielu = soul
sieni = fungus, mushroom, sponge
sihteeri = secretary
siideri = cider
siis = accordingly, so, then, therefore
siitt‰‰ = beget, generate
sija = affair, case, matter
sijaan = instead of
sijaita = be situated
sika = hog, pig, swine
siksi = on that account, therefore
sile‰ = smooth
silli = herring
silloin = then
silm‰ = eye
silta = bridge
sinappi = mustard
sinfonia = symphony
sininen = blue
sinne = that way, there, thither, yonder
sipuli = onion
sirkus = circus
siro = graceful
sis‰inen = inner, inside, internal
siteerata = cite, quote
siten = so, such, thus
sitoa = bind, connect, join, tie, tie up
sitruuna = lemon
sitten = afterwards, next, subsequently
siunata = bless
siveellisyys = morals
sivistynyt = cultured, educated, learned, well-informed
sivu = side, page
Skotlanti = Scotland
skotlantilainen = Scottish, Scot, Scotsman
sohva = sofa
soida = sound, peal, ring
soikea = oval
sointuoppi = harmonica
soitin = musical instrument
sokea = blind
sokeri = sugar
solmu = knot, node
solu = cell
sonaatti = sonata
sopia = befit, be fitting, be appropriate, suit, be suitable
sopimus = accord, accordance, agreement, concurrence, accord, accordance, agreement, concurrence
sora = gravel, grit
sormi = finger
sorsa = duck
sorvata = turn
sota = war
sotajoukko = army, army
sotav‰ki = army, army
soutaa = row
soutuvene = boat
-ssa = a, in, inside, into, on, per, within
-sta = about, concerning, on, upon, about, round, around, towards
sudenkorento = dragonfly
suhista = rustle, swish
suhtautua = concern, relate
suhteellinen = relative
suihkuttaa = shower
sukka = stocking
suklaa = chocolate
sukulainen = relative
sukupolvi = generation
sukupuoli = sex
sukupuoliyhdynt‰ = coition
sulattaa = melt
sulhanen = fiancÈ
sulkea = close, shut
sulku = lock, sluice
suloinen = charming, lovely
summa = amount, sum
sumu = fog, mist
sunnuntai = Sunday
suo = marsh, swamp
suodattaa = filter
suojata = shelter, protect
suojella = protect
suola = salt
suoli = intestine
suomalainen = Finnish, Finn
suomen kieli = Finnish, Finnish language
suomi = Finnish, Finnish language
suopea = advantageous, favourable
suora = direct, straight
suositella = commend, recommend, register
suostua = accede, agree, consent
suostuttaa = persuade
supistaa = reduce
surista = buzz, hum
surukseni = alas, regrettably, unfortunately
surullinen = dismal, dreary, sad
survoa = crush, pound
susi = wolf
suu = mouth, mouth
suudella = kiss
suunnata = direct, guide, manage, steer
suunnitella = plan
suuttua = be angry
suvaitsevainen = tolerant
Sveitsi = Switzerland
sveitsil‰inen = Swiss, Swiss
syd‰n = heart
syksy = autumn
synnytt‰‰ = give birth, labour, be in labour, bear, give birth to
synti = sin, transgression
synty‰ = arise, be born
syv‰ = deep, profound
syy = cause, reason, account, reason
syyllinen = guilty
syyskuu = September
syytt‰‰ = accuse, accuse, blame
syˆd‰ = eat, feed
s‰de = beam, ray
s‰e = verse
s‰hkˆ = electricity
s‰ie = fiber, fibre
s‰iliˆ = jug, box, container, vessel
s‰ilytt‰‰ = conserve, keep, maintain, preserve
s‰kki = bag, sack
s‰mpyl‰ = roll
s‰rke‰ = break
s‰velasteikko = gamut, key, scale
s‰velm‰ = melody, tune
s‰velt‰‰ = compose
s‰‰ = weather
s‰‰li‰ = have compassion on, pity
s‰‰nnˆnmukainen = normal
s‰‰nnˆttˆmyys = abnormity, anomaly
s‰‰ntˆ = norm, standard
s‰‰ri = leg, paw
s‰‰st‰‰ = save, spare