#setName = words_en_sv_v
#sideOneTitle = ENG
#sideTwoTitle = SWE
vacation = ferier, semester
vaccinate = vaccinera
vaccine = vaccin
vacuum-cleaner = dammsugare
vacuum cleaner = dammsugare
valiant = behjärtad, tapper
valley = dal, däld
value = valör, värde
valve = ventil
vampire = vampyr
vanilla = vanilj
vapor = dunst, imma
vapour = dunst, imma
varnish = fernissa
vary = variera
vase = vas
vast = rymlig, vid
vat = kar
vegetable = grönsaker
vehicle = fordon, åkdon
veil = dok
vein = åder, ådra
vend = avyttra, försälja, sälja
vengeance = hämnd
venture = riskera, våga, äventyra
veranda = veranda
verb = verb
verdict = dom
verify = besiktiga, kontrollera
vermin = ohyra
vermouth = vermut
very = bra, hart, mycket, mäkta
very much = bra, hart, mycket, mäkta
vessel = skål, stop, så, urna, vas, fartyg, skepp
vest = skjorta
vibrate = dallra
vicar = präst, katolsk präst
victim = slaktoffer
victor = besegrare
view = anblick, anseende, utsikt, vy, beskåda, kika, skåda, titta
viewpoint = synpunkt
vigour = kraft, styrka
viking = viking
vile = nedrig
village = by
villain = träl
vine = vinstock
vinegar = ättika
violet = viol
violin = violin
viper = huggorm
virgin = jungfrulig, jungfru
virginal = jungfrulig
visa = visum
visé = visum
visible = skönjbar, synlig
visit = besök, visit
visitor = besökande
vixen = ragata, rävhona
viz. = nämligen
vocabulary = ordbok
voice = mål, stämma, röst
void = tom
volcano = vulkan
Volt = volt
volume = volym
voluntary = godvillig, självmant, gärna
vomit = kräkas, spy
vote = rösta, mål, röst, stämma
vowel = självljud
voyage = färd, resa
vulgar = trivial
vulture = gam
wadding = vadd
wade = vada
waffle = våffla
wage = arvode, avlöning, lön, sold
wager = tippa
wages = arvode, avlöning, lön, sold
wage war = kriga
wait = forvänta, vänta, vänta sig
waiter = kypare, vaktmästare
wait for = forvänta, vänta, vänta sig
waiting-room = väntrum, väntsal
waiting room = väntrum, väntsal
wake = väcka, vakna
wake up = väcka, vakna
walk = gå, löpa, promenad, spatsertur
wall = mur, vägg
wall covering = tapet
wallet = börs, portmonnä
Walloon = vallon
wall-paper = tapet
walnut = valnöt
wander = irra
want = behov, förnödenhet, längtan, önskan, vilja
war = krig
wardrobe = garderob, klädskåp
warehouse = magasin
wares = vara
warlike = krigisk
warm = hjärtlig, hjärtlig, varm
warmth = värme
warn = varna, varsko, åtvarna
warrant = garantera
warrior = krigare, militär
wart = vårta
wash = tvätta
washing-accomodation = tvättrum
washing-bear = sjubb
wash-place = tvättrum
wash-room = tvättrum
wasp = geting
waste = slösa, öda, ödsla, slöseri
watch = armbandsur, klockarmband, klocka, ur, beskåda, beskåda, kika, skåda, titta
watchmaker = urmakare
watch out for = beakta
watch over = vakta
watchword = devis
water = vatten
water-bottle = fältflaska
water-closet = wc
water-colour = akvarell
waterfall = vattenfall, kaskad, vattenfall
waterlily = näckros
wave = bölja, svinga
wave about = svinga
wax = vax
way = bana, vana, maner, sätt, gång, stråt, väg
way out = utgång
weak = klen, svag
wealth = rikedom
wealthy = rik
weapon = vapen
wear = bära
wear out = utnöta
weasel = mård, vessla
weather = väder
weave = väva
wedding = bröllop
wedding-feast = bröllop
wedding-party = bröllop
Wednesday = onsdag
week = vecka
week-end = veckoslut
weep = grina, gråta
Wee Willie Winkie = Jon Blund
weight = vikt
welcome = välkommen
well = bra, väl, bläckhorn, nå, nåväl, sund
well-known = bekant, känd, veterlig
well-mannered = artig, hövlig
well-off = rik
well then = nå, nåväl
wench = flicka, jänta, mö, tös
west = väst, väster
western = västlig, västra
West Indies = Västindien
wet = våt
whale = val, valfisk
wharf = kaj, perrong
what = vad
what a = hur, huru, liksom, såsom
what a pity = det var synd, tyvärr
wheat = vete
wheel = hjul
when = när, när
whence = varifrån
where = varthän, vart, varthän, där, var
where ... to = varthän, vart, varthän
which = som, vem, vilken
which one's = vars
while = tid
whim = hugskott, kapris, nyck
whisper = tissla, viska
white = hvit, blank, vit, vit
whither = varthän, vart, varthän
Whitsunday = pingst
who = som, vem, vilken
whole = hel
wholly = alldeles
whore = hora, sköka
whose = vars
wide = rymlig, vid
widow = änka
widower = änkeman, änkling
width = vidd, bredd
wife = hustru, maka, äkta maka
wig = peruk
wild = ostyrig, vild, vildsint
wild boar = vildsvin
wild duck = and
will = testamente, vilja
willing = gärna
willingness = vilja
willow = pil, vide
win = förtjäna
wind = vind
window = fönster
wine = vin
wing = vinge
win over = besegra
winter = vinterlig, vinter
winter- = vinterlig
wipe out = utplåna
wireless = radio
wisdom = klokhet, visdom, vishet
wise = klok, vettig
wish = önska, längtan, önskan, vilja
witch = häxa
witchcraft = trolleri
with = med, per, vid
within = i
without = förutan, utan
without a name = anonym
with reference to = angående
with young = havande, dräktig
witness = bevista, åse
witty = spirituell
wizardry = trolleri
woe = ve
wolf = ulv, varg
wolverine = järv
woman = kvinna
womb = livmoder
wonder = förvåna sig, undra, förundran, förvåning, undran
wonted = bruklig, gemen, gångbar, ordinär, vanlig, övlig
wood = trä
wooden = av trä, trä-
woodpecker = hackspett
woods = skog
wool = ull, ylle
word = ord
work = arbeta, verka, arbete, verk
worker = arbetare
work hard = gno, träla
working man = arbetare
workman = arbetare
work of art = konstalster, konstföremål
work out = beräkna, uträkna
work-room = ateljé
workshop = ateljé
world = värld
worldglobe = jordglob, jordklot
worldwide = universal, universell
worm = mask
worn out = genomtrött, uppgiven
worse = sämre
worship = förära, tillbedja
worshipper = tillbedjare
worst = sämst
worth = valör, värde
worthless = värdelös
worthy = värdig
wound = såra, sår
wrangle = gräla, tvista
wreath = girland
wrench = nyckel
wrist = handlov, handlove, handled
wrist-watch = armbandsur, klockarmband
write = skriva, komponera
write down = annotera, anteckna, notera
writer = författare
writing-desk = skrivbord
writing desk = skrivbord
wrong = oriktig, orätt
Xanthippe = ragata
xylophone = xylofon
yacht = jakt
yard = rå, gård, gårdstomt
ye = du, ni
year = år
yearn = längta efter, smäkta
yeast = jäst
yellow = gul
yes = ja
yesterday = igår
yet = desslikes, ännu, allaredan, redan, ren, likafullt, oaktat
yield = cedere
yoghourt = yoghurt
yoghurt = yoghurt
yon = där
yonder = dit, där
you = ni, ni, du, ni
young = ung, ungdomlig
youngster = ungdom
you're welcome = det gör ingenting, för all del, ingen orsak
youth = uppväxtår, ungdom
Yule = jul
zenith = zenit
zephyr = sefyr
zero = noll, nolla
zilch = nolla
zinc = zink
ZIP code = postnummer
zipper = blixtlås
zone = bälte, gördel, rem, zon
zoology = zoologi