#setName = words_en_sv_dd
#sideOneTitle = ENG
#sideTwoTitle = SWE
daffodil = narciss
dagger = dolk
daily = alldaglig
daily paper = dagblad, journal
Dalecarlia = Dalarna
damage = haveri
dame = dam
dance = bal, dansa, dans
dancer = dansös
dandruff = mjäll
Dane = dansk
danger = fara, våda
dangerous = farlig, vådlig
Danish = dansk
dare = töras, våga
darkness = dunkelhet, mörker
darling = älskling
data = material
date = dadel, datera, datum
date-palm = dadelpalm
date palm = dadelpalm
daughter = dotter
daughter-in-law = sonhustru, svärdotter
dawn = dagning
day = dag
daybreak = dagning
dazed = oredig
dazzle = blända, förblinda, förblända
dead = avliden, död
deadly = dödlig
deaf = döv
deaf and dumb = dövstum
deal with = behandla, traktera
dear = ansedd, kär, rar, söt, dyr, dyrbar
death = död
debt = skuld
decanter = karaff, karaffin
deceitful = bedräglig
deceive = bedra, bedraga, lura, narra
deceiver = bedragare
December = december
decide = besluta
declaim = deklamera
declaration = förklaring
declaration of policy = program
declare = betyga, förklara
decorate = smycka
decree = dekret
dedicate = ägna
deem = tro, anse, tycka, beskåda, kika, skåda, titta
deep = djup
deer = hjort, hjärna
defeat = nederlag, besegra
defence = försvar, värn
defend = försvara, värja, värna
defense = försvar, värn
defiantly = trots
deformed = abnorm
defray the cost of = bekosta
degree = grad, titel
delay = anstånd, uppskov
deliver = avleverera, leverera
delivery = leverans
delta = delta
democracy = folkvälde
demolish = slopa
demonstrate = exponera
den = ruckel, kyffe, näste
Denmark = Danmark
dentist = dentist, tandläkare
deny = förneka, neka
depart = ge sig iväg
department = fack, yrke
dependant on = beroende
dependence = beroende
dependent = avhängig, beroende
deportment = beteende, uppförande
deposit = deponera
depository = lada
depressed = deprimerad, nedstämd
depression = kris
depth = djup, djuphet, djuplek
derive = härstamma
describe = beskriva
description = beskrivning
desert = ödemark, öken, lämna
deserving = värdig
design = rita, teckna, ritning, teckning
desire = önska, längtan, önskan
desk = skrivbord
desolate = tröstlös
despair = misströsta, förtvivlan, misströstan
desperate = desperat, förtvivlad, hopplös
despise = förakta, missakta
despite = trots
despotic = despotisk
dessert = efterrätt
destroy = förinta, förstöra
detached = fristående
detached house = fristående hus
detail = detalj
detective = detektiv
detention = häkte
determine = befästa, fästa
detrimental = ofördelaktig
device = apparat
devil = djävul, fan
devote = ägna
dew = dagg
diabetes = sockersjuka
diagram = figur, gestalt
dial = platta, skiva
dialect = allmogespråk, bygdemål, dialekt, folkmål, landsmål
diamond = diamant
diarrhoea = diarré
diary = diarium
dictate = diktera
dictionary = ordbok
die = avlida, dö, tärning
diet = diet
difference = olikhet, skillnad
different = olik, olika
differently = annorlunda
difficult = mödosam, svår
difficulty = svårighet
dig = gräva
dike = damm, fördämning, vall
diligent = arbetsam
dimension = omfång, storhet, storlek
diminutive = liten
din = bråk, buller, dån, krasch, larm, oljud, olåt, oväsen, stoj, väsen
diploma = aktstycke, diplom
direct = rak, rät
direction = direktion, kosa, riktning
directions = instruktion
director = direktör
directory = katalog
dirty = smutsig
dis- = o-
disabled = invalid
disadvantage = nackdel
disagreeing = oenig, oense
disagreement = oenighet
disappear = försvinna
disappoint = göra besviken
disappointment = besvikelse, missräkning
disapprove = missbilliga
disapprove of = missbilliga
disc = platta, skiva
disciples = anhang
discipline = disciplin
discontent = agg
discontented = missbelåten, missnöjd
discontentedness = agg
discord = oenighet
discount = diskont
discover = upptäcka
discovery = upptäckt
discrete = diskret
discuss = diskutera, orda om
disease = sjuka, sjukdom
disgust = vämjelse, äckel
dish = fat
disinfect = desinficera, smittrena
dislike = tycka illa om
dismal = banal, förtretlig, oangenäm, obehaglig, otrevlig, ledsen, sorgsen, sur
dismayed = förfärlig, hemsk
dismiss = avskicka
disobedient = olydig
dispatch note = adresskort, adresslapp
display = parad
displeased = missbelåten, missnöjd
displeasure = agg
dispose of = avyttra, försälja, sälja
disposition = begåvning, gåva, talang
dissatisfaction = agg
dissatisfied = missbelåten, missnöjd
dissemble = skrymta
dissension = oenighet
dissolve = lösa
distance = avstånd, distans
distil = destillera
distinct = klar, tydlig
distress = bedröva
distribute = utdela
distribution = utdelning
district = amt, distrikt, krets, rote, kvarter
distrust = misstro
dive = dyka
divide = dela
divine = gudomlig
divorce = skilsmässa
divorced = skild, frånskild
do = göra
do business = handla
dock = syra
doctor = doktor, läkare
document = aktstycke, dokument
doe = hind
dog = hund
dogma = dogm
doll = docka
domestic = inhemsk
domestic animal = husdjur
donate = skänka
donkey = åsna
don't mention it = det gör ingenting, för all del, ingen orsak
door = dörr
double = dubbel, dubblera, fördubbla
doubt = tvivla
doubtful = tvivelaktig
dough = deg
dove = duva
down = ned, nedvänd, ner
downstairs = nedan, nere
dowry = hemgift
dozen = dussin
drag = dra, draga, hala
dragon = drake
drama = dram, drama
draw = rita, teckna, dra, draga, hala
drawer = låda
drawers = underbyxor
drawing = ritning, teckning
dreadful = förfärlig, förskräcklig, gräslig, hemsk
dream = drömma, dröm
dreary = förtretlig, oangenäm, obehaglig, otrevlig
dress = klänning
drill = borra
drink = rumla, supa, dryck
drink to excess = rumla, supa
drip = droppa, droppe
drive = driva, fösa
drive away = förjaga
drive on = driva, fösa
driver = chaufför
driving-licence = körkort
dromedary = dromedar
droop = hänga
drop = falla, ramla, droppe
drown = drukna, dränka
drug = läkemedel, medicin
drugstore = apotek
drunk = berudsad, drucken, full, rusig
drunkenness = dryckenskap
dry = torr
dryness = torka
dual = dubbel
duchess = hertiginna
duchy = hertigdöme
duck = and, anka
duke = hertig
dumb = stum
dumbfounded = förfärlig, hemsk
duplicate = multiplicera
during the night = om natten
dusk = halvdager, skumrask, skymning
dust = damm
Dutch = holländsk, nederländsk
Dutchman = holländare, nederländare
dwarf = dvärg
dwell = bo, bygga
dwelling = boning, bostad
dye = färg
dynamite = dynamit