#setName = words_en_sv_Ss
#sideOneTitle = ENG
#sideTwoTitle = SWE
Sabbath = sabbat
sack = säck, väska
sacrament = sakrament
sacred = helig
sacrifice = offra
sad = sorgsen, ledsen
saddle = sadel
sadness = bedrövelse, förtrytelse, grämelse
safety = behåll
safety-pin = säkerhetsnål
safety pin = säkerhetsnål
sagacious = klok, vettig
sage = klok, vettig
sail = segla, segel
sailor = sjöman
saint = helgon
salad = salad, sallat
salamander = salamander
salary = arvode, avlöning, lön, sold
sale = försäljning
sales activity = marknad
saliva = dregel, saliv, spott
salivate = dregla
sallow = glåmig
salmon = lax
salon = salong
salt = salt
salt water = saltvatten
salty = salt
salute = hälsa
salvage = räddning
salvation = räddning
Salvation Army = frälsningsamé
sample = mönster, provbit
sanctuary = helgedom
sanctum = helgedom
sand = sandig, sand
sand- = sandig
sandal = sandal
sandbank = bank, sandbank
sap = saft
sarcastic = sarkastisk
sardine = sardin
Sassenach = engelsman
satisfied = belåten, nöjd, mätt
Saturday = lördag
sauce = spad, sås
sauna = badstuga, bastu
sausage = korv
savage = ostyrig, vild, vildsint
save = rädda, spara
saw = såga, såg
say = säga
say goodbye = säga adjö, säga adjö till
say goodbye to = säga adjö, säga adjö till
say yes = bejaka, jaka
scaffold = schavott
scale = fjäll
scandal = anstöt, förargelse, förtrytelse, harm, förtal, skandal
Scandinavia = Norden, Skandinavien
Scandinavian = nordisk
scar = ärr
scarcely = knappast, knappt, näppeligen
scatter = gjuta, hälla, stöpa
scene = scen
scenery = landskap
scent = doft
sceptre = scepter, spira
schedule = kommunikationstabell, tidtabell
scheme = projekt, schema
school = skola
science = vetenskap
scientific = vetenskaplig
scientist = vetenskapsman
scissors = sax
scold = förebrå, förevita
Scot = skotte
Scotland = Skottland
Scotsman = skotte
Scottish = skotsk
scrap = lapp
scratch = klå, klösa, krafsa, riva
scream = hojta, skria, skrika, skråla
screw = skruva, skruv
screwdriver = skruvmejsel
scuffle = batalj, kamp, slag, slagsmål, strid
sculptor = bildhuggare, skulptör
scythe = lie
sea = hav, sjö
sea-dog = säl
seagull = fiskmås, fiskmåse, mås, måse
seal = säl
seaside = kust
season = säsong, årstid
seat = sittplats
seaweed = alg
second = andra, andre, annan, sekund
secret = dold, hemlig, lönnlig
secretary = sekretarere
sect = sekt
section = fack, yrke, sektion
secure = befästa, fästa
security = behåll
seduce = förföra, förleda
see = möta, se, skåda, skönja, titta
seed = frö
seek = leta, söka
seem = synas, tyckas
self = själv
self-command = självbehärskning
self-confidence = självförtroende
self-conscious = blyg, brydd, förlägen
self-control = självbehärskning
self-possession = självbehärskning
self-reliance = självförtroende
sell = avyttra, försälja, sälja
Semitic = semitisk
send = sända
sender = adressant
sense = begrepp
sentence = mening, sats, döma
separate = särskild, dela
September = september
Serb = serbisk
serenade = serenad
serf = träl
sergeant = sergeant
series = serie
serious = viktig, allvarlig
sermon = predikan
serpent = orm, snok
servant = städerska, städhjälp, tjänarinna, tjänstflicka, betjänt, dräng, tjänare
service = tjänst
set = apparat, flock, grupp, hjord, koppel, svärm, tropp, trupp, serie
set straight = göra besviken
settlement = koloni
seven = sju
seventeen = sjutton
seventeenth = sjuttonde
seventh = sjunde
seventy = sjutti, sjuttio
several times = alltemellanåt, emellanåt, ibland
sew = sy
sewer = avlopp, kloak
sex = kön, sex
sexual = sexuell
shack = barack, hydda, hytt
shade = skugga
shadow = skugga
shallop = slup
shallow = grund
shame = blygsel, nesa, skam
shamrock = klöver, väppling
shanty = barack
shape = bilda, dana, forma, formera
share = aktie, dela, andel, del, part, portion
shark = haj
sharp = egg, gäll, amper, egg, gräll, gäll, skarp
sharpen = skärpa, slipa
sharpness = skärpa
shatter = krossa
shave = raka
shawl = schal
she = hon
sheaf = knippa, knyte, packe
she-ass = åsninna
she-bear = björnhona, björninna
shed = barack, kram, gjuta, hälla, stöpa
sheep = får
sheet = blad
she-goat = get
shell = snäcka, bark
shelter = kasematt
she-wolf = lupin, vargböna, varghona, varginna
shield = skylt
ship = fartyg, skepp
ship's boat = slup
shirt = skjorta
shiver = bäva, dallra, darra, skälva
shoe = sko
shoe-lace = skoband
shoo = driva, fösa
shop = affär, butik, handelsbod, shoppa
shopkeeper = butiksinnehavare
shopping street = affärsgata
shore = strand, kust
short = gen
shortage = brist, lyte, saknad
shortcoming = brist, lyte, saknad
shorthand = snabbskrift
short pants = knäbyxor
shorts = knäbyxor
short-sighted = kortsynt, närsynt
short story = novell
should = böra, må, måste
shoulder = axel, skuldra
shout = hojta, skria, skrika, skråla, skri, skrik
show = uppvisa, skådespel, spektakel
shower = duscha, dusch
shrew = ragata
shrub = buske
shuffle = blanda, sammanblanda
shy = blyg, brydd, förlägen
shyness = blyghet, bryderi, förlägenhet
Siberia = Siberien
Siberian = siberisk
siblings = syskon
Sicily = Sicilien
sick = dålig, sjuk
side = flank, kant, sida, part, parti
sideboard = skåp
sidewalk = gångbana, trottoar
side-way = avtagsväg, avväg
siege = belägring
sieve = sikt, sil, såll
sift = harpa, sikta, sålla
sigh = sucka
sight = anblick, anseende, vy
sign = varsel, bevis, gärd, prov, signal, tecken, skriva, teckna, underskriva, underteckna
signal = signal, tecken
signature = namnteckning, underskrift
sign-board = skylt
signify = beteckna, betyda, teckna
silent = tyst
silhouette = silhuett
silk = av siden, siden, silke
silk- = av siden
silken = av siden
silkworm = silkesmask
sill = tröskel
silver = silver
similar = liknande
similarity = likhet
simple = simpel
simplify = förenkla
sin = synda, synd
since = av, efter, alltifrån, efter
sinew = sena
sinful = syndig
sing = sjunga
singer = sångerska, sångare
singing = sång
single = ogift, ensamstående
sink = sjunka
sir = herr
sister = syster
sister-in-law = svägerska
sit = häcka, ruva, sitta
sitting-room = salong
situation = situation
six = sex
sixteen = sexton
sixteenth = sextonde
sixth = sjätte
sixtieth = sextionde
sixty = sexti, sextio
size = omfång, storhet, storlek, storlek
skeleton = benrangel, skelett
skeptical = klentrogen
skin = päls, hud, skinn, skinna
skinflint = gnidare, knusslare
skirt = kjol, kjortel
skull = hjässa, huvudskål, skalle
sky = himmel, sky
slander = bakdanta, baktala, förtala, häda, nedsvärta, förtal
slaughterhouse = slakthus
slave = slav, träl
Slavic = slavisk
slay = avliva, avrätta, dräpa
sleep = sömn
sleeping-accomodation = sängplats
sleeping-car = sovvagn
sleeping-place = sängplats
sleeve = ärm
slender = smal, tunn, smäcker, smärt
slim = smäcker, smärt
slime = dy, mudder, gyttja, slam, sörja
slip = glida, slira
slipper = toffel
slippery = hal, halkig
slogan = devis
sloop = slup
sloth = trögdjur
slow = långsam, trög
sly = fiffig, illmarig, klipsk, klyftig, knepig, knipslug, slug
smack = smacka
small = liten
smallpox = koppor
smart = fiffig, illmarig, klipsk, klyftig, knepig, knipslug, slug
smash = krossa
smell = osa, stinka, dofta, doft
smell bad = osa, stinka
smile = le, mysa, småle, leende, småleende
smith = smed
smoke = ryka, röka, rök
smokers = rökkupé
smokestack = skorsten
smooth = flack, jämn, glatt
smuggle = smuggla
snail = snigel, snäcka
snake = orm, snok
sneeze = nysa
snow = snö
snowdrop = snödroppe
snow white = snövit
so = alltså, jo, ändock, ändå, sålunda
soap = såpa, tvål
so ... as = lika ... som
sobriquet = binamn, vedernamn
social = social
socialism = socialism
society = klubb, samhälle, samliv, sammanlevnad
sock = socka, strumpa, strumpsocka
sofa = kanapé, sofa
soft = söt, len, mjuk, mör, vek
soften up = lena
softness = vekhet
soil = förorena, nedsmutsa, orena, smutsa, jord
soiled = smutsig
solair = solig
soldier = knekt, soldat
sole = fotsula, ensam, sjötunga, tunga
solely = bara, blott, endast
solicitor = advokat, sakförare
solitary = ensam
soloist = solist
so long = adjö så länge, hej så länge, vi ses
solve = lösa
some = någorlunda, någon, somliga
somebody = någon
someone = någon
some one = någon
something = någonting, något
sometime = någonsin
sometimes = alltemellanåt, emellanåt, ibland
somewhat = någorlunda
somewhere = någonstans, någonstädes
son = son
sonata = sonat
song = visa
son-in-law = måg, svärson
soon = snart
soot = sot
sorcery = trolleri, häxeri
sorrel = syra
sorrow = bedrövelse, förtrytelse, grämelse
sorrowful = ledsen
sort = sort
sound = ljuda, låta, tona, ljud
sound the alarm = alarmere
soup = soppa
sour = surna, ovänlig, snäsig
source = brunn
south = sydlig, södra, söder, syd
South America = Sydamerika
southern = sydlig, södra
sovereign = suverän
Soviet Union = Sovjetunionen
sow = so, så
spa = badort, brunn
space = utrymme
spaceman = rymdpilot
spacious = rymlig, vid
spade = gräva, skyffel, spade
Spain = Spanien
Spaniard = spanjor
spare = spara
spare time = ferier, semester
spark = gnista
spark plug = gnista, tändstift
sparrow = sparv, gråsparv, tätting
speak = tala
speaker's platform = tribun
spear = lans, spjut
special = särskild, speciell
speciality = fack, yrke
specimen = mönster, provbit
spectacle = skådespel, spektakel
spectacles = glasögon
speechless = stum
speed = fart, hastighet, tempo
speed-limit = hastighetsgräns
speed limit = hastighetsgräns
spell = stava
sphere = sfär
spider = spindel
spiderweb = spindelväv
spinach = spenat
spine = ryggrad
spinster = fröken
spiral = spiral
spirit = anda
spiritualism = spiritism
spite = agg
Spitsbergen = Spetsbergen
splinter = splittra, sticka
split = klyva
sponge = svamp
sponger = parasit, snyltdjur, snyltväxt, snyltgäst, tallricksslickare
spoon = sked
sporadic = sporadisk
sport = idrott, sport
sportsman = sportsman
spot = ort, fläck
spray gun = pistol
spring = brunn, vår, hoppa, skutta
springtime = vår
spruce = gran
spruce-fir = gran
spy = snoka, speja, spionera, kunskapare, snok, spejare, spion
square = fyrkant, kvadrat, torg
square decametre = flock, grupp, hjord, koppel, svärm, tropp, trupp
square metre = kvadratmeter
squatter = husockupant
squeeze = trycka
squirrel = ekorre
stab = sticka
stack = stack
stage = station
stage-manager = regissör
staid = allvarlig
staircase = trappa
stairs = trappa
stake = påle, stör
stalk = stjälk, strå
stallion = hingst
stamp = frimärke
stamped = portofri
stanchion = påle, stör
stand = kram
standard = standar
staple = spasm
star = stjärna
stare = stirra
starling = stare
start = begynna, börja, begynnelse, begynnelse, början
state = hävda, påstå, betyga, förklara, stat
statement = förklaring
statement of policy = program
station = station
statistics = statistik
statue = bildstod, staty
statute = statut
stay = förbli, förbliva, stanna
stay over = förbli, förbliva, stanna
steak = biff, biffstek
steam = dunst, imma
steel = stål
stem = strå, stam
stench = stank
stenography = snabbskrift
step = steg
steppe = stepp
sterile = steril
stew = ragu
stick = stav, stång, limma, klibba
stiff = ceremoniell, styv
still = desslikes, ännu
sting = sticka, gadd
stingy = girig, njugg
stink = osa, stinka
stipulation = kondition
stock exchange = börs
stocking = strumpa
stoic = stoisk
stoical = stoisk
stomach = mage
stomach ache = knip, magknip
stone = sten-, stenig, sten
stone-cutter = stenhuggare
stonemason = stenhuggare
stop = station
storage battery = batteri
storage room = förvaringsställe
store = affär, butik, handelsbod
storey = våning
stork = stork
storm = storma, storm
story = våning, berättelse, historia
stove = kamin, spis
straight = rak, rät
straightedge = linjal
straightforward = simpel
strait = sund
strange = främmande, egendomlig, märkvärdig
stranger = främling, utbörding
strangle = strypa
straw = halm
strawberry = jordgubbe
stream = ström, bäck, å
street = gata
streetcar = spårvagn
strength = kraft, styrka
stress = accent
stride = steg
strike = banka, drabba, slå, knacka, strejka, strejk
striking = påfallande
string = sena, lina, rep, sladd, snodd, snöre, streck
strip = streck, strimla, strimma
stripe = streck, strimla, strimma
stroke = smeka, smek
stroll = promenad, spatsertur, promenera, spatsera
strong = kraftfull, kraftig, stark
struggle = kämpa, slåss, strida, batalj, kamp, slag, slagsmål, strid
student = student
studio = ateljé
study = studera, studie, studium
stumble = snava, snubbla
stupid = dum
sturgeon = stör
sty = stia
style = stil
subject = subjekt, tema
subscribe = abonnera
subscriber = abonnent
subscribe to = abonnera
subscription = abonnemang
subsidy = subsidier
substantive = substantiv
subterfuge = knep, konstgrepp
subtle = subtil
suburb = förort, förstad
subway = tunnelbana
success = framgång
such = sådan, sålunda
such a = hur, huru, liksom, såsom, sådan
such as = hur, huru, liksom, såsom
suck = suga
sudden = plötslig
suffer = lida
sugar = socker
sugarbowl = sockerskål
sugar-bowl = sockerskål
sugar-cane = sockerrör
suggest = utpeka, bjuda
suggestion = suggestion
suit = klädedräkt, kostym
sulphur = svavel
sum = belopp, summa
summer = sommar
summon = kalla, ropa
sun = solig, sol
sun- = solig
sunbeam = solstråle
Sunday = söndag
sunflower = solros
sunrise = soluppgång
sunset = solnedgång
superficial = grund
superior = överman
superstition = skrock, vantro, vidskepelse, övertro
superstitious = vantrogen, vidskeplig
supervise = besiktiga, kontrollera
supper = aftonmåltid
supply = avleverera, leverera
support = stödja, stöd
supporter = partigängare
supporters = anhang
suppose = anta
sure = given, säker, trygg
surely = ju
surgeon = kirurg
surgical = kirurgisk
surgical operation = operation
surly = ovänlig, snäsig
surmise = anta
surname = efternamn, släknamn, tillnamn
surpass = överstiga, överträffa
surprise = förundran, förvåning, undran, överraskning
surround = kringgå, omgiva
suspect = misstro, anta
suspicion = misstro, misstroende, otro, aning, antagande, misstanke
suspicious = misstrogen, otrogen, antaglig
sustain = stödja
sustained = konstant, oupphörlig
swallow = svala
swamp = kärr, moras, sump, träsk
swan = svan
swarm = svärm
swear = svära
sweat = svettas, transpirera, svett
Swede = svensk
Sweden = Sverige
Swedish = svensk, svenska
Swedish language = svenska
sweep = sopa
sweet = söt
swim = simma
swimming-bath = bassäng
swimming-pool = bassäng
swimming trunks = simbyxor
swindle = bedrägeri, svek
swine = gris, svin
swing = svinga
Swiss = schweizisk, schweizare
Switzerland = Schweiz
swoon = svimma
sword = svärd, värja
sycamore = lönn, platan
syllable = stavelse
symbol = symbol
symmetric = symmetrisk
sympathetic = anslående, sympatisk
sympathy = sympati
symphony = symfoni
synagogue = synagoga
syrup = sirap
system = system
systematic = systematisk