#setName = words_en_fr_mm
#sideOneTitle = ENG
#sideTwoTitle = FRE
Macedonia = Macédoine
Macedonian = Macédonien
Machiavelli = Machiavel
machine = machine
machine of government = appareil administratif, machine administrative
mackerel = maquereau
mad = aberrant, agité, fou
Madagascar = Madagascar
madam = madame
madness = aberration, affolement, aliénation
Madonna = Madone, Sainte-Vierge
Madrid = Madrid
maestro = maestro, maître
magazine = gazette, journal, revue
magic = magie, magique
magical = magique
magician = sorcier
magnesium = magnésium
magnificent = grandiose, magnifique
magnifying glass = loupe
magpie = pie
maid = domestique, servante, femme de chambre
mail = courrier, poste
mailbox = boîte aux lettres
main = dominant, principal
mainland = continent
mainly = principalement, surtout
maintain = conserver, maintenir, retenir
maintenance = garde
maize = maïs
majestic = imposant, majesté
majesty = majesté, seigneurie
major = commandant, dominant, principal
Majorca = Majorque
majority = majorité
make = construire, fabriquer, opérer, poser, faire, rendre
make a contract = contracter, s'engager
make a deposit = payer un premier acompte, verser un premier acompte
make a down payment = payer un premier acompte, verser un premier acompte
make a mistake = se tromper
make an offer of = offrir
make a noise = faire du bruit
make a note = noter
make a project of = projeter
make a stroke = abaisser, tirer un trait
make clean = affinier, purifier
make fast = attacher, fixer
make for = s'adresser à
make fun of = bafouer
make glad = réjouir
make love = faire l'amour, coïter
make-up = fard, maquillage
make up = maquiller, fard, maquillage
make use of = appliquer, employer, se servir de, user de
make war = guerroyer
making = activité
malaria = malaria
Malawi = Malawi
Malay = Malais
Malaysia = Malaisie
Malaysian = Malaisien
male = mâle
male cook = cuisinier
Mali = Mali
malicious = méchant, perfide
Malines = Malines
Malta = Malte
Maltese = Maltais
mam = maman
mammal = mammifère
Mammon = Mammon
mammy = maman
man = être humain, homme, mâle
manage = administrer, diriger
manageability = docilité, obéissance, souplesse
manageable = conciliant
management = administration
manager = administrateur, exploitant, gérant, directeur
Manchuria = Mandchourie
Manchurian = mandchou
mandate = mandat
maneuver = intrigue, manoeuvre
manger = auge
manifacture = activité
manifest = manifester
Manila = Manille
manipulate = manier
manner = manière
manoeuvre = intrigue, manoeuvre
mansion = immeuble
mantle = manteau
manufacture = fabriquer, activité
manure = engrais, fumier
many = nombreux
map = carte, plan
maple = érable
marble = marbre
march = marcher
march off = décéder
Marcus = Marc, Marc-en-Baroeul, Marcq
margin = marge
marguerite = marguerite
Mariana Islands = Mariannes
marigold = calendula, souci
maritime = marin
mark = marquer, cachet, marque, mark, signal, signe, témoignage, estampiller
market = bazar, foire, marché, marché
marketplace = marché
marmelade = confiture
Maroni = Maroni
marriage = mariage
married = mariée, marié, mariés
married people = couple, époux, mari et femme
marry = se marier, marier
Mars = Mars
marsh = marais, marécage
marten = marte, martre
marter = belette
martyr = martyre, martyr
marvel = s'étonner
marvel at = s'étonner
masculine = mâle
mask = masque
mason = maçon
mass = amas, foule, multitude, tas, bloc, masse
massacre = massacrer
massage = masser
massive = massif
mast = mât
master = apprendre à fond, maestro, maître, patron
masturbate = se masturber
match = allumette, apparier, s'entremettre
match-make = s'entremettre
mate = s'accoupler
material = matériel, matériau, étoffe, tissu
mathematical = mathématique
mathematics = mathématiques
matrimony = mariage
matter = affaire, chose, cas, matière, substance
Matterhorn = mont Cervin
mattress = matelas
mature = fait, mûr
Mauretanian = Mauritanien
Mauritania = Mauritanie
Mauritius = île Maurice
maw = gouffre, gueule
maxim = sentence
maximum = maximum
maybe = peut-être
mayhap = peut-être
mayor = maire
me = à moi, me, m', moi
meadow = prairie, pré, pâturage, pâture
meager = maigre, misérable, pauvre
meal = farine, repas
mealies = maïs
mean = intermédiaire, moyenne, centre, milieu, signifier
meaning = dessein, intention, propos, sens, importance, signification
means = instrument, outil, produit, ustensile, moyen, remède, ressource
meanwhile = dans l'intervalle
measurable = prévisible
measure = mesurer, mesure, taille
measurement = dimension, mesure, taille
meat = viande
Mecca = Mecque
mechanic = mécanicien
mechanics = mécanique
Mechlin = Malines
medal = médaille
mediation = intermédaire
medicine = remède
meditate = méditer, songer
Mediterranean = Méditerranée
Medusa = Méduse
meet = réunir, rencontrer
meeting = séance, réunion
meet with = contenter, satisfaire
melancholy = mélancolique, sombre, abattement, mélancolie
Melanesia = Mélanésie
Melanesian = Mélanésien
melody = mélodie
melon = melon
melt = dégeler, fondre, faire fondre
member = affilié, membre, adhérent, partisan
memento = souvenir
memorize = apprendre par coeur
memory = mémoire
menace = gronder, menacer, menace
menacing = sinistre
mend = rapiécer
mend one's pace = presser le pas
mental = intellectuel, mental
mention = mentionner
menu = carte, menu
Mephistopheles = Méphistophélès
merchandise = denrée, marchandise, produit
merchant = commerçant, marchand, négociant
merciful = sensible, indulgent
mercifulness = compassion
mercury = mercure
mercy = compassion
mere = pur
merit = mériter, gloire, mérite
merry = gai, joyeux
mesh = maille
Mesopotamia = Mésopotamie
mess = bouillie, purée
message = message, faire-part, renseignement
Messiah = Messie
Messina = Messine
metal = métal
metamorphosis = métamorphose, transformation
meteoric stone = aérolithe
meteorite = aérolithe
method = méthode
Methuselah = Mathusalem
methylated spirit = alcool dénaturé
metre = mètre
Meuse = Meuse
Mexican = Mexicain
Mexican woman = Mexicaine
Mexico = Mexique
Mexico City = Mexico
mica = mica
microbe = microbe
micrometre = micromètre
midday = midi
midday meal = déjeuner, dîner
middle = intermédiaire, centre, milieu
middleclass citizen = bourgeois
Middle East = Moyen-Orient, Proche-Orient
midget = nain
midwife = accoucheuse, sage-femme
migrate = voyager au loin
Milan = Milan
mild = doux, suave
milk = lait, traire
mill = usine
miller = meunier
millimetre = millimètre
milliner = modiste
mind = esprit, observer
mine = mine
miner = mineur
mineral = minéral
Minerva = Minerve
mingle = mélanger, mêler, retourner
minimum = minimum
minister = ministre
ministry = ministère
minority = minorité
mint = menthe
minus = moins
minute = minute
minutes = compte-rendu, procès-verbal, protocole
miracle = miracle
mirror = miroir
miscarriage = avortement spontané, avortement spontané, avortement
miscarry = avorter
mischievous = méchant, perfide
miserable = lamentable, malheureux, mal, mauvais, méchant, maussade, sombre, pénible, misérable, pauvre, vide
miserliness = avarice
miserly = avare, avaricieux
misery = misère
miss = rater, manquer
mission = mission
missionary = missionnaire
mist = brouillard
mistake = erreur
mistaken = abusif
Mister = monsieur
mistletoe = gui
mistress = maîtresse
misunderstanding = malentendu
mite = acarien
mitten = gant
mix = mélanger, mêler, retourner
moan = gémir
mobile = mobile, mobilier
mock = bafouer
mockery = simulacre
mode = manière, mode
model = modèle, modeler, schéma
moderate = abordable, modéré, raisonable, ralentir, retenir
modern = moderne
modest = modeste
modesty = modestie
modify = modifier
Mohammed = Mahomet
Mohammedan = musulman
moist = humide
mold = modeler, fondre
Moldavia = Moldavie
Moldavian = Moldave
mole = taupe
Moluccan = Moluquois
Moluccas = Moluques
mom = maman
moment = instant, moment
mommy = maman
Monacan = Monégasque
Monaco = Monaco
monastery = couvent
Monday = lundi
Monegasque = monégasque
money = argent, monnaie
money-box = caisse
money box = caisse
money order = mandat-poste
Mongol = Mongol
Mongolia = Mongolie
Mongolian = Mongol
mongrel = hybride
monk = moine
monkey = singe
monkshood = aconit
monopolize = accaparer, monopoliser
monotonous = monotone
monsignor = monseigneur
monster = clébard, monstre
Montenegrin = Monténégrin
Montenegro = Monténégro
month = mois
monthly = mensuel, mensuellement, par moins
monument = monument
mood = ambiance, humeur
moon = lune
moor = attacher, lier, steppe
Moorish = maure
moose = élan
moped = vélomoteur
moral = moral
morality = vertu
morals = morale
Moravia = Moravie
more = davantage, plus
more and more = de plus en plus, toujours plus
moreover = et puis, en prime, en outre, d'ailleurs, en outre
mores = coutume
Moresque = maure
morning = matin, matinée
Moroccan = Marocain
Morocco = Maroc
Morpheus = Morphée
morphia = morphine
morphine = morphine
morter = mortier
mortgage = hypothèque
Moscow = Moscou
Moses = Moïse
Moslem = musulman
mosque = mosquée
mosquito = moustique
moss = mousse
most = extrêmement, le plus
most important = dominant, principal
mostly = plupart
moth = mite
mother = mère
motion = motion, résolution
motionless = au repos, fixe, immobile
motion picture = film, pellicule
motive = lieu, occasion, motif
motor = moteur
motor-boat = vedette
motor car = auto, automobile
motorcycle = moto, vélomoteur
motoring = automobilisme
motorist = automobiliste
motor-launch = vedette
motor road = autoroute, autostrade
motorway = autoroute, autostrade
motto = devise, épigraphe
mould = modeler, fondre
mouldy = moisi
mount = adapter, monter
mountain = mont, montagne
mountain chain = massif, massif de montagnes, montagne
mountain climber = alpiniste
mountaineer = alpiniste
mountaineering = alpinisme
mountain lion = puma
mountain pass = col
mountain ridge = arête, crête
mounting = montage
mourn = regretter
mournful = morne, sombre
mourning = deuil
mouse = souris
moustache = moustache
mouth = bouche, bouche, embouchure, embouchure
move = affecter, émouvoir, mouvoir, se déplacer, remuer, déménagement
movement = mouvement
movie = film, pellicule
moving = attendrissant
mow = faucher
Mr. = monsieur
Mrs. = madame
much = beaucoup, maint, beaucoup de
muck-water = purin
mud = boue, bourbe, limon, vase
Muhammad = Mahomet
mulberry-tree = mûrier
mule = mulet
multicoloured = bigarré, multicolore
multiple = multiple
multitude = amas, foule, masse, multitude, tas
munition = munitions
murder = assassiner, rectifier
murderer = meurtrier
murk = obscurité, ténères
murmur = murmurer, murmure
muscle = muscle
Muscovite = Moscovite
museum = musée
mush = bouillie, purée
mushroom = champignon
music = musique
musical time = mesure, tact
musician = musicien
musket = mousquet
musk-rat = ondatra, rat musqué
Muslim = musulman
musquash = ondatra, rat musqué
mussel = moule
Mussulman = musulman
must = devoir, être obligé
mustard = moutarde
musty = moisi
mute = muet
mutiny = révolte
mutter = murmurer
mutton = mouton
mutual = réciproque
mutually = se
muzzle = muselière
my = ma, mon, mes
Mycenae = Mycènes
myrrh = myrrhe
mysterious = mystérieux
mystery = mystère
mystic = mystique
mystical = mystique
mysticism = mysticisme
mystification = mystification
mystify = mystifier
myth = mythe
mythical = mythique
mythologist = mythologue
mythology = mythologie
myxomatosis = myxomatose