#setName = words_en_fr_ee
#sideOneTitle = ENG
#sideTwoTitle = FRE
each = à, à raison de, par, chaque
eager = avide
eagerness = avidité
eagle = aigle
eaglet = aiglon
ear = oreille, épi
earl = comte
early = hâtif, précoce, de bonne heure, tôt
earmark = destiner
earn = gagner, remporter
earn back = rattraper, regagner
earnest = sérieux
earth = terre, butter, terrer
earthen = terrestre
earthly = terrestre
earthquake = séisme, tremblement de terre
earth up = butter, terrer
earthworm = lombric, ver de terre
easel = établi
easily = facilement
east = est, orient
Easter = Pâques
easy = facile
eat = déjeuner, manger
eat up = dévorer
echo = écho, répercussion, résonner
economy = économie
edelweiss = edelweiss
Eden = Eden
edge = rive, bord, lisière
edging = bord, lisière
Edinburgh = Edimbourg
edit = rédiger
editorial office = rédaction
educate = éduquer
educated = cultivé
education = enseignement, instruction
eel = anguille
eelworm = anguillule, tylenchus
effect = effet, impression, résultat
effort = démarche, requête, effort, peine
egg = oeuf
eggfruit = aubergine
eggplant = aubergine
Egypt = Egypte
Egyptian = égyptien, Egyptien
eight = huit
eighteen = dix-huit
eighty = quatre-vingts
either ... or = soit ... soit
elastic = élastique, souple
Elba = Elbe
Elbe = Elbe
elbow = coude
elder = sureau
elect = adopter, choisir, désigner, opter
election = choix
electric = électrique
electric fan = aérateur
electricity = électricité
electric plug = bouchon, prise de courant mâle
electric socket = prise de courant, prise de courant femelle
electron = électron
element = élément
elemental = primaire
elementary = primaire
elements = abc, alphabet
elephant = éléphant
elevator = ascenseur
eleven = onze
eleventh = onzième
elf = lutin
elk = élan
elm = orme
eloquent = éloquent
Elsass = Alsace
else = autre, plus
elsewhere = ailleurs
embarrassment = embarras
embassy = ambassade
embassy building = ambassade
embellish = embellir, rendre plus beau
embrace = embrasser, prendre dans les bras
embroider = broder
emerge = paraître, apparaître, surgir
emergency = crise
emigrate = se réfugier
eminent = accompli, excellent, éminent
emmet = fourmi
emotion = émotion
emperor = empereur
emphasis = emphase
emphasize = accentuer, souligner
empire = empire
employ = embaucher, appliquer, employer, se servir de, user de
employee = employé
employment exchange = bourse du travail
empty = vide, vider
enchanter = sorcier
encounter = rencontrer, abord, rencontre
encourage = inciter, pousser à, réconforter
encyclopaedia = encyclopédie
end = cesser, terminer, finir, prendre fin, se terminer, bout, fin
endeavour = se démener, peiner
ending = bout, fin
endlessly = infiniment
end-of-the-line = terminus
endorse = virer
end up = finir, prendre fin, se terminer, arriver
endure = continuer, durer, soutenir, supporter, endurer, souffrir, subir, tolérer
enemy = ennemi
energy = énergie
engagement = fiançailles, accordailles, fiançailles
engine = locomotive, machine, moteur
engineer = ingénieur
England = Angleterre
English = anglais, langue anglaise
English Channel = la Manche
English language = anglais, langue anglaise
Englishman = Anglais
engrave = graver
enigma = énigme, puzzle
enjoy = être joyeux, jouir, jouir de
enjoyable = agréable
enjoy oneself = se réjouir
enlarge = accroître, agrander, amplifier, augmenter, étendre
enlargement = accroissement
enlighten = illuminer
enormous = énorme, formidable, immense
enough = suffisant, assez, passablement, plutôt, suffisamment
entangle = empêtrer, entortiller
enter = introduire, entrer, entrer dans, inscrire
entertain = recevoir des visiteurs, distraire, abriter, régaler
entertaining = amusant, drôle
entertainment = amusement
enthusiasm = enthousiasme
entice = détourner, dévoyer, entraîner hors du droit chemin, tenter
entire = entier, total
entirely = complètement, entièrement, totalement, tout
entrée = hors-d'oeuvre
entrust = charger, confier une tâche, confier, se fier à
entry = inscription, présentation
envelope = enveloppe
environment = environnement, milieu, abords
environs = abords
envisage = contempler
envy = envier, envie
Epiphany = Epiphanie
epoch = époque
equal = égal
equally = de même, pareillement
Equatorial Guinea = Guinée Equatoriale
equip = équiper
equivalent = équivalent
er = -iste, -er
era = époque
eradicate = arracher
eraser = gomme
erect = fonder
erecting = montage
Eritrea = Erythrée
erotic = érotique
err = se tromper
errand = commission, message
erroneous = abusif
error = erreur
escape = échapper, s'échapper
escort = accompagnement
especially = tout d'abord, principalement, surtout
Esperanto = espéranto
essay = thèse
essential = essentiel
establish = fonder, constater
estate = bien, domaine, fonds, propriété, propriété foncière
esteem = apprécier, estimer, estime, considérer
estimate = apprécier, estimer, évaluer, taxer
Estonia = Estonie
Estonian = Estonien
Estonian woman = Estonienne
etc. = etc.
etching = eau-forte
eternal = éternel
Ethiopia = Ethiopie
Ethiopian = éthiopien, Ethiopien
ethos = ambiance
Etrurian = étrusque, Etrusque
Etruscan = étrusque, Etrusque
Euphrates = Euphrate
Europa = Europe
Europe = Europe
European = Européen
European Union = Union Européenne
Euxine Sea = Pont-Euxine
evade = éviter, parer, s'abstenir de
even = plat, uni, égal, même, régulier
evening = soir, soirée
evening dress = habit
evening meal = dîner, souper
Evening Star = Vénus
event = événement, occasion
eventual = éventuel
ever = jadis, un jour, en tous temps, toujours
ever = n'importe
everlasting = infini, interminable, permanent, perpétuel
every = chaque
everybody = chacun, tout le monde
everyday = vulgaire
every kind of = tout, toute espèce de, toute sorte de
every one = chacun, tout le monde
everyone's = à tout le monde
everything = tout
everywhere = partout
evident = évident
evoke = rappeler
evolve = évoluer
ex- = ancien
exact = exact, juste
exactitude = exactitude
exactly = à l'heure, exactement, justement, précisément, proprement
examination = examen
examine = examiner, explorer, fouiller, rechercher, reconnaître
example = exemple
excavate = abattre
exceed = dépasser, dominer, maitriser, surmonter
excellency = seigneurie
except = dispenser, excepter, exempter, en outre, hormis, sauf
except for = en outre, hormis, sauf
excess = excès
exchange = central, centrale
excise = droit de régie, taxe d'octroi
excise-duty = droit de régie, taxe d'octroi
excite = exciter, hérisser, agacer, irriter
excite pity = apitoyer
exciting = captivant, passionnant
exclude = dispenser, excepter, exempter
exclusively = ne ... que, seulement
excommunication = anathème
excrement = excrément
excursion = excursion, randonnée
excuse = dispenser, excuser
excuse me = je vous demande pardon, veuillez m'excuser
excuse oneself = s'excuser
execute = exécuter
exempt = dispenser, exempter
exercise = exercer, instruire, exercice
exercise-book = cahier
exert = pratiquer
exhortation = observation, recommandation, sommation
exile = bannir, exiler, banni, bannissement
exist = exister
exit = issue, sortie, aboutir, descendre, donner, sorter
expect = attendre
expectation = attente
expel = renvoyer, repousser
expenses = dépense, sortie
expensive = cher, coûteux
experienced = experimenté
experiment = essai, expérience
expert = experimenté
expertness = adresse, habileté
expire = finir, prendre fin, se terminer, décéder, mourir
explain = développer, expliquer
explode = exploser
exploit = exploiter
exploration = recherche, reconnaissance
explore = examiner, explorer, fouiller, rechercher, reconnaître
express = répandre, exprimer, représenter
expression = locution, terme, air, mine
expressway = autoroute
extend = ampleur, grandeur, importance, taille, étendre
extension = suffixe
extensive = ample, étendu, large
exterior = aspect, spectacle, vue
exterminate = exterminer, supprimer
extinguish = éteindre
extraordinary = extraordinaire, formidable, prodigieux, singulier
extreme = extrême
extremely = extrêmement
eye = oeil
eyebrow = sourcil
eyelid = paupière