#setName = words_en_la_cc
#sideOneTitle = ENG
#sideTwoTitle = LAT
cabbage = brassica, crambe, raphanus
cabin = canaba, casa
cabinet = armarium
cadaver = cadaver
Caesar = Cæsar
calculate = calculare
calf = vitellus
call = vocare
camel = camelus
canal = canalis, via
canary = passer
candidate = candidatus
cane = arundo, baculum, baculus, arundineus, canneus, calamus, canna
cane- = arundineus, canneus
cane-field = cannetum
cantharides = cantharis
capability = capacitas
Capricorn = Capricornus
capture = capere
card = carere
care = cura
careful = cautus
carefully = cautim
caress = admulcere, adulare
carnivorous = carnivorus
carry = portare, tulere, vehere
carry away = asportare
Carthage = Carthago
Carthaginian = Carthaginiensis, Poenicus, Poenus, Punicus
case = causa, res, casus
cashier's stand = fiscus
castle = arx, turris
castrate = castrare
cat = feles
catastrophe = catastropha
catch = capere, captus
catechism = catechismus
cattle-lifter = abactor
cattle-stealer = abactor
cause = causa
caution = monere, admonere, cautela, cautio
cautious = cautus
cave = antrum, caverna, caulæ, cavea, cavum, cavus
cavern = antrum, caverna
cavity = antrum, caulæ, cavea, cavum, cavus
cedar = cedrinus, cedrus
celebrate = celebrare
celebration = festum
celery = apium
celestial = ætherius, cæles, cælestis, cælicus
cell = carcer
cemetery = capulus, cimeterium
censer = turibulum
centaur = Centaurus
centipede = scolopendra
cerastes = cerastes
Cerberus = Cerberus
ceremony = cæremonia, cærimonia
Ceres = Ceres
certain = cautus, certus
certainly = certe, certim, certo
certainty = certitudo
chain = catena
Chaldean = Chaldæi
chalk = creta
chamber = cella
chamois = capra, capreolus
chance = casus, occasio
change = mutare
channel = canalis, via, fistula
chaos = chaos
chapter = caput
character = natura
charcoal = carbo
charge = onus
charm = phylacterium, præbia
charming = bellus
Charon = Charon
Charybdis = Charybdis
chase away = abigere
chasm = abruptum, abyssus, crater, fauces
chaste = castus
chasten = castificare
chastity = castimonia, castitas
cheese = caseus
chef = archimagirus
cherry = cerasus
cherry-tree = cerasus
chest = arca, thorax
chestnut-tree = castanea
chicken = gallina
chicory = cichorium, pancratium
chief = dux
chiefly = potissimum
choke = astrangulare
choose = optare
Christ = Christus
christen = baptizare
christening = baptisma, baptismus
Christian = Christianus
Christianity = Christianismus
chuck = admulcere, adulare
Cicero = Cicero
cinder = cinis, spodium
cinnamon = casia, cinnamum, cinnamomum
Circe = Circe
circle = circus, orbis
circumvent = ambire
city = oppidum, urbs
clandestinely = absconse, arcano, celatim
clap = applaudere
clarion = tuba
class = classis
clay = argilla
clean = castus, purus, putus, purgare
cleanse = purgare
clergyman = clericus
clerk = amanuensis
clever = captiosus, trebax, vafer
climate = clima
cloak = mantellum
close = claudere, angustus, artus
closet = armarium
clothe = vestire
cloud = ær, nebula, nubes
clover = trifolium
clown = maccus
cluster = fascis
coast = orarius, acta, litus, ora
coast- = orarius
coastal = orarius
cock = gallus
cock-pigeon = columbus
cockroach = tinea
coffin = arca, capulus
coherent = continuus
coition = clinopale, coetus, coitus
cold = frigus
collar = boiæ
collateral branch = bracchium
colleague = collega
collection = caterva, grex
colony = colonia
colossal = Colosseus, Colossicus
colour = colorare, color
coltsfoot = farferis, farferus
combination = adunatio
come = venire
come about = accidere
come close = proximare
come closer = proximare
come flocking in = affluere
come on = adire, proximare
comet = cometes, fax
commend = laudare
common = communis
commonplace = abiectus
commotion = scandalum
compact = compactus
compare = comparare
compel = coercere
compensation = præmium
competition = agon, pugna
complete = plenus
concave = cassus, cavus
conceal = abdere, abscondere, celare
concern = causa, cura
concert = acroama
conduct = ducere
confidence = fides
congregate = coire
connect = copulare, ligare
connected = continuus
conquer = profligare, vincere
consider = spectare
consistent = continuus
constringent = acerbus, austerus
consul = consul
consumption = cachexia, phthisis
consumptive = cachetcta
container = alveus, olla
contest = agon, pugna
continuous = perpetuum
control = gubernare, regere, regnare
convert = converti
cook = coquus, magirus
cool = alsus
cooperate = collaborare
co-operate = collaborare
Copenhagen = Hafnia
copper = æneus, aheneus, ærarius, chalceus, æs
copy = apographon
cord = chorda, ceruchus, funis
coriander = coriandrum
cork = cortex
corn = callum
corn cockle = lolium
cornel = cornum, cornus
corner = angulus
corona = corona
corporal = corporalis, corporeus
corporeal = corporalis, corporeus
corpse = cadaver
corpulent = carnatus, crassus, obesus
cottage = casa
cough = tussis
counsel = advocatus, causidicus, monere
count = calculare
country = rus
countryside = rus
couple = combinare
courage = cervix
courier = cursor
course = catinus, tryblium
cover = operire, tegere
cow = bovillus, bovinus, bublus, bubulus, vacca
cow- = bovillus, bovinus, bublus, bubulus
cowhouse = bovile, bubile
cowshed = bovile, bubile
crack-brained = cerritulus
cramped = angustus, artus
crawl = repere, serpere
crayfish = cancer
craziness = amentia, dementia
crazy = amens, astrosus, cerebrosus, Ceritus, Cerritus, demens
create = creare
creep = repere, serpere
Crete = Creta
crime = crimen, scelus
croak = coaxare
crocodile = crocodilus
cross = bifurcum, crux
crow = cornix
crowd = massa, multitudo, turba
crude = crudus
cruel = acerbus, atrox, barbarus, crudelis
cry out = boare
crystal = crystallus
cuckoo = cuculus
cucumber = cucumis
cultivate = colere
cunning = captiosus, trebax, vafer, versutia
cupboard = armarium
Cupid = Amor
current = amnis
curse = blasphemare
curtail = breviare
curved = curvus
cuss = blasphemare
custom = mos
cut = scalpere, secare
Cybele = Cybele
cylinder = cylindrus
cymbal = cymbalum
cypres = cupressus, cyparissus