#setName = words_en_de_Ss
#sideOneTitle = ENG
#sideTwoTitle = GER
Sabbath = Sabbat
sack = abdanken, verabschieden, entlassen, Beutel, Sack
sacrament = Sakrament
sacred = heilig
sacrifice = erbieten, opfern, sich erbieten
sacrilege = Sakrilegium
sad = düster, traurig, vergrämt
saddle = Sattel
sadness = Betrübnis
safety = Sicherheit
safety-belt = Rettungsgürtel
safety-pin = Sicherheitsnadel
safety pin = Sicherheitsnadel
sagacious = einsichtsvoll, intelligent, verständig, gescheit, klug, weise
sage = Salbei, gescheit, klug, weise
Sagittarius = Schütze
sail = Segel
sailor = Seemann
Saint Gotthard pass = Sankt Gotthard
Saint Nicholas = Sankt Niklas, Sankt Nikolaus
salad = Salat
salamander = Molch, Salamander
salary = Gage, Gehalt, Salär
sale = Absatz, Debit, Vertrieb, Abnahme, Verkauf
sales activity = Markt
salesman = Ladengehilfe, Verkäufer
saleswoman = Ladenfräulein
saliva = Speichel
sallow = blaß, bleich, fahl
salmon = Lachs, Salm
salon = Aula, Salon
salt = salzen, Salz
salt water = Salzwasser
salty = salzen, salzig
salute = grüßen, begrüßen
salvage = Heil
salvation = Heil
same = gleiche, gleicher, gleiches, selbe, selber, selbes
samovar = Samowar
sample = Muster, Probe, Probestück, Spezimen
sanctify = heiligen, weihen
sanction = sanktionieren, Sanktion
sanctuary = Heiligtum
sanctum = Heiligtum
sand = sandig, Sand
sand- = sandig
sandal = Sandale
sandwich = Sandwich
Sanskrit = Sanskrit
sap = Saft
sarcasm = Sarkasmus
sarcastic = sarkastisch
sardine = Sardelle, Sardine
Sassenach = Engländer
Satan = Satanas, Teufel
satellite = Trabant
satisfied = zufrieden, satt
satisfy = befriedigen, zufriedenstellen
saturate = sättigen
Saturday = Samstag, Sonnabend
sauce = Brühe, Sauce, Soße, Tunke
saucepan = Bratpfanne, Kasserole, Kochpfanne, Pfanne
saucer = Untertasse
sausage = Wurst
savage = wild
save = wahren, retten, erlösen, erretten, erübrigen, sparen, ersparen
saw = sägen, Säge
Saxe = Sachsen
saxifrage = Steinbrech
Saxon = sächsisch, Sachse
Saxony = Sachsen
say = erwähnen, sagen, he, heda, holla, lauten
say yes = bejahen, ja sagen
scabbard = Scheide
scaffold = Blutgerüst, Schafott
scald = brühen
scale = Gamme, Tonleiter, Maßstab, Skala, Schuppe
scales = Waage
scandal = Ärgernis, Skandal
Scandinavian = skandinavisch, Skandinave
scandium = Scandium
scar = Narbe
scarcely = kaum
scare = zurückschrecken
scatter = streuen, gießen, schütten
scene = Bühne, Scene, Szene
scenery = Landschaft
scent = Geruch
sceptre = Szepter, Zepter
scheme = Entwurf, Plan, Projekt, Schema
schism = Schisma
scholar = Schüler
school = Schule
school desk = Pult
science = Wissenschaft
scientific = wissenschaftlich
scissors = Schere
scold = anhalten, vermahnen, zureden, zurechtweisen, schelten, vorwerfen, Vorwürfe machen
scorpion = Skorpion
Scot = Schotte
Scotland = Schottland
Scotsman = Schotte
Scottish = schottisch
scoundrel = Bandit, Canaille, Kanaille, Schuft, Schurke
scrap = Fetzen, Hader, Lappen
scrape = schaben, kratzen, radieren, schrapen
scratch = ritzen, schaben, kratzen, radieren, schrapen
scream = Geheul, schreien
screen = Schutzwand
screw = schrauben, Schraube
screw up = pfuschen
script = Handschrift
scrupulous = skrupulös
scuffle = Kampf, Schlacht
sculpture = Bildhauerwerk, Bildwerk, hauen, skulptieren
scythe = Hippe, Sense
sea = Meer, See
sea-bottom = Meeresboden
sea-dog = Seehund
seagull = Möwe
seal = Seehund, siegeln, versiegeln
Sea of Azov = Asowsches Meer
search = Nachsuchung, Suche, Suchen
seasickness = Seekrankheit
seaside = Küste
season = Jahreszeit, Saison
seaweed = Alge
seclude = absondern, außer Verbindung setzen, isolieren
second = Sekunde
secret = geheim, heimlich, verborgen, verstohlen, Geheimnis, Hehl
secretary = Sekretär
secret code = Chiffre, Marke
sect = Sekte
section = Abteilung, Fach, Sektion
sector = Sektor
secure = befestigen, festsetzen, fixieren
security = Bürgschaft, Sicherheit
seduce = verführen, verlocken
see = antreffen, begegnen, sehen, ansehen, besuchen, einen Besuch abstatten, Sorge tragen, sorgen
see again = wiedersehen
seed = Same
seek = ausschauen nach, suchen, aufsuchen
seem = scheinen
seemingly = anscheinend, dem Anschein nach, scheinbar
seemly = angemessen, füglich, geeignet, zeitgemäß
seize = greifen, angreifen, ergreifen, requirieren
seized with emotion = bewegt, gerührt
seizure = Schlag, Schlagfluß
seldom = selten
self = selber, selbst
self-assurance = Aplomb, Sicherheit
self-heal = Dornschlehe, Schlehe
selfinterest = Egoismus, Selbstsucht
selfishness = Egoismus, Selbstsucht
selfless = anhänglich, zugetan, ergeben
self-sufficiency = Autarkie
self-taught man = Autodidakt
sell = veräußern, verkaufen
sell door-to-door = hausieren, kolportieren
Semite = Semit
Semitic = semitisch
send = schicken, senden, einsenden
sender = Absender
send for = entbieten, holen, kommen lassen
send off = abfertigen, befördern, expedieren, fortsenden, spedieren
sensation = Empfindung, Sensation, Sinn
sensational = sensationell
sense = Auffassung, Begriff, Verständnis, Sinn, Verstand, empfinden, fühlen
sensible = gescheit, klug, vernünftig, verständig
sensitive = empfänglich, empfindlich, empfindsam, sensibel
sentence = Phrase, Redensart, verdammen, verurteilen, Satz, Satzgefüge
sentry = Wache
separate = abgesondert, besonder, einzeln, seperat, absondern, abteilen, abtrennen, entzweien, scheiden, auseinandergehen, sich überwerfen, dividieren, teilen, einteilen, gliedern, verteilen, zerlegen
separately = besonders, eigens
separation = Abteilung
sepia = Sepia, Tintenfisch
September = September
Serb = serbisch, Serbe
serenade = Serenade, Ständchen
serene = heiter, ungetrübt
serfdom = Frondienst, Frone, Leibeigenschaft
sergeant = Sergeant
serial = Feuilleton
series = Kette, Reihe, Serie
serious = arg, bedeutend, bedeutsam, beträchtlich, erheblich, wichtig, ernst, ernsthaft, gesetzt
sermon = Predigt
serpent = Schlange
servant = Dienstbote, Magd, Bursche, Diener, Gehilfe
serve = den Dienst haben, dienen, bedienen, auftragen
service = Gottesdienst, Bedienung, Dienst
servitude = Frondienst, Frone, Leibeigenschaft
set = Apparat, Vorrichtung, Ar, Vollzähligkeit, Kette, Reihe, Serie
set a trap = auflauern, nachstellen
set a trap for = auflauern, nachstellen
set straight = enttäuschen
settlement = Ansiedelei, Ansiedlung, Kolonie
seven = sieben
seventeen = siebzehn
seventy = siebzig
several = verschiedene
several times = manchmal
severe = streng
severity = Strenge
sew = heften, nähen
sewer = Kloake
sew on = heften
sew together = heften
sex = Geschlecht, Sex
sexual = generisch, geschlechtlich, sexuell
sexual love = Amor
sexual pleasure = Lust, Wollust, Wonne
shack = Baracke, Lagerhütte, Hütte
shade = Abstufung, Nuance, Schattierung, Ton, Schatten, schattieren
shadow = Schatten
shaft = Welle, Schacht
shaggy = gezottelt, haarig, Zottel-, zottig
shah = Schah
shake = reißen, zerren, rütteln, schütteln, schüttern, erschüttern, bewegen, wankend machen
shallop = Schaluppe
shallow = flach
shame = pfui
shamrock = Klee
shanty = Baracke, Lagerhütte
shape = bilden, formen, gestalten, Form, Gestalt
share = Aktie, Anteilschein, dividieren, teilen, einteilen, gliedern, verteilen, zerlegen, mitmachen, teilnehmen, Stück, Teil, Partie, Anteil, Portion, Ration
share-capital = Aktienkapital
shareholder = Aktieninhaber, Aktionär
shark = Hai, Haifisch
sharp = herb, grell, herb, scharf, bündig
sharpen = schleifen, wetzen
shatter = zermalmen, zerschmettern
shave = barbieren, rasieren
shawl = Shawl, Umschlagetuch
she = sie
sheaf = Bund, Bündel, Büschel, Fascikel, Garbe
shear = scheren, abscheren, schneiden, abschneiden
she-bear = Bärin
shed = Lagerhütte, Baracke, Bude, Hütte, Scheune, Markise, gießen, schütten
shed tears = tränen
sheen = Glanz
sheep = Hammel, Schaf
sheet = Blatt, Betttuch, Bettlaken, Laken, Tafel
sheet metal = Blech
she-goat = Geiß, Ziege, Zicke
shelf = Bordbrett, Brett, Regal, Wandbrett
shell = Muschel, Borke, Hülse, Rinde, Schale
shelter = Asyl, Freistätte, Hospiz, Zuflucht, bergen, schirmen, beschirmen, beschützen
shepherd = Senner, Hirt
she-wolf = Lupine, Wölfin
shield = Schild
shilling = Schilling
shin-bone = Schienbein
shine = blinken, glänzen, scheinen, schimmern, strahlen, leuchten
shingle = Dachschindel, Schindel
ship = abfertigen, befördern, expedieren, fortsenden, spedieren, Schiff
ship = -heit, -keit
ship's boat = Schaluppe
shirt = Hemd
shiver = beben, zittern, zucken
shock = rütteln, schütteln, schüttern, erschüttern, Anstoß erregen, Anstoß
shoe = Schuh
shoe-lace = Schnur, Schuhband
shoemaker = Schuhmacher, Schuster
shoo = anfeuern, jagen, treiben, vor sich hertreiben
shoot = feuern, schießen
shoot dead = erschießen, füsilieren
shop = Butike, Kramladen, Laden, Geschäft
shore = Bord, Gestade, Strand, Ufer, Küste
short = kurz
shortage = Fehlen, Fehler, Manko
shortcoming = Fehlen, Fehler, Manko
shorten = abkürzen, verkürzen
shorthand = Kurzschrift, Stenographie
shortness of breath = Asthma
short-sighted = kurzsichtig
short story = Novelle
should = müssen, sollen
shoulder = Achsel, Schulter
shoulderblade = Schulterbein, Schulterblatt
shout = schreien
shove = schieben
shovel = schaufeln, Schaufel, Schüppe, Schippe
show = manifestieren, angeben, weisen, anweisen, hinweisen, zeigen, andeuten, markieren, zeichnen, anzeichnen, kennzeichnen, Spektakel
shower = Brause, Dusche, Sturzbad
shrapnel = Schrapnell, Shrapnell
shrew = Megäre, Weib
shrewd = spitzfindig
shrub = Gebüsch, Staude, Strauch
shuffle = mengen, mischen
shut = schließen, verschließen, zumachen, geschlossen, zu
shut off = abstellen
Siberia = Sibirien
siblings = Geschwister
Sicily = Sizilien
sick = krank
side = Flanke, Seite, Fraktion, Partei
sideboard = Schrank
sideissue = Anhängsel
sideshow = Anhängsel
sidewalk = Bürgersteig, Gehweg, Trottoir
side-whiskers = Backenbart
siege = Belagerung
sight = Anblick, Aspekt, Aussehen, Gesicht, Sehen, Sicht
sightless person = Blinder
sightseeing trip = Ausflug, Exkursion
sign = Vorzeichen, Vorbedeutung, Wahrsagung, Ausweis, Beweis, Beleg, Signal, Abzeichen, Anzeichen, Kennzeichen, Merkzeichen, Wink, Zeichen, subskribieren
signal = signalisieren, Signal, Abzeichen, Anzeichen, Kennzeichen, Merkzeichen, Wink, Zeichen
signature = Unterschrift
sign-board = Schild
signify = bedeuten, bezeichnen
signpost = Wegweiser
silence = Schweigen, Stille
silent = schweigend, verschwiegen
Silesia = Silesien
silhouette = Schattenriß, Silhouette
silicon = Silicium, Silizium
silk = seiden, Seide
silk- = seiden
silken = seiden
silkworm = Maulbeerspinner, Seidenraupe
sill = Schwelle
silver = Silber
similar = ähnlich
similarity = Ähnlichkeit
simple = einfach, einfältig
simplify = vereinfachen
simultaneous = gleichzeitig
sin = sündigen, sich versündigen, Sünde
since = seit, da, denn, weil
sincere = aufrichtig
sincerity = Aufrichtigkeit
sinew = Flechse, Sehne
sing = singen
singer = Berufssänger, Kantor, Sänger
singing = Gesang
singing-bird = Singvogel
single = einfach, einzig
sink = tauchen, eintauchen, untertauchen
sip = aufsaugen, einsaugen, schlürfen, einschlürfen
siphon = Siphon
sir = Herr
sirocco = Schirokko
sister = Schwester
sit = brüten, sitzen
sit down = sich setzen
sitting-room = Wohnzimmer, Aula, Salon
situation = Fassung, Lage, Situation, Zustand
six = sechs
sixteen = sechzehn
sixty = sechzig
size = Ausdehnung, Bereich, Dimension, Fassung, Gehalt, Umfang, Größe
skate = Rochen
skeleton = Gebein, Knochengerüst, Gerippe, Skelett
skeptic = Skeptiker
skeptical = skeptisch
sketch = entwerfen, skizzieren, Entwurf, Skizze
ski = Schi
skilful = geübt
skilfulness = Geschicklichkeit, Gewandtheit
skill = Geschicklichkeit, Gewandtheit
skilled = geübt
skillful = anstellig, behende, fix, geschickt, geübt, gewandt
skillfulness = Geschicklichkeit, Gewandtheit
skimpy = mager
skin = Balg, Fell, Pelz, Tierhaut, Haut, abdecken, häuten
skinflint = Geizhals
skinny = mager
skirt = Rock, Frauenrock
skull = Schädel
sky = Himmel
sky blue = azurn, Azur, Lasur
slab = Tafel
slam = zuschlagen
slander = afterreden, anschwärzen, fälschlich beschuldigen, verleumden
slanting = indirekt, obliquus, schief, schräg
slap = Backenstreich
slat = Latte
slate = Schiefertafel
slaughter = erschlagen, schlachten
Slav = Slawe
slave = Sklavin, Knecht, Sklave
Slavic = slawisch
slay = ermorden, töten
sleep = schlafen, Schlaf
sleeping-accomodation = Schlafgemach
sleeping-car = Schlafwagen
sleeping-place = Schlafgemach
sleeve = Ärmel
slice = Scheibe, Schnitte, schneiden
slime = Schlamm
slip = gleiten, glitschen, rutschen
slipper = Pantoffel
slogan = Devise, Wahlspruch
sloop = Schaluppe
slope = Abhang, Halde, Steilung
sloping = abhängig, abschüssig
slot = Falz
slothful = faul, träge
slug = Schnecke
sluice = Schleuse
slum = Armenviertel, Hinterviertel
slumber = schlummern
sly = abgefeimt, arglistig, gerieben, gewiegt, gewitzt, listig, schlau
smack = schmatzen
small = gering, klein
small letter = kleiner Buchstabe
smallpox = Blattern, Pocken
small room = Kamera, Kammer
smart = abgefeimt, arglistig, gerieben, gewiegt, gewitzt, listig, schlau
smash = zermalmen, zerschmettern
smear = schmieren
smell = wittern, duften, riechen, Geruch
smile = lächeln
smith = Schmied
smock = Kittel
smoke = rauchen, Rauch
smokers = Raucherabteil
smokestack = Esse, Schornstein
smooth = eben, flach, geläufig, glatt, glätten
snack = Lunch
snail = Schnecke, Klammeraffe
snake = Schlange
snare = Falle
sneer = grinsen
sneeze = Niesen
snifter = Aperitif
snore = schnarchen
snorter = Aperitif
snow = schneien, Schnee
snowball = Schlinge, Schneeball, Wasserholder
snowflake = Schneeflocke
so = also, daher, denn, doch, jedoch, somit, wohl, damit, daß, folglich, ebenso, so
soak = tauchen, eintauchen, tunken, eintunken
soap = Seife, seifen
soapwort = Seifenkraut
so ... as = ebenso ... wie, sowohl ... als
sober = abstinent, mäßig, nüchtern
soccer ball = Fußball
social = sozial
socialism = Sozialismus
socialist = Sozialist
society = Klub, Association, Sozietät, Gesellschaft
sociologist = Soziologe
sociology = Soziologie
sock = Halbstrumpf, Socke
socket = Besteck, Etui, Gehäuse
sodium = Natrium
sofa = Kanapee, Couch, Sofa
soft = süß, weich
soften up = erweichen, verweichlichen
softness = Weichheit
soil = flecken, beflecken, einflecken, beschmutzen, einschmutzen, sudeln, Boden, Erdboden, Erde, Grund, Land, Terrain
soiled = unlauter
solder = löten, schweißen
soldier = Soldat
sole = Fußsohle, Sohle, allein, alleinig, bloß, einzig, Seezunge
solely = allein, bloß, nur
solemn = feierlich, festlich
solicitor = Advokat, Anwalt, Rechtsanwalt
solid = gesetzt, solide
solidarity = Solidarität
soliloquy = Monolog
solitary = allein, alleinig, bloß, einzig, einsam
soloist = Solist
solution = Auflösung, Lösung
solve = lösen
somber = düster
some = ein bißchen, ein wenig, etwas, ziemlich, ein gewisser, einer, irgend einer, irgendwer, jemand, ein paar, einiger, einiges, etliche, einige, manche
somebody = ein gewisser, einer, irgend einer, irgendwer, jemand
somehow = einigermaßen, irgendwie
some kind of = ein, einige, einiges, einiger, irgendein, irgendwelch
someone = ein gewisser, einer, irgend einer, irgendwer, jemand
some one = ein gewisser, einer, irgend einer, irgendwer, jemand
someone's = irgend jemandes, irgend eines
something = etwas, irgendetwas, irgendwas
something new = Neues, Neuheit, Neuigkeit
sometime = ehemals, einmal, einst, einstens, einstmals, irgendwann, je, jemals
sometimes = mal, einmal, eines Tages, manchmal
sometimes ... sometimes = bald ... bald
somewhat = ein bißchen, ein wenig, etwas, ziemlich
somewhere = irgendwo, irgendwohin
son = Sohn
sonata = Sonate
song = Gesang, Lied
song-bird = Singvogel
son-in-law = Eidam, Schwiegersohn
soon = bald, alsbald, baldig
soot = Ruß
soothe = beruhigen
soprano = Diskant, Sopran
sorcerer = Zauberer
sorcery = Zauber, Zaubern
sore = Geschwür
sorrow = Betrübnis
sorrowful = vergrämt
sort = Abart, Art, Gattung, Schlag, Sorte
so that = damit, daß
so to speak = gewissermaßen
soul = Gemüt, Seele
sound = gellen, klingen, läuten, tönen, Hall, Klang, Laut, Schall, Ton
soup = Suppe
sour = herb, sauer, adstringierend, zusammenziehend, brummig, unwirsch
source = Born, Quelle
south = südlich, nach Süden, südwärts, Süden
South Africa = Südafrika
South America = Südamerika
southern = südlich
southward = nach Süden, südwärts
southwards = nach Süden, südwärts
souvenir = Andenken, Erinnerung
sovereign = Souverän
Soviet Union = Sowjetunion
sow = zerstreuen, Sau, säen
spa = Badeort
space = Gelaß, Raum
spaceman = Astronaut, Weltraumfahrer
spacious = ausgedehnt, geräumig, weit
spade = graben, wühlen, Grabscheit, Spaten
spades = Pik, Stich
Spain = Spanien
Spaniard = Spanier
Spanish = Spanisch, spanische Sprache
Spanish fly = Kantharide, spanische Fliege
Spanish language = Spanisch, spanische Sprache
spanner = Schraubenschlüssel
spare = nachsichtig sein, schonen, verschonen, erübrigen, sparen, ersparen
spare time = Ferien
spark = Funke
spark plug = Kerze
sparrow = Spatz, Sperling
spasm = Krampf, Spasmus
spawn = Laich
speak = reden, sprechen
speaker's platform = Tribüne
spear = Lanze, Speer
special = abgesondert, besonder, einzeln, seperat, spezial, speziell
speciality = Abteilung, Fach
specially = ausdrücklich, besonders, speziell
species = Spezies
specific = spezifisch
specify = spezifizieren
specimen = Muster, Probe, Probestück, Spezimen
spectacle = Spektakel
spectacles = Augengläser, Brille
spectator = Zuschauer
speculative = spekulativ
speech = Rede, Vortrag, Wort
speechless = sprachlos, stumm
speed = Tempo, Eile, Geschwindigkeit, Hast
speed-limit = Höchstgeschwindigkeit
speed limit = Höchstgeschwindigkeit
speed up = beeilen, beschleunigen, fördern, befördern
speedwell = Ehrenpreis
speedy = baldig, geschwind, hurtig, rasch, schnell
spell = Zauber
spend = auslegen, verausgaben, angeben, herreichen, verbringen, zubringen
sperm = Samen, Sperma
sperm whale = Pottfisch
sphere = Sphäre
spice = würzen, Gewürz, Spezerei, Würze
spider = Spinne
spiderweb = Spinngewebe
spiked = spitz
spill = verschütten
spin = spinnen
spinach = Spinat
spindle = Welle, Spindel
spine = Wirbelsäule, Rückgrat
spiral = Spirale
spirit = Geist, Genius
spirits = Spirituosen
spiritual = Geistes-, geistig, intellektuell
spiritualism = Spiritismus
spit = speien, ausspeien, auswerfen, spucken
spittoon = Spucknapf
splash = klatschen, plätschern
splender = Gepränge, Pomp
splinter = splittern, Splitter
split = spalten, bersten, splittern
spoil = beschädigen, Schaden zufügen, verletzen, pfuschen, verderben, verschlechtern, verschlimmern
sponge = Schwamm
sponger = Parasit, Schmarotzer
spontaneous = spontan
spool = Haspel, Spule
spoon = Löffel
sporadic = sporadisch, zerstreut
sport = Sport
spot = Ort, Platz, Stätte, Stelle, Terrain, Tupf, beflecken, einflecken, sudeln, Fleck, Flecken, Klecks, Punkt
spray gun = Pistole
spread = ausbreiten, betten, schmieren
spread out = entfalten, betten
spring = Born, Quelle, Frühjahr, Frühling, Lenz, Feder, Triebfeder, springen
spring crocus = Frühlings-Krokus
springtime = Frühjahr, Frühling, Lenz
sprinkle = besprengen
spruce = Tanne, Edeltanne
spruce-fir = Tanne, Edeltanne
spur = Sporn
spur on = anspornen, antreiben, aufhetzen, herausfordern
spurt = spritzen
spurt out = spritzen
spy = belauschen, spionieren, Späher, Spion
squad = Rotte
square = Karree, Quadrat, Viereck, rechtwinklig, Platz
square decametre = Ar
squash = Kürbis
squat = kauern
squeeze = beklemmen, drücken, bedrücken, pressen, zwängen
squint = schielen
squirrel = Eichhorn, Eichhörnchen
squirt = spritzen, sprühen
stab = stacheln, stechen, stecken, sticheln
stable = fest, feststehend, firm, gediegen, stabil, wiederstandsfähig, Stall
stableman = Groan, Reitknecht
stack = aufstapeln, häufen
stadium = Stadium
staff = Stab
stage = Estrade, Phase, Haltestelle, Station, Stadium
stage-manager = Regisseur
staid = ernst, ernsthaft, gesetzt, abstinent, mäßig, nüchtern
stain = flecken, beflecken, einflecken, sudeln
stair = Staffel, Stufe
staircase = Stiege, Treppe
stairs = Stiege, Treppe
stake = Pfeiler, Pfosten, Pfahl, Staket, Zaunpfahl
stale = Jauche
stalk = ausschreiten, schreiten, treten, Halm, Stengel, Stiel
stall = Stall
stallion = Hengst
stammer = stammeln, stottern
stamp = Patrize, Briefmarke, abstempeln
stamp-collecting = Philatelie
stanchion = Pfeiler, Pfosten
stand = Baracke, Bude, Hütte, Scheune, stehen, aufstehen, sich stellen, sträuben
standard = Norm, Richtschnur, Banner, Fahne, Standarte
stand guard = Posten stehen
standing on end = struppig
standing together = solidarisch
stand up = aufstehen, sich stellen, sträuben
staple = Klammer, Krampe
star = Stern
stare = starren, anstarren
stare at = gaffen
starling = Star
start = anstellen, anstiften, veranlassen, anbrechen, anfangen, beginnen, Anfang, Anfang, Beginn
starter = Anlasser
start running = anlaufen
state = behaupten, deklarieren, Reich, Stand, Zustand, Staat
statement = Angabe, Anzeige
statement of policy = Programm
States General = Generalstaaten
station = Bahnhof, Haltestelle, Station
stationer's shop = Schreibwarenhandlung
station-master = Bahnhofsvorsteher
statistics = Statistik
statue = Bildsäule, Standbild, Statue
stature = Gestalt, Statur
stay = Aufenthalt, bleiben, übrigbleiben
stay on = zurückbleiben
stay over = bleiben, übrigbleiben
steak = Beefsteak
steal = entwenden, stehlen
steam = Dampf
steamship = Dampfer
steel = Stahl
steep = abschüssig, steil
steepness = Steilheit
steer = dirigieren, führen, richten, steuern
steering-wheel = Steuer, Steuerrad, Lenkrad
stem = Stengel, Stamm, Baumstamm, Strunk
stench = Gestank
stenography = Kurzschrift, Stenographie
step = schreiten, treten, Schritt, Tritt, Staffel, Stufe
steppe = Steppe
stereotype = Stereotyp
stern = Heck
sterness = Strenge
steward = Intendant
stick = Stab, Stecken, Stock, kleben, leimen
stick to the pan = anbrennen
stiff = starr, steif, spröde
stiffling = erstickend, schwül, Stick-, stickig
still = noch, beruhigen
stimulate = aufhetzen, aufreizen, anspornen, aufhetzen, herausfordern, antreiben, anfeuern, anregen, reizen, anreizen, stimulieren, aufmuntern, ermuntern
stimulus = Anreiz, Anreizung, Stimulation
sting = stacheln, stechen, stecken, sticheln, Stachel, Pik, Stich
stinginess = Geiz
stingray = Rochen
stingy = geizig
stipulation = Bedingung, Klausel, Vorbehalt
stir = bewegen, erschüttern, rühren, quirlen
stir up = agitieren, aufregen, ermutigen, erregen, aufhetzen, aufreizen, antreiben, anfeuern, anregen, reizen, anreizen, stimulieren
stitch = steppen
St. Nicholas = Sankt Niklas, Sankt Nikolaus
stock exchange = Börse, Börsengebäude
Stockholm = Stockholm
stocking = Strumpf
stodgy = überdrüssig, verdrießlich
stoic = stoisch
stoical = stoisch
stoke = heizen
stomach = Magen
stomach ache = Bauchweh
stone = irden, steinern, Stein
stone-cutter = Steinmetz
stonemason = Steinmetz
stool = Taburett
stoop = hängen, sich bücken, biegen
stop = halten, Halt machen, stocken, stoppen, anhalten, bremsen, sperren, abstellen, Haltestelle, Station, aufhören
stopper = Pfropfen, Spund, Stöpsel
stop up = pfropfen, stopfen, verstopfen, zustopfen
storage battery = Akku, Akkumulator, Stromspeicher
storage room = Gewahrsam
store = Butike, Kramladen, Laden, bergen, suspendieren, zurücklegen, Geschäft
storey = Etage, Geschoß, Stock, Stockwerk
stork = Storch
storm = Sturm
story = Etage, Geschoß, Stock, Stockwerk, Historie, Erzählung, Geschichte
stout = wohlbeleibt
stove = Herd, Ofen
stow = einschließen, einsetzen, inserieren
straigh ahead = aufrecht, direkt, gerade, geradeaus, geradeswegs, geradezu
straight = aufrecht, direkt, gerad, gradlinig, unmittelbar
straightforward = einfach, einfältig
straight past = über ... hinaus, vorbei, vorüber
strained = gespannt
strange = ausländisch, fremd, befremdend, kurios, seltsam, sonderbar, wunderlich
stranger = Fremder, Fremdling
strap = Riemen
Strasbourg = Straßburg
strategy = Strategie
straw = Stroh
strawberry = Erdbeere
stray off = sich verirren
streak = Strich
stream = Strömung, Bach
strech = aufziehen, spannen, anspannen, ausspannen, straffen
strecher = Bahre, Träger
strech out = ausbreiten, ausrecken, strecken, ausstrecken, erstrecken
street = Straße
streetcar = Straßenbahn
strength = Stärke, Gewalt, Kraft
stress = Akzent, Betonung, Ton
strict = streng
stride = ausschreiten, schreiten, treten, Schritt, Tritt
strike = hauen, entbrennen, zünden, klopfen, schlagen, streichen, Achtung einflößen, Eindruck machen auf, imponieren, streiken, Streik, treffen
strike a balance = saldieren
string = Saite, Binde, Verband, Flechse, Sehne, Leine, Schnur, Seil, Strang, Strick
stringent = rigoros
strip = Binde, abdecken, häuten, Streifen
stripe = Streifen
stroke = Schlag, Schlagfluß, streicheln, Liebkosen, Strich
stroke of apoplexy = Schlag, Schlagfluß
stroll = Spaziergang, promenieren, spazieren
strong = kräftig, stark
strong drink = Spirituosen
strontium = Strontium
structure = Bildung, Struktur
struggle = sich sträuben, zappeln, kämpfen, Kampf, Schlacht, ringen
stubborn = widerhaarig, eigensinnig, halsstarrig, hartnäckig, starrköpfig, trotzig
student = Student
studio = Studium
study = studieren, Studium
stuff = füllen, stopfen, polstern, Substanz
stumble = stolpern, straucheln
stupid = blödsinnig, stumpfsinnig, albern, dumm
sturdy = fest, befestigt, haltbar, wiederstandsfähig
sturgeon = Stör
stutter = stammeln, stottern
sty = Stall
style = Stil
stylus = Griffel
subdue = überwinden, bezwingen, überwältigen, unterbreiten, unterwerfen
subject = Subjekt, Thema
subjective = subjektiv
subjugate = überwinden, bezwingen, überwältigen, unterbreiten, unterwerfen
subjunctive = Konjunktiv, Subjunktiv, Subjunktivus
subjunctive mood = Konjunktiv
submit = bezwingen, überwältigen, unterbreiten, unterwerfen
subordinate = Untergebene
subscribe = beisteuern
subscription = Abonnement
subsequently = dann, darauf, hernach, hierauf, hinten, hinterher, nachher, später, folglich
subsidy = Subvention
substance = Substanz
substantive = Hauptwort, Substantiv
substitute = substituieren, vertauschen
subterfuge = Ausflucht
subtle = spitzfindig, subtil
subtract = abziehen, subtrahieren
suburb = Vorstadt
succeed = Erfolg haben, gelingen
success = Erfolg, Gelingen
successor = Abkomme, Abkömmling, Epigone
such = derartige, derartiger, derartiges, solche, solcher, solches
such a = als, wie, inwiefern, derartige, derartiger, derartiges, solche, solcher, solches
such as = als, wie, inwiefern
suck = lutschen, saugen
suckle = säugen
sudden = plötzlich
suddenly = jäh
sue = prozessieren, rechten
suet = Schmalz, Talg
suffer = austragen, aushalten, dulden, erdulden, ertragen, leiden, erleiden
suffice = ausreichen, genügen, hinreichen, zureichen
sufficient = auskömmlich, genügend, ziemlich, zulänglich
sufficiently = genug, genügend, hinlänglich, ziemlich
suffix = Suffix
suffocate = erdrosseln, ersticken, erwürgen
sugar = Zucker
suggest = andeuten, weisen, anweisen, zeigen, beantragen, proponieren, vorschlagen, suggerieren
suit = Vollzähligkeit, behagen, fügen, ziemen, geziemen, Anzug, Gewand, Kostüm, Tracht, taugen
suitability = Brauchbarkeit, Tauglichkeit
suitable = gehörig, angemessen, füglich, geeignet, zeitgemäß, tauglich, tüchtig
suitcase = Handkoffer, Felleisen
sulfuric = schwefelig
sulphur = Schwefel
sulphureous = schwefelig
sulphuric = schwefelig
sultan = Sultan
sultry = erstickend, schwül, Stick-, stickig
sum = Betrag, Summe
summarize = summieren, zusammenfassen
summer = Sommer
summery = Übersicht
summit = Kulm, Spitze, Stift, Zacke, Zinke, Zipfel, Fläche, First, Gipfel, Wipfel
summon = rufen, anrufen
sum up = addieren
sun = Sonne
Sunday = Sonntag
superb = grandios, großartig
superficial = flach
superintendant = Intendant
superior = höher, überlegen, Chef
superscription = Überschrift
superstition = Aberglaube
superstitious = abergläubisch
supervise = kontrollieren, nachsehen, überwachen
supper = Abendessen, Abendmahl, Souper
supplement = Ergänzung, Zusatz, Nachtrag
supplementary = ergänzend
supply = liefern, anschaffen, ausstatten, versehen, versorgen, Versorgung, Vorrat
support = anlegen, lehnen, anlehnen, stützen, Stütze, stemmen, unterstützen, unterhalten
supporter = Glied, Anhänger
supporters = Anhang, Gefolge
supporting actor = Statist
supporting base = Sockel
suppose = vermuten, voraussetzen
supposition = Voraussetzung
suppress = erpressen, unterdrücken, erdrosseln, ersticken, erwürgen
sure = bestimmt, gewiß, sicher, zuversichtlich
surely = allerdings, freilich, immerhin, ja, ja doch, wohl, zwar
surface = Fläche, First, Gipfel, Wipfel
surgeon = Chirurg, Wundarzt
surgery = Chirurgie, Wundarzenei-Kunst
surgical operation = Operation
surly = brummig, unwirsch
surmise = mutmaßen, vermuten, voraussetzen
surname = Familienname, Nachname
surpass = bewältigen, überflügeln, übersteigen, überragen, übertreffen
surplus = ergiebig, ersprießlich, förderlich, zuträglich
surprise = Aufsehen, Verwunderung, Wunder, befremden, überfallen, überraschen, Überraschung
surrender = sich ergeben, kapitulieren, Entsagung, Verzichtleistung
surround = umringen, umzingeln
surroundings = Umgebung
suspect = argwöhnen, verdächtigen
suspenders = Hosenträger
suspicion = Argwohn, Verdacht
suspicious = argwöhnisch
sustain = anlegen, lehnen, anlehnen, stützen, stemmen, unterhalten, unterstützen
sustained = beständig, fest, konstant, ständig, stetig, unablässig
swallow = schlingen, schlucken, Schwalbe
swallow up = verschlingen
swamp = Sumpf
swan = Schwan
swap = austauschen, auswechseln, umtauschen, vertauschen, verwechseln
swarm = schwärmen, wimmeln, Gewimmel
sway = schlingen, schwingen
swear = lästern, beeidigen, schwören, beschwören
sweat = schwitzen, Schweiß
Swede = Schwede
Sweden = Schweden
Swedish = schwedisch
sweep = fegen, kehren, abkehren
sweet = süß
sweetheart = Geliebte
sweetness = Süßigkeit
sweet smell = Wohlgeruch
swell = schwellen, strotzen
swelling = Bausch, Puff
swift = geschwind, hurtig, rasch, schnell
swiftly = flugs, geschwind, schnell
swim = schwimmen
swimming trunks = Badehose
swindle = Betrug, Täuschung, Trug, Unterschleif
swine = Schwein
swing = balanzieren, schaukeln, schlingen, schwingen
swish = rauschen
Swiss = schweizerisch, Schweizer
switch = Gerte, Rute
switch off = abstellen
switch on = anstellen
Switzerland = Schweiz, die Schweiz
swoon = in Ohnmacht fallen, ohnmächtig werden
sword = Schwert
sycamore = Ahorn, Platane
syllable = Silbe
symbol = Symbol
symmetric = symmetrisch
symmetry = Ebenmaß, Gleichmaß, Symmetrie
sympathetic = sympathisch
sympathy = Sympathie
symphony = Symphonie
symptom = Symptom
synagogue = Synagoge
syndicate = Syndikat
syntax = Syntax
syphilis = Syphilis
Syrian = syrisch, Syrer
syringe = Injektor
syrup = Sirup
system = System
systematic = systematisch