#setName = words_en_de_cc
#sideOneTitle = ENG
#sideTwoTitle = GER
cab = Droschke, Fiaker
cabbage = Kohl
cabin = Hütte, Kabine, Kajüte, Koje
cabinet = Kabinett, Schrank
cable = Kabel
cachalot = Pottfisch
cactus = Kaktus
cadaver = Kadaver, Leiche
cadger = Parasit, Schmarotzer
cadmium = Kadmium
cadre = Einfassung, Rahmen
Caesar = Cäsar
caesium = Cäsium
café = Café
caftan = Kaftan
cage = Bauer, Käfig
Cairo = Kairo
cake = Kuchen
calabash = Kürbis
Calabria = Kalabrien
calcium = Kalzium
calculate = erachten, kalkulieren, rechnen, berechnen
calculation = Kalkulation, Zählung
calendar = Kalender
calf = Kalb, Wade
calibre = Kaliber
California = Kalifornien
Californian = kalifornisch
calk = kalfatern
call = heißen, nennen, benennen, ernennen, rufen, anrufen
call on = besuchen, einen Besuch abstatten
call out = ausrufen
calm = fromm, sanft, gelassen, gemütlich, ruhig, still, beruhigen
calm down = beruhigen
Calvin = Kalvin
cambric = Batist
camel = Kamel
camphor = Kampfer
camping ground = Campingplatz, Zeltplatz
camping site = Campingplatz, Zeltplatz
campion = Leimkraut
camp of tents = Lager, Zeltlager
camp out = kampieren
Canada = Kanada
Canadian = kanadisch, Kanadier
Canadian woman = Kanadierin
canal = Graben, Kanal
canary = Kanarienvogel
Canary Islands = Kanarische Inseln
cancel = annullieren, für null und nichtig erklären, kassieren
candidate = Bewerber, Kandidat
Candlemas = Lichtmeß
candy = Süßigkeit
cane = Stab, Stecken, Stock, Ried, Rohr, Schilf
canine = hündisch
cannibal = Kannibale, Menschenfresser
cannon = Kanon, Kanone
canoe = Kanoe
can opener = Büchsenöffner
canopy = Baldachin
canteen = Feldflasche
cantharides = Kantharide, spanische Fliege
canvas = Kanevas, Stramin
cap = Haube, Kappe, Mütze
capability = Brauchbarkeit, Tauglichkeit
capable = begabt, fähig, imstande, tüchtig
capital = Kapital, Hauptstadt
capital city = Hauptstadt
capitol = Kapitol
capitulate = sich ergeben, kapitulieren
caprice = Eigensinn, Kaprize, Laune
Capricorn = Steinbock
capsule = Kapsel
captain = Hauptmann, Kapitän
capture = erbeuten, ergreifen, ertappen, erwischen, fangen, fassen
car = Auto, Automobil
carafe = Karaffe
caravan = Karawane
carburettor = Vergaser
card = Karte, Zettel
cardboard = Karton, Pappe
care = Sorge tragen, sorgen, Besorgnis, Sorge
career = Karriere, Laufbahn
care for = behandeln, heilen, kurieren
careful = bedächtig, behutsam, besonnen, vorsichtig, sorgfältig, sorgsam
careless = achtlos, fahrlässig
caress = streicheln, Liebkosen
caressing = einschmeichelnd
Caribbean = karibisch
Caribbean Sea = Karibische Meer
carillon = Glockenspiel
carnation = Nelke
carnival = Fasching, Fastnacht, Karneval
carousel = Karussell, Ringelstechen
carp = Karpfen
carp at = schikanieren, Kleinigkeiten tadeln, wegen
Carpathian mountains = Karpathen
Carpathians = Karpathen
carpenter = Zimmermann
carpet = Teppich
carriage = Lafette, Kalesche, Karosse, Kutsche, Bahnwagen, Wagen, Wagon, Waggon
carrion = Aas
carrot = Karotte, Möhre, Mohrrübe
carrousel = Karussell, Ringelstechen
carry = tragen
carry away = abtragen, fortbringen, wegtragen
carry out = aushalten, austragen
cart = Fuder, Fuhre, Karren
cartridge = Kartätsche, Patrone
carve = hauen, skulptieren, meißeln, ziselieren
case = Angelegenheit, Ding, Sache, Werk, Fall, Kasus
cash = bar, kontant
cashier = Zahlmeister
cashier's stand = Geldkasten, Kasse
casino = Gesellschaftshaus, Kasino
casserole = Bratpfanne, Kasserole, Kochpfanne, Pfanne
cassette = Kassette
Castile = Kastillien
castle = Burg, Kastell, Schloß, Turm, Zwinger
castrate = entmannen, kastrieren, verschneiden
cat = Katze
catalogue = Katalog, Verzeichnis
cataract = Augenstar, Katarakt
catarrh = Katarrh
catastrophe = Katastrophe
catch = entbrennen, zünden, erbeuten, ergreifen, ertappen, erwischen, fangen, fassen, Fang, treffen
catching = infektiös
catechism = Katechismus
category = Kategorie
caterpillar = Raupe
cathedral = Dom, Kathedrale, Münster
catholic = Katholik
Catholisism = Katholizismus
cauldron = Kessel
cauliflower = Blumenkohl, Karfiol
caulk = kalfatern
cause = machen, antun, bewirken, veranlassen, verursachen, zufügen, Anlaß, Grund, Ursache, Veranlassung, hervorrufen
cause pain = betrüben
cause pain to = betrüben
cause to take place = hervorrufen
caution = warnen, Sicherheit, Vorsicht
cautious = bedächtig, behutsam, besonnen, vorsichtig
cavalier = Kämpe, Kavalier, Ritter
cavalry = Kavallerie
cave = Grotte, Höhle, Grube, Höhlung, Vertiefung
cavern = Grube, Höhle
caviar = Kaviar
cavity = Grube, Höhlung, Vertiefung
caw = krächzen
cease = aufhören
ceaselessly = fortwährend, unaufhörlich
cedar = Zeder
cede = abtreten, nachgeben, weichen
ceiling = Decke, Zimmerdecke
celebrate = feiern
celebrating one's birthday = Geburtstag haben
celebration = Feier, Fest
celebrity = Berühmtheit
celery = Eppich, Sellerie
cell = Karzer, Zelle
cellar = Keller
cello = Violincello
Celsius = Celsius
cement = Zement
cemetery = Friedhof, Gottesacker, Kirchhof
censor = zensieren, Zensur
censure = begutachten, kritisieren
cent = Cent
centavo = Centavo
centimetre = Centimeter, Zentimeter
centipede = Tausendfuß
central = zentral
Central African Republic = Zentralafrikanische Republik
Central Asia = Zentralasien
central heating = Zentralheizung
centre = Mittelpunkt, Zentrum
century = Jahrhundert
Cerberus = Zerberus
ceremonious = feierlich, festlich
ceremony = Feierlichkeit, Förmlichkeit, Zeremonie, Feier, Festlichkeit
cerium = Cerium
certain = bestimmt, gewiß, sicher, zuversichtlich
certainly = bestimmt, gewiß, allerdings, freilich, immerhin, ja, ja doch, wohl, zwar
certainty = Bestimmtheit, Gewißheit, Sicherheit, Zuversicht
certificate = Akt, Akte, Attest, Testimonium, Zeugnis, Zertifikat
cession = Entsagung, Verzichtleistung
chain = Kette
chair = Stuhl
chalice = Becher, Kelch
chalk = Kreide
chamber = Gemach, Stube, Zimmer
chameleon = Chamäleon
chamois = Gemse, Gemshaut, sämisches Leder, Waschleder
chamois leather = Gemshaut, sämisches Leder, Waschleder
champagne = Champagner
chance = zufällig, Hasard, Zufall, Begebenheit, Gelegenheit, Geschehnis, Ereignis, Fall, Vorfall, Chance
chandelier = Kronleuchter, Lüster
change = Umänderung, Kleingeld, ändern, tauschen, umändern, umtauschen, wechseln, umwechseln, Kleingeld, Abwechslung, Änderung, Tausch, Veränderung, Wechsel
channel = Graben, Kanal, Rohr, Röhre, Schlauch
chaos = Chaos
chapel = Kapelle
chaplain = Feldgeistlicher
chapter = Kapitel
character = Charakter, Gemüt, Natur, Abzeichen, Anzeichen, Kennzeichen, Merkzeichen, Wink, Zeichen
characterize = charakterisieren, kennzeichnen
charge = laden, Belastung, Bürde, Fuhre, Ladung, Last
chariot = Fuder, Fuhre, Karren
charity = Almosen, Barmherzigkeit
charlatan = Scharlatan, Quacksalber
charm = Amulett, anmuten, Anmut
charming = allerliebst, anmutig, hold, lieblich, reizend
chase = anfeuern, treiben, vor sich hertreiben, fahnden, nachzusetzen, verfolgen, jagen
chase away = austreiben, ausweisen, fortjagen, vertreiben, wegjagen
chasm = Abgrund, Tiefe
chaste = keusch, züchtig
chastity = Zucht
chat = Geplauder, plaudern, schwatzen
chatter = plaudern, schwatzen
chauffeur = Chauffeur, Fahrer
chauvinism = Übereifer
cheap = billig
cheat = Gauner, Halunke, Schuft, Schurke, Spitzbube, äffen, betrügen, hintergehen, täuschen
Chechenia = Tschetschenien
check = zügeln, Zaum, Zäumung, kontrollieren, nachsehen, überwachen, Bankanweisung, Scheck
checkers = Damspiel, Damespiel
check up on = kontrollieren, nachsehen, überwachen
cheek = Backe, Wange
cheerful = fröhlich, heiter, lustig, vergnügt
cheese = Käse
chemist = Apotheker
chemistry = Chemie
chemist's shop = Apotheke
cheque = Bankanweisung, Scheck
cherry = Kirsche
cherry-tree = Kirschbaum
chess = Schach, Schachspiel
chessboard = Schachbrett
chess-board = Schachbrett
chest = Brust, Busen, Kasten, Kiste, Truhe, Kommode
chestnut = Kastanie, Marone
chestnut-tree = Kastanienbaum
chew = kauen
chick = Kücken, Küken
chicken = Kücken, Küken, Henne, Huhn
chicory = Zichorie
chief = Befehlshaber, Häupling, Herr, Oberhaupt, Vorsteher, Haupt-, hauptsächlich, Chef, Haupt
chief- = Haupt-
chiefly = besonders, eigens, insbesondere, vornehmlich, vorzüglich, zumal
chief of police = Kommissar
child = Kind
child-birth = Gebären, Geburt
Chile = Chile
Chilean = chilenisch, Chilene
chimera = Chimäre
chimes = Glockenspiel
chimney = Esse, Schornstein
chin = Kinn
China = China
Chinaman = Chinese
Chinese = Chinese, Chinesisch, Chinesin
Chinese lady = Chinesin
Chinese language = Chinesisch
Chinese woman = Chinesin
chirp = piepen, zwitschern
chisel = meißeln, ziselieren, Meißel, Stemmeisen
chive = Schnittlauch
chlorine = Chlor
chocolate = Schokolade
choice = Auslese, Wahl
choke = erdrosseln, erwürgen, ersticken
cholera = Cholera
choose = auslesen, wählen, auswählen, erwählen
chop = hacken, hauen
chord = Akkord
chorus = Chor, Sängerchor
chrestomathy = Chrestomatie
Christ = Christus
christen = taufen
christening = Taufe
Christian = Christ
Christianity = Christentum
Christmas = Weihnachten
Christmas rose = Christrose, Schwarze Nieswurz
chromium = Chrom
chronicle = Chronik
chuck = streicheln, Liebkosen
chunk = Kloß, Klumpen
chunk of wood = Holzscheit, Klotz, Scheit
church = Kirche
church-building = Kirche
cider = Apfelwein, Obstwein, Zider
cigar = Zigarre
cigar-end = Zigarrenstummel
cigarette = Zigarette
cigar-stub = Zigarrenstummel
cinder = Asche
Cinderella = Aschenbrödel
cinema = Kino
cinnamon = Zimmet, Zimt
cipher = Zahl, Zahlzeichen, Ziffer
circle = Bezirk, Kreis, Runde, Association, Gesellschaft, Sozietät
circular = Rundschreiben, Zirkular
circulate = umlaufen, zirkulieren
circulation = Zirkulation
circumcise = beschneiden
circumference = Perimeter
circumflex = Zirkumflex
circumstance = Bewandnis, Umstand
circumstances = Fassung, Lage, Situation, Zustand
circumvent = umgehen
circus = Zirkus
cistern = Behälter, Zisterne
citadel = Zitadelle
citation = Zitat, Anführung
cite = anführen, erwähnen, nennen, zitieren
city = Ort, Stadt
city hall = Rathaus
city state = Bürgerschaft
civil = bürgerlich, zivil
civilian = bürgerlich, zivil
civilization = Aufklärung, Bildung, Gesittung, Zivilisation
civilize = bilden, gesittet machen, zivilisieren
civilized = gesittet
claim = Anspruch machen auf, beanspruchen, zumuten, Anspruch
clamp = Klammer, Krampe
clan = Abkunft, Geschlecht, Gezücht, Sippe, Stamm
clap = applaudieren, Beifall spenden, Gonorrhöe, Tripper, klacken, klappen, schnalzen
clarify = darlegen, einleuchten, erklären, erläutern
clasp = raffen, Agraffe, Spange
class = Klasse, Kurs, Kursus
classic = klassisch
classical = klassisch
clatter = verhauen
claw = Klaue, Kralle
clay = irden, Lehm, Ton, Tonerde
clean = blank, rein, reinlich, sauber
cleanliness = Reinheit, Reinlichkeit, Sauberkeit
clear = hell, licht, lichtvoll, erhellen, anschaulich, bestimmt, deutlich, klar
clear away = abräumen
clearly = ausdrücklich
Cleopatra = Kleopatra
clergyman = Geistliche, Pastor, Pfarrer, Priester
clerk = Büroangestellte, Handlungsgehilfe, Kommiß, Ladengehilfe, Angestellte, Kanzlist
clever = anstellig, behende, fix, geschickt, geübt, gewandt, abgefeimt, arglistig, gerieben, gewiegt, gewitzt, listig, schlau
click = klacken, klappen, schnalzen
client = Klient, Kunde
climate = Klima
climb = klettern, klimmen, steigen, ersteigen
clinic = Klinik
clip = scheren, abscheren, schneiden, abschneiden
cloak = Mantel, Umhang
cloakroom = Garderobe
clock = Uhr
clod = Kloß, Klumpen
clog = pfropfen, stopfen, verstopfen, zustopfen
close = schließen, verschließen, zumachen, zufallen, gemütlich, innig, intim, vertraulich, vertraut, bevorstehend, kommend, künftig, nächst, nahe
closed = geschlossen, zu
closet = Schrank
cloth = Tuch, Stoff, Zeug
clothe = anziehen, kleiden, ankleiden, bekleiden
clothes = Kleider
clothing = Kleider
cloud = Wolke
cloudy = Wolken-, wolkig
clover = Klee
club = Klub, Association, Gesellschaft, Sozietät
club member = Mitglied eines Klubs
clubs = Treff
cluster = Bund, Bündel, Büschel, Fascikel
clutch = greifen, angreifen, ergreifen, Kupplung
co- = aneinander-
coach = erziehen, Erziehung leiten, Kalesche, Karosse, Kutsche, Bahnwagen, Wagen, Wagon, Waggon
coal = Kohle
coarse = arg, barsch, grob, holperig
coast = Küste
coat = Paletot, Mantel, Überrock, Überzieher
cobalt = Kobalt
cock = Hahn
cockroach = Schabe
cocoa = Kakao
coconut = Kokosnuß
cocoon = Kokon
cod = Dorsch, Kabeljau
coddle = hätscheln, verhätscheln, verzärteln, verziehen
code = Chiffre, Marke
codfish = Dorsch, Kabeljau
coffee = Kaffee
coffee-house = Café
coffee-pot = Kaffeekanne
coffin = Sarg
cognac = Kognak
coil = Haspel, Spule
coin = Geldstück, Münze
coincide = kongruieren
coir = Chor, Sängerchor
coir loft = Chor
cold = Kälte, Erkältung
collar = Kragen
colleague = Amtsbruder, Amtsgenosse, Genosse, Kollege
collect = sammeln, einsammeln
collection = Ar
collective = kollektiv, zusammenfassend
college = Kollegium
collision = Kollision
Cologne = Köln
Colombia = Kolumbien
colonel = Oberst
colonize = ansiedeln
colony = Ansiedelei, Ansiedlung, Kolonie
colossus = Koloß
colour = färben, Farbe
columbine = Aglei, Akelei, Glockenblume
column = Kolumne, Säule, Spalte, Rubrik
comb = kämmen, Kamm
combine = kombinieren
come = entspringen, entstehen, herkommen, stammen, abstammen, kommen
come about = werden, zu stande kommen, geschehen, passieren, sich ereignen, stattfinden, vorkommen
come across = antreffen, begegnen
come close = bevorstehen
come closer = bevorstehen
comedy = Komödie, Lustspiel
come into = hereinkommen, hineinkommen
come on = bevorstehen
come out = auskommen, herauskommen, hinauskommen
comet = Komet, Schweifstern
come to a halt = halten, anhalten, Halt machen, stocken, stoppen
come to an agreement = übereinstimmen
come to an end = enden, endigen
come true = zustandekommen
comfort = Behaglichkeit, Komfort, trösten, Trost spenden
comfortable = bequem, gemächlich, wohnlich
comic = drollig, komisch, spaßhaft
comical = drollig, komisch, spaßhaft
comma = Komma
command = befehligen, kommandieren, anordnen, befehlen, gebieten, verordnen, vorschreiben, Anlaß, Befehl, Edikt, Gebot, Weisung
commander = Befehlshaber
commence = anbrechen, anfangen, beginnen
commencement = Anfang, Beginn
commencing salary = Anfangsgehalt
commend = rühmen, verherrlichen, loben, preisen, anpreisen, empfehlen, anpreisen
commerce = Handel
commission = Auftrag, Bestellung, Kommission
commit adultery = ehebrechen
committee = Ausschuß, Komitee
commodity = Artikel
common = gemein, allgemein, gemeinsam, gemeinschaftlich, gewöhnlich, üblich, verständlich, vulgär
commonplace = abgedroschen, banal, fade, trivial
commotion = Ärgernis, Skandal
communicate = anschließen, mitteilen, teilhaftig machen, verbinden
communication = Bericht, Mitteilung, Nachricht, Auskunft, Bekanntmachung
communication-cord = Notbremse
communion = Kommunion
communism = Kommunismus
communist = Kommunist
community = Gemeinde
commute = umschalten, umschnallen
compact = fest, kompakt, massig
companian = Gefährte
companion = Kamerad, Gefährte, Genosse, Geselle
company = Firma, Gesellschaft, Kompagnie
compare = vergleichen
comparison = Gleichnis, Vergleich
compartment = Abteilung, Fach, Abteil, Coupé, Kupee
compass = Kompaß
compel = zwingen
compensate = ausgleichen, entschädigen, ersetzen, vergüten, lohnen, belohnen, vergelten
compensation = Belohnung, Lohn
compete = konkurrieren, wetteifern
competent = kompetent, zuständig
competition = Wetteifer, Konkurrenz-Prüfung, Preisausschreiben, Wettbewerb
compile = kompilieren
complain = klagen, sich beklagen, verklagen
complaint = Beschwerde, Klage
complementary = ergänzend
complete = vervollständigen, voll
completed = fertig
completely = völlig
complex = Komplex, umständlich
complexion = Gesichtsfarbe, Teint
complicate = komplizieren, verwickelt machen
complicated = umständlich
compliment = Höflichkeiten erweisen, Komplimente machen, komplimentieren
compose = abfassen, verfassen
composing = Zusammenstellung
comprise = umfangen, umfassen, enthalten
computation = Kalkulation, Zählung
computer = Computer, Datenverarbeiter
comrade = Genosse, Kamerad
concave = hohl
conceal = bergen, hehlen, verbergen, verhehlen, verheimlichen, verstecken
conceited = eitel, hinfällig
concentrated = dicht, gedrängt, geschlossen
concept = Konzept
conception = Verständnis
concern = Tragweite, Wichtigkeit, angehen, anlangen, betreffen, sich beziehen, verkehren, Besorgnis, Sorge
concerning = anbelangt, betreffend, über, von, betreffs, bezüglich
concert = Musikaufführung, Konzert
concise = bündig, gedrängt, konzis, kurz
conclusion = Erfolg, Ergebnis, Resultat
concord = Akkord, Abkommen, Einklang, Übereinkommen, Übereinstimmung
concrete = Beton, konkret
concurrence = Akkord, Abkommen, Einklang, Übereinkommen, Übereinkunft, Übereinstimmung
condemn = verdammen, verurteilen
condition = Bedingung, Klausel, Vorbehalt, Fassung, Lage, Situation, Stand, Zustand
condolences = Beileid
conduct = lenken, führen, leiten, Aufführung, Benehmen, Betragen, Gebahren, Verhalten
conduct oneself = sich aufführen, sich benehmen, sich betragen, sich verhalten
conductor = Fahrer, Chauffeur
cone = Kegel, Konus
confectionery = Konditorei
confederation = Konföderation
conference = Beratung, Konferenz
confess = beichten, anerkennen, gestehen, eingestehen, beichten
confession = Beichte, Bekenntnis, Eingeständnis, Geständnis, Beichte
confide = betrauen mit, vertrauen mit, Vertrauen setzen in, zutrauen
confidence = Vertrauen, Zuversicht
confine = begrenzen, beschränken, einschränken
confirm = bekräftigen, bestätigen, konfirmieren
confirmation = Firmelung
confiscate = mit Beschlag belegen, konfiszieren
conflict = Konflikt, Streit, Widerstreit
conforming = gleich, entsprechend, konform
confuse = in Unordnung bringen, in Verwirrung bringen, verwirren
confusion = Gewirr, Trubel, Verwirrung, Wirrsal
congenital = angeboren
congentital = angeboren
congratulate = beglückwünschen, gratulieren
congratulation = Glückwünsch, Gratulation
congregate = sich treffen, sich versammeln, zusammenkommen, zusammentreffen
congress = Kongreß
conjecture = mutmaßen, vermuten
conjunction = Bindewort, Konjunktion
connect = verknüpfen, binden, verbinden
connection = Anschluß, Allianz, Band, Bund, Bündnis, Liga, Verband, Verbindung
conscience = Gewissen
conscientious = gewissenhaft
conscious = wissentlich
consciousness = Bewußtsein
consecutively = hintereinander
consent = beipflichten, beistimmen, einwilligen, zustimmen, zuwilligen, Einigkeit, Eintracht
consequence = Konsequenz, Folge, Sequenz
consequently = folglich
conservative = konservativ
conserve = aufbewahren, behalten, bergen, erhalten, konservieren
consider = berücksichtigen, betrachten, erwägen, sich überlegen, anblicken, ansehen, blicken, schauen, zuschauen, zusehen
consideration = Anbetracht, Erwägung
consignee = Empfänger
consist = bestehen
consistency = Folge, Konsequenz
consist of = bestehen aus
consolation = Trost
console = trösten, Trost spenden
consonant = Konsonant, Mitlaut
conspiracy = Komplott, Verschwörung
conspire = sich verschwören
constant = beständig, fest, konstant, ständig, stetig, unablässig
constantly = immer, stätig, stets
constitution = Konstitution, Verfassung
constringent = adstringierend, zusammenziehend
construct = bauen, aufbauen, erbauen, konstruieren
consul = Konsul
consulate = Konsulat
consul general = General-Konsul
consult = befragen, konsultieren, nachschlagen, zu Rate ziehen
consume = abnutzen, aufzehren, konsumieren, verbrauchen, zehren, verzehren
consumption = Schwindsucht, Phtisis
contact = Berührung, Kontakt
contagion = Infektion
contagious = infektiös
contain = enthalten
container = Behälter, Besteck, Krug
contamination = Infektion
contempt = Verachtung
contented = zufrieden
contents = Inhalt
contest = Konkurrenz-Prüfung, Preisausschreiben, Wettbewerb
continent = Erdteil, Festland, Kontinent
contingent = etwaig, eventuell
continual = beständig, fest, konstant, ständig, stetig, unablässig
continuation = Fortsetzung
continue = dauern, währen, fortfahren, fortführen
continuous = unablässig
contort = drehen, ringen, winden
contour = Außenlinie, Kontur, Umriß
contraband = Konterbande, Schleichhandel, Schmuggel
contract = Akkord, Traktat, Vertrag
contradict = widersprechen
contralto = Altstimme
contralto voice = Altstimme
contrary = widerwärtig, verkehrt
contrast = Gegensatz, Kontrast
contribution = Beisteuer, Kontribution
control = Regierung, herrschen, beherrschen, regieren
controversy = Polemik
convenient = bequem, gelegen, gemächlich
convention = Kongreß, Konvention
converge = konvergieren, zusammenlaufen
conversance = Bekanntschaft
conversation = Unterredung, Gespräch, Konversation, Unterhaltung
converse = sich unterhalten
conversion = Umänderung, Abwechslung, Änderung, Tausch, Veränderung, Wechsel
convert = bekehren, umstimmen, Proselyt
convey = angeben, aushändigen, einhändigen, herreichen, überliefern
convince = überreden, überzeugen
convulsion = Krampf, Konvulsion, Zuckung
cook = kochen, Köchin
cookie = Biskuit, Bisquit, Zwieback
cooking pot = Pfanne
cool = kühl
Copenhagen = Kopenhagen
copious = reichlich
copper = ehern, Kupfer
copy = Exemplar, Abdruck, Abschrift, Kopie, Nachbildung
copyright = Verlagsrecht
coquettish = gefallsüchtig, kokett
cord = Saite, Leine, Schnur, Seil, Strang, Strick
cordon = Kordon, Postenkette
core = Kern, Obststein
cork = Kork, Pfropfen, Stöpsel
corkscrew = Korkenzieher
cormorant = Kormoran
corn = Hühnerauge, Leichdorn, Schwiele, Mais
corner = <wucherisch aufkaufen>, Ecke
cornflower = Kornblume
corporal = Korporal, Unteroffizier
corporation = Innung, Körperschaft, Korporation, Zunft
corps = Korps
corpse = Kadaver, Leiche
corpulent = dick
correct = berichtigen, korrigieren, verbessern, recht, richtig, zutreffend
correspond = entsprechen, in Briefwechsel stehen, korrespondieren
corridor = Gang, Hausflur, Flur, Korridor
corridor train = D-Zug
corroborate = bekräftigen, bestätigen, konfirmieren
corrosive sublimate = Sublimat
Corsica = Korsika
Corsican = korsisch, Korse
Corsican woman = Korsin
cosmetic powder = Puder
cosmos = Kosmos
cost = kosten, Unkosten
Costa Rica = Kostarika
costly = teuer
costume = Anzug, Gewand, Kostüm, Tracht
cottage = Häuschen, Hütte
cotton = Kattun, Baumwolle
cotton-wool = Watte
couch = Couch, Divan, Ruhelager, Kanapee
cough = Husten
counsel = Advokat, Anwalt, Rechtsanwalt, avisieren, raten, beraten, ratgeben, Rat, Ratschlag
count = Graf, erachten, kalkulieren, rechnen, berechnen, zählen, aufzählen
count down = abrechnen
countertenor = Altist
count in = addieren, hinzurechnen
countless = zahllos
country = Gefilde, Land
countryside = Gefilde, Land
coupé = Abteil, Coupé, Kupee
couple = Ehepaar, einrücken, kuppeln
coupon = Coupon, Zinsabschnitt
courage = Mut
courageous = beherzt, dreist, getrost, mutig, tapfer
courier = Eilbote, Kurier
course = Kurs, Kursus, Schale, Schüssel, trivial
court = den Hof machen, poussieren, Instanz, Gericht, Hof, Hofraum
courteous = artig, galant, höflich
courtroom = Gericht
courtyard = Hof, Hofraum
cousin = Base, Kusine, Cousin, Vetter
cover = Einband, belegen, decken, bedecken, einhüllen, verhüllen, zudecken, Deckel, Umschag, Verdeck, Bedeckung, Decke, Hülle, beziehen, überziehen, durchgehen, durchqueren, hindurchgehen
covet = gelüsten
covetousness = Gelüst, Gierde, Habsucht
cow = Kuh
cower = kauern
cowl = Kappe, Kapuze
crab = Krabbe
crack = Spalte, knallen, knarren, krachen
cradle = Wiege
cramp-iron = Armatur
crane = Kranich
crane's-bill = Geranium, Storchschnabel
crawl = kriechen
crayfish = Krebs
craze = Wut
craziness = Wahnsinn
crazy = irre, toll, verrückt, wahnsinnig
creak = fletschen, knirschen, knarren
cream = Rahm, Sahne
crease = zerknittern, zerknüllen
create = schaffen, erschaffen, abfassen, verfassen
creature = Gebilde, Geschöpf
credit = Kredit, ergiebig, ersprießlich, förderlich, zuträglich
credulous = leichtgläubig
creep = kriechen
crevice = Spalte
crew = Mannschaft
cricket = Grille, Heimchen
crime = Frevel, Verbrechen, Vergehen
criminal = Bösewicht, Verbrecher
crimson = Karmesin
crippled = gebrechlich, krüppelhaft, verkrüppelt
crisis = Krisis, Krise
criticize = begutachten, kritisieren
croak = krächzen
Croatia = Kroatien
crockery = Fayence, Steingut
crockery set = Geschirr, Tisch-Service
crocodile = Krokodil
crook = Gauner, Halunke, Schuft, Schurke, Spitzbube
cross = arg, böse, Kreuz, entern, übergeben, übertreten
cross roads = Straßenkreuzung
crouch = kauern
crow = Krähe
crowbar = Winde, Hebel
crowd = Haufen, Menge, Stapel
crown = Kranz, Krone
crucifix = Kruzifix
crucify = kreuzigen
crude = rauh, roh, arg, barsch, grob
crude oil = Naphta, Erdöl, Petroleum
cruel = grausam
cruise = kreuzen
crumble = bröckeln, zerknittern, zerknüllen
crumble away = bröckeln
crumble off = bröckeln
crush = zerschmettern, kleinstoßen, zermalmen, zerstampfen, zerstoßen
crust of the earth = Erdrinde, Erdkruste
cry = weinen
cry down = in Mißkredit bringen
cry out = schreien
crystal = Kristall
Cuba = Kuba
Cuban = Kubaner, kubanisch
cube = Kubus, Würfel
cubic = kubanisch
cuckoo = Kuckuck
cucumber = Gurke
cuddlesome = einschmeichelnd
cuddly = einschmeichelnd
cult = Kultus
culture = Kultur
cultured = gebildet, gesittet
cunning = abgefeimt, arglistig, gerieben, gewiegt, gewitzt, listig, schlau
cup = Tasse
cupboard = Schrank
cupola = Dom, Gewölbedach, Kuppel
cure = behandeln, heilen, kurieren, wiederherstellen, genesen
curiosity = Wißbegier
curious = kurios, merkwürdig, seltsam, gespannt, neugierig
curl = Locke, frisieren, quirlen
currant = Johannisbeerstrauch, Johannisbeere
currant bush = Johannisbeerstrauch
currency = Valuta, Währung, Wert
current = aktuell, Strömung, heutig, jetzig, gegenwärtig
curry = striegeln
curse = lästern, verfluchen, verwünschen
curtain = Gardine, Vorhang
curtsy = biegen, sich verneigen, Reverenz, Verbeugung
curve = Kurve
curved = gebogen, krumm
cushion = Kissen
cuspidor = Spucknapf
cuss = lästern
custom = Angewohnheit, Gebrauch, Gepflogenheit, Gewohnheit, Usus, Brauch, Sitte
customary = geläufig, üblich
customer = Klient, Kunde
customs = Zollamt
cut = mähen, abmähen, hacken, hauen, scheren, abscheren, abschneiden, schneiden
cut into = anbrechen
cutlet = Kotelett
cut off = abschneiden
cut up = in Mißkredit bringen
cycle = Fahrrad, Rad, Rover, Zeitkreis, Zyklus
cyclone = Wirbelwind, Zyklon
cylinder = Walze, Zylinder
cylinder phonograph = Phonograph
cymbal = Zimbel
cynical = zynisch
cypres = Zypresse
Cypriot = zyprisch, Zypriot
Cypriote = zyprisch
Cyprus = Zypern
czar = Zar
Czech = Tschechisch, tschechische Sprache