#setName = words_en_de_tt
#sideOneTitle = ENG
#sideTwoTitle = GER
table = Tabelle, Verzeichnis, Tisch
table-cloth = Tischtuch
tablet = Tabelle, Verzeichnis
tabulation = Tabelle, Verzeichnis
tact = Takt
tactic = Taktik
tactics = Taktik
tadpole = Kaulquappe
Tagus = Tajo
tail = Bürzel, Fahne, Lunte, Rute, Schleppe, Schwanz, Schweif, Sterz, Wedel
tail-light = Rücklampe, Schlußlicht, Schlußlampe
tailor = schneidern, Schneider
tails = Frack, Rock
take = annehmen, empfangen, genehmigen, bekleiden, besetzen, einnehmen, in Anspruch nehmen, fassen, nehmen
take a break = pausieren
take action = agieren, handeln, verfahren, vorgehen, wirken
take along = mitbringen, mitnehmen
take an interest = sich interessieren
take a rest = pausieren
take a switch to = stäupen
take away = abholen, abnehmen, abräumen, entziehen, fortnehmen, wegnehmen
take care = Sorge tragen, sorgen
take fire = entbrennen, zünden
take in = abonnieren, annehmen, empfangen, genehmigen
take into account = berücksichtigen, betrachten, erwägen, sich überlegen
taken aback = bestürtzt
take note = als Tatsache feststellen, konstatieren
take off = zurücklegen
take one's measure for = anpassen
take over = kaufen, sich kaufen
take part = mitmachen, teilnehmen
take refuge = seine Zuflucht nehmen zu, sich flüchten
take steps = sich anstrengen, sich bemühen, trachten nach
take the place of = ablösen, ersetzen
tale = Erzählung, Geschichte
talent = Talent
talented = begabt, talentiert
talisman = Amulett
talk = reden, sprechen
talkative = beredsam
tall = erhaben, hoch
tallow = Schmalz, Talg
Talmud = Talmud
tambourine = Tamburin
tame = abrichten, bändigen, dressieren, zahm, zähmen
tan = gerben
tangle = Chaos
tank = Zisterne, Behälter
tannin = Gerbstoff, Tannin
tap = Hahn, Kran, Zapfen
tape = Binde, Streifen
taper = Wachskerze
tapestry = Tapete
tar = Teer
tarantula = Tarantel
tard = Fladen
tardy = spät
target = Ziel, Zweck
tart = herb, sauer, adstringierend, zusammenziehend, Torte
Tartar = Tatar
task = Arbeit, Aufgabe, Pensum
taste = Geschmack, kosten, schmecken
tasteless = fade
tasty = delikat
Tatar = tatarisch
tax = Abgabe, Steuer, Steuerabgabe
tax collector = Zöllner
tax form = Steuererklärung
taxi = Taxe, Taxi
tea = Tee
teach = abgewöhnen, entwöhnen, lehren, belehren, instruieren, unterrichten, unterweisen
teacher = Lehrerin, Lehrer
tea-house = Teepflanzung, Teeplantage
teapot = Teekanne
tea-pot = Teebüchse
tear = Träne, reißen, einreißen, zerreißen, zerren, zupfen
tear off = abreißen, losreißen, pflücken, abpflügen
teat = Brust, Mutterbrust
technical = technisch
technics = Technik
technique = Technik
technology = Technologie
teeth = Gebiß
teetotalism = Abstinenz, Enthaltsamkeit
teetotaller = Abstinenzler
telegram = Telegramm
telegraph = telegraphieren, Telegraph
telephone = anrufen, telephonieren, Telephon
telescope = Teleskop
television set = Fernsehapparat, Fernsehgerät
tell = erwähnen, sagen, beauftragen, betrauen, anordnen, befehlen, gebieten, verordnen, vorschreiben, erzählen
tell a lie = flunkern, lügen, belügen
tellurium = Tellur
temper = hart machen, härten, abhärten, stählen, Humor, Laune, Stimmung
temperament = Temperament
temperate = abstinent, mäßig, nüchtern
temperature = Temperatur, Witterung
tempest = Sturm
temple = Schläfe, Tempel
temporarily = einstweilig
temporary = Interim-, provisorisch
tempt = in Versuchung führen, versuchen
temptation = Versuchung
ten = zehn
tench = Schleie
tendency = Stimmung, Inklination, Lust, Tendenz
tender = süß, aufführen, bieten, anbieten, darstellen, vorstellen, präsentieren, Lieferungsausschreibung, Verdingung, Lieferungsausschreibung, Verdingung, beantragen, proponieren, vorschlagen, Anerbieten, Antrag, Gebot, sorgfältig, sorgsam
tenderness = Weichheit
tendon = Flechse, Sehne
tend to = pflegen, warten
tenor = Tenor
tenor violin = Bratsche
tension = Anstrengung
tent = Baracke, Zelt
tented camp = Lager, Zeltlager
tenth = zehnter
term = Ausdruck, Terminus, Wort
terminate = beschließen, enden, beenden, endigen, beendigen, erledigen, Endung
termite = Termite
terms = Bedingung, Klausel, Vorbehalt
terrace = Altan, Terrasse
terrain = Gelände
terrestrial = irdisch, terrestrisch, erdhaft
terrible = entsetzlich, furchtbar, gräßlich, schrecklich
terrify = in Schrecken setzen, entsetzen, Entsetzen verbreiten
territorial = territorial
territory = Gebiet, Gelände, Territorium
terror = Entzetzen, Grauen, Schreck, Schrecken
tertian fever = Wechselfieber
test = Examen, Essay, erproben, probieren, prüfen, versuchen, Probe, Prüfung, Versuch
testament = Testament, Vermächtnis
testicle = Hoden
testify = beglaubigen, bescheinigen, bezeugen
testimony = Attest, Testimonium, Zeugnis, Zertifikat
Teuton = Germane
text = Text
textile = Gewebe, Gewirk
thallium = Thallium
than = als
thank = danken, sich bedanken, verdanken
thankful = dankbar, erkenntlich
thankless = undankbar
thanks = Dank, danke
thanks to = dank
thank you = danke
that = daß, was, wen, das, der, die, welche, welcher, welches, wer, so, ebenso
that is = das heißt, das ist
that kind of = derartige, derartiger, derartiges, solche, solcher, solches
that much = sofern, insofern, sosehr, ebensosehr, soviel, ebensoviel, soweit
that one = das, der, die, derjenige, jener
that one over there = das, der, die, derjenige, jener
that one's = deren, dessen
that ... over there = jene, jenes, dortig, das, der, die, derjenige, jener
that over there = das, dies, jenes
that way = auf die Weise, so, dahin, dorthin, hierhin, nach dort
thaw = tauen, auftauen, Tauwetter
the = am, desto, um so, das, der, die
theatre = Theater
theatrical = Theater-, theatralisch
the day after tomorrow = übermorgen
thee = dir, euch, Ihnen, dich, euch, Sie
theft = Diebstahl
The Hague = Haag
their = ihre
them = ihnen, sie, sie
theme = Thema
then = also, daher, denn, doch, folglich, jedoch, somit, wohl, damals, dann, alsdann, danach, hierauf
thence = daher
the Netherlands = Niederlande
theocracy = Theokratie
theologian = Theologe
theology = Theologie
theorem = Theorem
theory = Theorie
the power of suggestion = Suggestion
therapy = Therapie
there = hier, hier ist, siehe, dahin, dorthin, hierhin, nach dort, da, dort
thereabout = annähernd, etwa, gegen, umher, ungefähr, zirka
thereabouts = annähernd, etwa, gegen, umher, ungefähr, zirka
thereafter = danach
thereby = dadurch
therefore = denn, doch, folglich, jedoch, somit, wohl, dafür, also, daher, darum, deshalb
therein = darin
thermometer = Thermometer
thermos = Isolier-Gefäß
thermos bottle = Isolier-Gefäß
thermos flask = Isolier-Gefäß
the same = dasselbe, derselbe, dieselbe
these = dies
thesis = These
the Sleeping Beauty = Dornröschen
the ... the = je ... desto
the Ukraine = Ukraine, die Ukraine
the Vatican = Vatikan
they = sie, man
thick = dicht, gedrängt, geschlossen, dick
thicken = dicker machen
thief = Dieb
thigh = Schenkel, Oberschenkel
thin = hager, mager
thing = Ding, Gegenstand, Objekt
think = bedünken, befinden, dafür halten, erachten, meinen, denken, bedenken, erwägen, sich überlegen
think about = bedenken, erwägen, sich überlegen
think ahead = antizipieren, vorausnehmen, vorwegnehmen
think to oneself = erwägen, nachdenken, nachsinnen
think well of = achten, hochschätzen
thirst = Durst
thirteen = dreizehn
thirty = dreißig
this = dies, diese, dieses, dieser
this afternoon = heute Nachmittag
this evening = heute abend
this here = dies
thisle = Distel, Karde
this way = hierher, hierhin, hüben, nach hier
thither = dahin, dorthin, hierhin, nach dort
thorium = Thorium
thorn = Dorn, Grat, Stachel
thoroughgoing = eingehend
those = das, dies, jenes, die, jene
thou = du, Sie, du, ihr
though = obgleich, obschon, wenn auch, zwar
thought = Gedanke
thoughtfulness = Vorsorge
thousand = tausend
Thrace = Thrakien, Thrazien
Thracia = Thrakien, Thrazien
thrash = verhauen
thread = Faden, Garn, Senkel, Zwirn
threat = Bedrohung, Drohung
threaten = bevorstehen, dräuhen, drohen, bedrohen
three = drei
thresh = dreschen
threshold = Schwelle
thrifty = sparsam
throat = Gurgel, Kehle
throne = Thron
through = völlig, durch, kraft, mit, mittelst, vermittels, bereit, erbötig, fertig, anläßlich, halber, um ... willen, wegen, hindurch, quer mitten
throw = schleudern, werfen
throw away = fortwerfen, wegwerfen
throw-back = Ahnenähnlichkeit, Atavismus
throw up = sich brechen, sich erbrechen, sich übergeben
thrush = Drossel
thrust = dringen, rücken, stoßen, treiben
thrust down = abstoßen
thumb = Daumen
thunder = donnern, Donner
Thuringia = Thüringen
Thursday = Donnerstag
thus = folglich, auf die Weise, so
thwart = erschweren
tibia = Schienbein
tic = Zwillich
tic douloureux = Gesichtsreißen
ticket = Billett, Fahrkarte, Karte
ticket-window = Schalter, Schalterfenster, Schiebefenster
tickle = kitzeln
tide = Ebbe und Flut
tidy = geordnet, Ordnungs-
tie = anschließen, Halsbinde, Krawatte, Schlips, Binde, Verband, binden, verbinden, Band
tie on = anschließen
tie up = binden, verbinden
tiger = Tiger
tightly = angestrengt
tile = Fliese, Kachel
till = Geldkasten, Kasse, bis
tillage = Ackerbau
tilt = neigen, hinneigen
timber = Holz
timbrel = Tamburin
time = Mal, Stunde, Uhr, Zeit
time off = Ferien
time to consider = Bedenkzeit
timid = bang, zaghaft
tin = Blech, Zinn
tinder = Zunder
tinkle = klimpern, klirren
tin-opener = Büchsenöffner
tin plate = Blech
tint = Abstufung, Nuance, Schattierung, Ton, färben, Farbe, Tinktur
tiny = winzig
tip = Kulm, Spitze, Stift, Zacke, Zinke, Zipfel, Trinkgeld
tipsy = angeheitert
tire = Reifen
tired = matt, müde
tiresome = überdrüssig, verdrießlich
Titan = Titan
title = betiteln, titulieren, Titel
titmouse = Meise
to = an, in, nach, zu
toad = Kröte
toast = braten, rösten, Trinkspruch, Toast
today = heute
toe = Zehe
toga = Toga
together = aneinander, beisammen, gesamt, insgesamt, zugleich, zusammen
together with = zuzüglich, außerdem
to her = ihr
to him = ihm
toilet = Abort, Abtritt, Toilette
toilet-paper = Toilettenpapier
to it = ihm
token = Ausweis, Beweis, Beleg, Signal, Abzeichen, Anzeichen, Kennzeichen, Merkzeichen, Wink, Zeichen
tolerate = dulden
tolling = Geläut
tomato = Tomate
tomb = Grab, Gruft
to me = mir, mir
tomorrow = morgen
Tom Thumb = Däumling
tone = Ton
tongs = Griff, Henkel, Zange
tongue = Zunge, Sprache
too = auch, ebenfalls, gleichfalls, zu, zu sehr, zu viel
tool = Mittel, Werkzeug
too much = zu, zu sehr, zu viel
tooth = Zacken, Zahn, Zinke
toothache = Zahnschmerz, Zahnschmerzen, Zahnweh
tooth-brush = Zahnbürste
tooth-paste = Zahnpasta, Zahnpaste
top = kappen, Fläche, First, Gipfel, Wipfel
topaz = Topas
topgallant mast = Brasse, Brassen
topic = Thema
topical = aktuell, gegenwärtig
top of the head = Scheitel
torch = Fackel
torment = martern, peinigen, quälen, Marter, Pein, Qual
torpedo = Torpedo
torrent = Strom
tortoise = Schildkröte
to some extent = ein bißchen, ein wenig, etwas, ziemlich
to some place = irgendwohin
total abstainer = Abstinenzler
total abstinence = Abstinenz, Enthaltsamkeit
to the = am
to thee = dir, dir, euch, Ihnen
to the letter = buchstäblich
to them = ihnen
touch = rühren, anrühren, berühren, tangieren, Berührung
touching = ergreifend
touch lightly = leicht berühren, streifen
touch upon = streifen
tourism = Reisesport
tourist = Tourist
tourist agency = Reisebüro
tournament = Turnier
to us = uns
tousle = herumzausen
tow = schleppen, nachschleppen
toward = an, in, nach, zu, betreffs, bezüglich
towards = an, in, nach, zu, betreffs, bezüglich, um, um ... herum
towel = Handtuch
tower = Turm, Zwinger
towing-line = Schlepptau
town = Ort, Stadt
town-hall = Rathaus
town hall = Rathaus
toy = Spielzeug
to you = dir, Ihnen, dir, euch, Ihnen, dir, euch, Ihnen
trade = handeln, Handel treiben, Handel, Beruf, Gewerbe, Handwerk, Geschäfte betreiben, Geschäfte machen, verhandeln, Geschäft, Unterhandlung
trade-union = Innung, Körperschaft, Korporation, Zunft, Syndikat
trading = Unterhandlung
tradition = Tradition, Überlieferung
traffic = Zirkulation
traffic rules = Verkehrsvorschriften
tragedy = tragisch, Tragödie, Trauerspiel
trail = Geleise
trailer = Anhänger
train = abrichten, bändigen, dressieren, Bahnzug, Eisenbahnzug, Zug
trait = Gesichtszug, Zug
trajectory = Flugbahn
tram = Straßenbahn
tranquil = gelassen, gemütlich, ruhig, still
transact money = einen Umsatz erzielen, umsetzen
transfer = entern, übergeben, übertreten
transform = umändern, umbilden, umgestalten, umwandern
transformation = Umänderung, Verwandlung, Umänderung, Metamorphose, Abwechslung, Änderung, Tausch, Veränderung, Wechsel
transgress = sündigen, sich versündigen
transgression = Sünde
transitive = transitiv, übergehend
translate = übersetzen, übertragen
translation = Übersetzung, Übertragung
transmit = schicken, senden, einsenden
transport = befördern, übertragen, Transport
trap = Falle
travel = fahren, reisen
travel agency = Reisebüro
traveller = Reisende
travesty = Travestie
tray = Präsentierbrett, Präsentierteller, Tablett
treacherous = heimtückisch, hinterlistig, treulos, wortbrüchig
treachery = Treubruch, Verrat
tread = schreiten, treten, besteigen
treasure = Schatz, Tresor
treat = heilen, kurieren, bewirten, regalieren, Bewirtung, Speisung, behandeln, traktieren, unterhandeln
treatment = Manipulation, Behandlung, Unterhandlung, Verhandlung
treat to = traktieren mit
treaty = Abhandlung, Traktat
tree = Baum
trefoil = Klee
tremble = beben, zittern, zucken
trench = Graben, Laufgraben
tressle = Arbeitsbock, Bank, Gestell, Staffel, Staffelei, Werkstuhl
trial = Essay
triangle = Dreieck
tribe = Abkunft, Geschlecht, Gezücht, Sippe, Stamm
tribunal = Tribunal
tribute = Tribut
trick = Ausflucht, narren, mystifizieren, zum besten halten, List, Tücke
trickery = Ausflucht
tricycle = Dreirad
trifle = Bagatelle, Kleinigkeit
trifling = unbedeutend
trigger = Hahn, <Hahn (an der Schußwaffe)>
trigonometry = Trigonometrie
trill = trillern, Triller
trillion = Trillion
trim = besetzen, einfassen, garnieren, verzieren
trimming = Borte, Posament, Tresse
Trinity = Dreieinigkeit, Dreifaltigkeit, Trinität
trip = Reise, Tour
trite = abgedroschen, banal, fade
triumph = Triumph
trombone = Posaune
troop = Truppe
tropical = tropisch
tropics = Tropikus, Wendekreis
trot = traben, trotten
trouble = Schwierigkeit, Problem, beengen, behindern, belästigen, genieren, lästig werden, stören
trough = Mulde, Trog
troupe = Truppe
trousers = Beinkleid, Hose
trout = Forelle
truck = Lastauto, Lastkraftwagen, LKW
true = im Recht, rechthabend, authentisch, echt, recht, urkundlich, wahr, wahrhaft
truly = tatsächlich, fürwahr, wahrhaftig, wahrlich, wirklich
trump = Atout, Trumpf
trumpet = trompeten, Trompete
truncate = kappen
trunk = Koffer, Rüssel, Torso, Stamm, Baumstamm, Strunk
trust = rechnen, sich verlassen auf, vertrauen, Zuversicht, betrauen mit, vertrauen mit, Vertrauen setzen in, zutrauen
trustworthy = vertrauenswert, zuverlässig
truth = Wahrheit
try = sich abmühen, sich anstrengen, sich bemühen, sich Mühe geben, erproben, probieren, prüfen, versuchen
tub = Bottich, Bütte, Wanne, Zober, Zuber
tube = Rohr, Röhre, Schlauch, Ventil
tuberculosis = Schwindsucht, Phtisis, Tuberkulose
Tuesday = Dienstag
tuft = Büschel
tug = anziehen, reißen, zerren, ziehen, verziehen, Schlepper
tugboat = Schlepper
tulip = Tulpe
tumble down = entfallen, verfallen
tummy = Bauch, Unterleib
tummy ache = Bauchweh
tumult = Aufruhr, Aufstand, Getümmel, Krawall, Tumult
tuna = Thunfisch
tuna-fish = Thunfisch
tune = adaptieren, anpassen, stimmen, Melodie, Weise
tungsten = Wolfram
tunic = Tunika
tunnel = Tunnel
tunny = Thunfisch
tup = Widder
Turk = Türke
turkey = Truthahn
Turkish = türkisch
turn = abschweifen, abweichen, kappen, umstoßen, umstürzen, umwerfen, drechseln, drehen, kehren, umdrehen, umwälzen, wenden, umwenden, Wende, Wendung, Kette, Reihe, Reihenfolge, Tour
turn around = drehen, kehren, umdrehen, umwälzen, wenden, umwenden
turn away = ableiten, abwenden, entwenden, abschicken, entsenden, fortschicken, wegschicken
turnip = Kohlrübe, Rübe
turn off = abstellen
turn on = anstellen
turnover = Umsatz
turn over = umstoßen, umstürzen, umwerfen, einstürzen, kappen, umfallen
turn round = drehen, kehren, umdrehen, umwälzen, wenden, umwenden
turtle-dove = Turteltaube
tutor = erziehen, Erziehung leiten, Gouverneur
TV set = Fernsehapparat, Fernsehgerät
Twelfth-night = Dreikönigsfest
twelve = zwölf
twenty = zwanzig
twenty-one = einundzwanzig
twich = Zwillich
twilight = Dämmerung
twill = Köper
twine = flechten, schlingen, winden
twins = Zwilling
twist = sich schlängeln, drehen, ringen, winden
twitter = piepen, zwitschern
two = zwei
two-footed = zweibeinig
type = tippen, Typus
typeset = setzen
typewriter = Schreibmaschine
typhus = Typhus
typical = typisch
tyrannize = tyrannisieren
tyranny = Tyrannei
tyrant = Tyrann, Wüterich
tyre = Pneumatik, Reifen