#setName = longlist_en_it
#sideOneTitle = ENG
#sideTwoTitle = ITA
a = a, dentro
abacus = abaco
abandon = abbandonare
abandonment = cessione
abashed = timido
abate = diminuire
abbess = badessa
abbey = badia
abbot = abate
abbreviate = abbreviare, accorciare
abbreviation = abbreviazione
ABC = alfabeto
abdication = abdicazione
abdomen = ventre
aberration = errore, sbaglio
abet = aiutare, assistere, incitare, spronare, poggiare, appoggiare, sostenere
abhor = detestare
abhorrence = orrore, ribrezzo
abhorrent = orrendo, orribile
abide = aspettare
abiding = continuo, durevole, permanente
ability = abilità, capacità
abject = miserabile, misero, povero
abjure = annullare
ablaze = ardente
able = abile, adatto, capace, idoneo
abnormal = anormale
abode = residenza, alloggio, appartamento
abolish = abolire, abrogare annullare
abolition = abolizione, abrogazione
abominable = orrendo, orribile
abominate = detestare
abomination = orrore, ribrezzo
abort = abortire
abortion = aborto
about = concernere, circa, verso, intorno a
about-face = cambiamento
above = sopra, di sopra
above all = principalmente, soprattutto
above-board = onesto, sincero
abrasive = acuto, affilato, aguzzo, appuntito, aspro, piccante, tagliente
abridge = limitare, restringere
abridgement = sommario
abroad = all'estero, fuori
abrogate = abolire, abrogare, annullare
abrogation = abolizione, abrogazione
abrupt = ripido, subitaneo
abscess = ascesso
abscond = fuggire
absence = assenza, mancanza
absent = assente
absent onself = andarsene, partire
absolute = completo
absolutely = davvero, infatti
absolute ruler = autocrate
absorb = assorbire, disporre
abstract = astratto, concludere, dedurre, ritirare, sommario
abstraction = furto
abstruse = misterioso
absurd = assurdo
abundance = abbondanza, affluenza, ricchezza
abuse = insultare, offendere
abysmal = terribile
abyss = abisso, burrone
Abyssinia = Abissinia, Etiopia
Abyssinian = abissino
academic = studente
academy = accademia
academy of music = conservatorio
accede = concordare, esserer d'accordo
accelerate = accelerare
accelerator = acceleratore
accelerator pedal = acceleratore
accent = accentare, accento
accentuate = accentare
accept = accettare, accogliere
acceptable = accettabile
acceptance = accoglienza, accoglimento
access = assalto, attacco
accession = guadagno
accidence = caso
accident = accidente, disgrazia, incidente
acclaim = acclamare, applaudire, battere le mani, applausi, approvazione
acclamation = applausi
accommodate = adattare, aggiustare
accommodating = servizievole
accommodation = aggiustamento, accomodamento, accordo, patto, compromesso, alloggio, appartamento
accomodate = finire, terminare, aiutare
accompany = accompagnare
accomplish = arrivare, compiere, eseguire
accord = accordo, accomodamento, accordo, patto, permettere
accordance = accordo
accordion = fisarmonica
account = spiegazione, fattura, considerare, conto, credere, pareggiamento dei conti
accountable = responsabile
accountant = perito contabile
account for = spiegare
accounting = contabilità
accredit = credere
accretion = crescimento
accrue = discendere, crescere
accumulation = accumulazione, folla
accumulator = accumulatore
accurate = esatto, preciso
accusal = accusa, imputazione, incriminazione
accusation = accusa, imputazione, incriminazione, denuncia
accuse = accusare, caricare, denunciare
accused = accusato, imputato
accuser = accusatore
accustom = solere
accustomed = consueto, usuale
accustom oneself = abituarsi, avvezzarsi
ace = asso
acerbic = acuto, affilato, aguzzo, appuntito, aspro, piccante, tagliente, amaro
acetous = acido, agro
ache = far male, dolore
Acheron = Acheronte
achieve = arrivare, commettere, fare, compiere, eseguire
achievement = azione, successo
Achilles = Achille
Achilles' heel = tallone d'Achille
Achilles' tendon = tendine d'Achille
acid = acido, agro, acuto, affilato, aguzzo, appuntito, aspro, piccante, tagliente
acknowledge = confessare, confermare
acknowledgement = confessione, ricevuta
acolyte = membro
acorn = ghianda
acquaint = informare, insegnare
acquaintance = conoscenza
acquire = comperare, comprare
acquisition = guadagno, acquisto, compra
acquisitive = avido, bramoso
acquittal = pagamento
acrid = acuto, affilato, aguzzo, appuntito, aspro, piccante, tagliente
acrimonious = acuto, affilato, aguzzo, appuntito, aspro, piccante, tagliente
across = attraverso
across from = contro
act = agire, azione, atto, azione, documento, commettere, fare, presentare
act for = rappresentare
action = azione, battaglia, processo
activate = causare
active = attivo, operoso, attivo, laborioso
activity = occupazione
act of grace = amnistia
actor = attore
actress = attrice
actual = reale
actually = di fatto
actuate = muovere
acuity = attenzione
acute = acuto, affilato, aguzzo, appuntito, aspro, piccante, tagliente
ad = annuncio, avviso, inserzione
Adam = Adamo
Adam's apple = pomo d'Adamo
adapt = adattare, aggiustare
add = aggiungere
adder = vipera
addled = ignorante, sciocco, stupido
address = indirizzare, indirizzo
address list = indirizzario
adherents = partito, seguito
adieu = addio
adjacent = vicino
adjectival = aggettivo
adjective = aggettivo
adjust = adattare, aggiustare
adjustable wrench = chiave
adjustment = accomodamento
adjutant = aiutante
administer = amministrare, dirigere
administer the last sacraments = amministrare gli ultimi sacramenti
administration = amministrazione, direzione, gestione, governo
admirable = ammirabile
admiral = ammiraglio
admiration = ammirazione
admire = ammirare
admission = accoglienza, accoglimento, confessione
admit = confessare, permettere
admixture = mistura
admonition = ammonimento, esortazione
ado = rumore
Adonis = Adone
adopt = adottare
adopted = adottivo
adore = adorare, venerare
adorn = decorare
Adriatic = Mar Adriatico
Adriatic Sea = Mar Adriatico
adroit = abile, destro, lesto, sveglio
adult = adulto
adulterer = adultero
adulterous = adultero
adultery = adulterio
advance = avvicinarsi
advancement = progresso
advantage = beneficio, guadagno, profitto, vantaggio
advantageous = utile
adventure = avventura
adverb = avverbio
adversary = nemico
adverse = nocivo
advert = aspettare, attendere
advertence = attenzione
advertency = attenzione
advertise = annunciare, annunziare, pubblicare
advertisement = annuncio, avviso, inserzione
advice = avviso, consiglio, annunzio, comunicato
advise = consigliare, raccomandare
advise against = sconsigliare
advocate = avvocato
Aeolus = Eolo
aerate = aerare, arieggiare, ventilare
aerial = antenna
aeronautics = aviazione
aeroplane = aereo, aeroplano
affable = amichevole, benevole, carino, cortese, gradevole, grazioso
affair = affare, faccenda, caso
affectation = affettazione, posa
affection = amore, affetto, affezione
affiliation = parentado, parentela
affined = congiunto, parento
affinity = parentado, parentela
affirm = assicurare, affermare
affirmation = promessa
affix = fissare
affluence = ricchezza
affluent = ricco
afford = permettere, produrre
Afghan = afgano
Afghanistan = Afghanistan
afire = ardente
aflame = ardente
afraid = angoscioso, pauroso, inquieto
afresh = ancora, di nuovo
Africa = Africa
African = africano
after = dietro, dopo
afternoon = pomeriggio
afterwards = dietro, dopo
again = ancora, di nuovo
against = contro
age = età
agency = agenzia
agent = agente, arnese, strumento
aggrandize = ingrandire
aggravating = indecente, scandaloso
aggression = assalto, attacco
aggressive = aggressivo
aggressor = aggressore, assalitore
agile = agile, snello
agitation = agitazione
aglow = ardente.. ago = ... fa
agog = curioso
agonize = torturare
agonizing = orrendo, orribile
agony = agonia, angoscia
agrarian = agricoltore, colono, contadino
agree = convenire, pattuire, concordare, esserer d'accordo
agreeable = gradevole, piacevole
agreeably = piacevolmente
agreement = accordo, accomodamento, patto
agriculture = agricoltura
ague = febbre
ahead = davanti, avanti
aid = assistente, aiutare, assistere, aiuto, assistenza
aide-de-camp = aiutante
ailment = malattia
aim = proposito, scopo
air = aria
air out = aerare, arieggiare, ventilare
airplane = aereo, aeroplano
airport = aeroporto
airy-fairy = cattivo
Aix-la-Chapelle = Aquisgrana
Ajax = Aiace
akin = congiunto, parento
alacrity = entusiasmo
alarm = allarme, sveglia
alarmclock = sveglia
Alaska = Alasca
Albania = Albania
Albanian = albanese
album = album
alcohol = alcool
alcoholic = alcoolico
alcove = alcova
alder = ontano
ale = birra
Alexander = Alessandro
Alexandria = Alessandria d'Egitto
Algeria = Algeria
Algerian = algerino
Algiers = Algeri
alien = orrendo, orribile, straniera
alike = simile
all = tutto
all about = dappertutto
alley = vicolo
All Hallows = Ognissanti
all-knowing = onnisciente
all of a sudden = ad un tratto, improvvisamente
all over again = ancora, di nuovo
allow = permettere
all-powerful = onnipotente
All Saints' Day = Ognissanti
all sorts = di ogni genere, ogni sorta di
all sorts of = di ogni genere, ogni sorta di
All Souls' Day = il giorno dei Morti
all the = ogni, ognuno, tutto
allude = alludere
almighty = onnipotente
almond = mandorla
almost = quasi
alms = elemosina
alone = solo, non ... che, solamente, soltanto, unicamente
alongside = accanto
a long time = a lungo, da molto, per molto tempo
a lot of = molto
alphabet = alfabeto, alfabet
Alps = Alpi
already = già
Alsace = Alsazia
Alsace-Lorraine = Alsazia-Lorena
Alsatian = alsaziano
also = anche
altar = altare
alteration = cambiamento
alternative = alternativa
although = benche, sebbene
altitude = altitudine
altogether = tutto
alum = allume
always = sempre
amateur = dilettante
amaze = sbalordire
Amazon = Rio delle Amazzoni, amazzone
ambassador = ambasciatore
amber = ambra gialla
ambiguous = ambiguo, equivoco
ambition = ambizione
ambulance = ambulanza
America = America
American = americano
American Indian = indiano, indiano americano
amnesty = amnistia
amortize = ammortizzare
amount = numero, importo, somma
amount to = ammontare a
amputate = amputare
amuse = divertire
amusement = divertimento
amusing = divertente
anaemia = anemia
analyse = analizzare
analyst = analizzatore
analytical chemist = analizzatore
anarchy = anarchia
anathema = anatema, scomunica
Anatolia = Anatolia
anchor = ancora
anchovy = acciuga, alice
ancient = antico
Andalusia = Andalusia
Andalusian = andaluso
Andes = Ande
Andorra = Andorra
Andorrian = andorrano
and so on = eccetera
anemone = anemone
anew = ancora, di nuovo
angel = angelo
anger = collera
angle = angolo
Angola = Angola
Angolan = angolano
Angolese = angolano
angry = irato
anguish = angoscia
animal = animale, bestia
animate = animare
ankle = caviglia
annexation = annessione
anniversary = compleanno
annotation = annotazione, nota
announce = annunciare, annunziare, pubblicare
announcement = annunzio, comunicato
annual = annuale
annul = annullare
Annunciation = Annunciazone
another = altro
answer = replicare, rispondere, rispondere a, risposta
ant = formica
Antarctic = Antartico, Antartide, Polo Sud
Antarctic Ocean = Oceano Antartico
antenna = antenna
anthology = antologia
anthracite = antracite
antibiotic = antibiotico
anticipate = anticipare
antifreeze = anticongelante
Antilles = Antille
Antillian = delle Antille, uomo delle Antille
antique = antico
antiseptic = antisettico
Antwerp = Anversa
anvil = incudine
anxiety = ansia, ansietà
anywhere = in qualche luogo
apart = separato
apart from = eccetto, salvo
apartment = appartamento
apathy = apatia
ape = scimmia
Apennines = Appennini
apiarist = apicoltore, apicultore
apologize = scusarsi
apology = scusa
apoplectic fit = apoplessia
apostle = apostolo
apparatus = apparecchio
apparently = evidentemente
appeal = domanda, preghiera
appear = apparire, parere
appearance = apparenza, aria, aspetto
appear to be = parere
appease = calmare, placare
appellation = nome
appetite = appetito
applaud = acclamare, applaudire, battere le mani
apple = mela
apple-tree = melo
applicant = petente, postulante, supplicante
apply = applicare
appoint = nominare
appointment = nomina, appuntamento
appointment to office = nomina
appraise = apprezzare, stimare, valutare
appreciate = apprezzare
apprehension = arresto
approach = accesso
appropriate = conveniente
approval = applausi, approvazione
approve = approvare
approximately = circa, verso
apricot = albicocca
April = aprile
aptitude = ingegno, talento
Apulia = Puglia
Arab = arabo
Arabia = Arabia
Arabian = arabo
Arabian Sea = Mare Arabico
Arabic = arabo
arbiter = arbitro
arbitrary = arbitrario
arbitrator = arbitro
arbor = albero
arc = arco
Arcadia = Arcadia
archbishop = arcivescovo
archduke = arciduca
Archimedes = Archimede
architect = architetto
archive = archivio
archivist = archivista
Arctic = Artico
Ardennes = Ardenne
ardent = ardente
are = gruppo
arena = arena
Argentina = Argentina
Argentine = argentino
argument = argomento
aria = aria
arise = salire, nascere
aristocratic = aristocratico
Aristotle = Aristotele
arm = armare, bracchio
armchair = poltrona
Armenia = Armenia
Armenian = armeno
armoury = arsenale
army = esercito
army chaplain = cappellano militare
aroma = aroma
around = intorno a
arrange = predisporre, sistemare
arrangement = accomodamento
arrest = arrestare, arresto
arrested person = arrestato, detenuto, prigioniero
arrival = arrivo, venuta
arrive = arrivare
arsenal = arsenale
art = arte
artery = arteria
artichoke = carciofo
article = merce, prodotto, articolo, cosa, ogetto
article of clothing = abito
artillery = artiglieria
as = quando, come, così, considerato che, visto che
as a matter of fact = di fatto
asbestos = amianto
ascend = salire
Ascension Day = Ascensione
ascertain = constatare
as for the rest = d'altronde, inoltre
ash = cenere, frassino
ashtray = portacenere
Ash Wednesday = Ceneri, Mercoledì delle Ceneri
Asia = Asia
Asia Minor = Anatolia, Asia Minore
Asian = asiatico
Asiatic = asiatico
as if = come se
ask = domandare, chiedere
ask for = chiedere
asparagus = asparago
aspect = apparenza, aria, aspetto
asphalt = asfalto
ass = asino, ciuco
assailant = aggressore, assalitore
assault = attaccare, aggredire, assalire, attentato
assemblage = convegno
assembly = accumulazione
assent = affermare
assert = asserire, sostenere
assertion = asserzione
assets = attivo
assigned job = compito
Assisi = Assisi
assist = aiutare, assistere
assistant = assistente
associate = unirsi
assure = assicurare
Assyria = Assiria
Assyrian = assiro
asthma = asma
as though = come se
asylum = asilo, ricovero
at = a, su
at first = all'inizio, dapprima, dapprincipio
Athena = Atene
Athene = Atene
Athenian = ateniese
Athens = Atene
at home = a casa, in casa
Atlantic = Atlantico
Atlantic Ocean = Atlantico
Atlantis = Atlantide
at last = alla fine, finalmente
at least = almeno, per lo meno
atmosphere = atmosfera
at most = tutt'al più
atom = atomo
atom bomb = bomba atomica
atomic energy = energia atomica
at once = direttamente, fra poco, immediatamente, subito
attach = affigere, fissare
attack = attaccare, assalto, attacco
attacker = aggressore, assalitore
attain = arrivare
attempt = provare
attend = curare, visitare
attendance = servizio
attention = attenzione
attentive = attento
at that place = là, laggiú, li
at the outset = all'inizio, dapprima, dapprincipio
at the right time = in tempo
at the same time = allo stesso tempo
attitudinize = posare
attract = attrarre
attraction = forza attrativa
attractive = allettante, attraente, seducente
attune = adattare, aggiustare
aubergine = melanzana
audience = udienza, uditorio
audit = controllare, verificare
auditory = uditorio
augment = ingrandire
August = agosto
aunt = zia
aurora = alba, aurora
Australia = Australia
Australian = australiano
Austria = Austria
Austrian = austriaco
author = autore
authority = autorità
autobus = autobus
autocrat = autocrate
automobile = auto, automobile
automoton = automa
autumn = autunno
avail = essere utile, giovare, servire, utilizzare
available = disponibile
avaricious = avaro
average = medio, mezzo
aversion = avversione, ripugnanza
aviation = aviazione
avoid = evitare
await = aspettare
aware = cosciente
awareness = consapevolezza, coscienza
away = lontano
awful = orrendo, orribile
axe = ascia, scure
axiom = assioma
axis = assale, asse, perno
axle = assale, asse, perno
Azerbaijan = Azerbaigian
Azores = Azzorre
babysitter = bambinaia
Bacchus = Bacco
back = dorso
backbiting = maldicenza
back-door = porta di dietro
background = fondo, sfondo
backside = sedere
back street = quartiere popolare, rione popolare
backward = a rovescio, supino, indietro, deficiente
backwards = indietro, a rovescio, indietro, all'indietro, supino
bacon = lardo
bacterium = batterio
bad = cattivo
badger = tasso
badly = male
bag = borsa
bagasse = bagassa
baggage = bagaglio
bairn = bambino, fanciullo
bait = esca
baize = tessuto di lana
bake = cuocere
baker = fornaio
bakery = panetteria
balance sheet = bilancio
balcony = balcone, terrazzo
bale = balla
baleen = osso di balena
Balkans = Balcani
ball = ballo, globo, palla, sfera
ballad = ballata
ballade = ballata
ballast = zavorra
ball-bearing = globo
ballet = balletto
ballet dancer = ballerino
balloon = pallone
ballpoint pen = penna a sfera
Baltic Sea = Baltico
balustrade = parapetto
bamboo = bambù
ban = anatema, scomunica
banana = banana
bandit = bandito, brigante
banisters = parapetto
bank = banca
bank account = conto bancario
bank clerk = banchiere
banker = banchiere
banking account = conto bancario
banknote = banconota
bank-note = banconota
bank note = banconota
bank official = banchiere
bankrupt = bancarotta, fallimento
bankruptcy = fallimento
banner = bandiera
baptism = battesimo
baptismal font = fonte battesimale
baptize = battezzare
bar = sbarrare, eccetto, salvo, impedire, bar
barbarian = barbaro
barbaric = barbaro
barber = barbiere, parrucchiere
bare = nudo
barely = appena
bargain = mercanteggiare
barge = chiatta
bark = corteccia
barley = orzo
barn = baracca, granaio
barometer = barometro
baron = barone
barrack = baracca
barracks = caserma
barrel = barile, condotto
barren = sterile
barrier = barriera
barring = eccetto, salvo
barrister = avvocato
barrister-at-law = avvocato
base = basare, fondare, base
Basel = Basilea
basin = bacino
basis = base
basket = cesto
Basle = Basilea
bass = pesce persico
bast = corteccia, scorza
bastard = bastardo
bastion = baluardo, bastione
bath = vasca da bagno, bagno
bathe = bagnare, bagnarsi
bathing-suit = costume da bagno
bathing suit = costume da bagno
bathroom = stabilimento balneare, sala da bagno, stanza da bagno
battalion = battaglione
battery = accumulatore, batteria
battle = battaglia
bay = baia
bayonet = baionetta
bazaar = bazar
be able to = potere
beach = spiaggia
beacon = boa, gavitello
be acquainted with = conoscere
be afraid of = aver timore, temere
beak = becco
be alive = vivere
beam = sciopero, trave
bean = fava
bear = produrre, orso
beard = barba
be ashamed = vergognarsi
be asleep = dormire
beast = animale, bestia
beat = battere
be at loggerheads = combattere, duellare, picchiarsi
beautiful = bello, carino
beauty = bellezza
be bold = osare
be born = nascere
be called = chiamarsi
because = considerato che, visto che
become accustomed = acclimarsi, ambientarsi
becoming = conveniente
bed = letto
bed-clothes = biancheria da letto
bedding = biancheria da letto
be dependent on = dipendere da
be detained = resti dietro
bedridden = costretto a letto
bedroom = camera da letto
bee = ape
beech = faggio
beef = manzo
beefsteak = bistecca
beehive = alveare, arnia
bee-keeper = apicoltore, apicultore
bee-keeping = apicoltura, apicultura
bee-master = apicoltore, apicultore
beer = birra
beet = barbabietola
befit = convenire
be fitting = convenire
be found = trovarsi
beg = mendicare, chiedere
beggar = mendicante
begin = cominciare
beginning = inizio, principio
behave = comportarsi, condursi
behavior = condotta
behaviour = condotta
behind = dietro, dopo, di dietro, in fondo
behind one's back = di nascosto
be hungry = avere fame
be in the habit of = solere
be kept in = resti dietro
Belgian = belga
Belgium = Belgio
believe = credere
bell = campana
belly = ventre
be located = trovarsi
belong to = appartenere
below = sotto, dabbasso, giú
belt = cintura
be married = maritarsi, ammogliarsi, sposare
bench = panka
bend = curvarsi, curva
beneath = sotto
benefit = beneficio, guadagno, profitto, vantaggio
bent = curvo
be painful = far male
be quiet = tacere
beret = beretta
Berlin = Berlino
berry = bacca
beside = accanto, a, su
besides = d'altronde, inoltre
besiege = assediare
be similar = rassomiglare
be sorry about = rincrescere
best = migliore
be succesful = prosperare
bet = scommettere
be taken ill = ammalarsi
better = migliore
beverage = bevanda, bibita
bevy = gruppo
be willing to = volere
be worth = valere
be worthy of = meritare
beyond = dopo, in seguito, poi, attraverso
bicuit = biscotto
bicycle = bicicletta
bid = offrire, chiedere
big = grande
bike = bicicletta
bile = bile
bill = becco, biglietto, fattura
billiards = biliardo
bill of exchange = cambiale
bind = rilegare, legare
binding = legatura
birch = betulla
bird = uccello
birth = nascita
birthday = compleanno
biscuit = biscotto
bishop = vescovo
bit = pezzo
bite = mordere
bitter = amaro
black = nero
blackbird = merlo
black radish = ravanello
bladder = vescica
blame = riprendere
blameworthy = biasimevole
blank = bianco
blanket = coperta
blaspheme = bestemmiare
bleak = sgradevole, spiacevole, afflitto, triste, buio, scuro, freddo
bleat = belare
bleed = sanguinare
bleeding = salasso
blind = cieco
blindness = cecita
blister = bolla
block = bloccare, blocco
blockade = bloccare
blond = biondo
blood = sangue
blood-letting = salasso
blood-relationship = parentado, parentela
bloom = fiore
blotter = carta asciugante, carta assorbente
blotting paper = carta asciugante, carta assorbente
blouse = blusa
blow = colpo, soffiare
blue = azzurro, blu
blueberry = bacca di mirtillo
blunt = smussato, spuntato
blushing = rosso
boarding house = pensione
boarding school = pensione
boat = barca
body = corpo
boil = bollire, far bollire
boiler = calderotto
bold = grosso, spesso
bomb = bomba
bonbon = confetto
bon-bon = confetto
bond = legame
bone = osso
bonnet = cappotta
book = libro, ordinare
bookcase = libreria
book-keeper = contabile
book-keeping = contabilità
bookseller = librario
bookshop = libreria
bookstore = libreria
border = orlo
bore = succiello, annoiare
bosom = petto
boss = capo, maestro, padrone, principale
bother = disturbare
bottle = bottiglia
bottom = fondo
bough = ramo
boundary = confine, frontiera
boutique = negozio
bow = arco, prua
bowl = bacino
box = fare il pugilato, scatola, cassa, tinozza, vaso
boy = ragazzo, servire
bra = reggiseno
bracelet = braccialetto
brain = cervello
brake = frenare, freno
branch = ramo
brandy = cognac
brass = ottone
Brazil = Brasile
Brazilian = brasiliano
bread = pane
bread and butter = fetta di pane
break = rompere, spezzare, rompersi
break down = demolire
breakfast = colazione, prima colazione
break oneself of a habit = perdere l'abitunide di
bream = scardola
breast = petto
breath = alito
breathe = respirare
breed = razza
breeze = brezza
Bretagne = Bretagna
brew = far la birra
brick = mattone
bride = fidanzata, novella sposa, sposa
bridegroom = sposo
bridge = ponte, ponte di comando
brief = corto
bright = brillante
brilliant = brillante
brim = orlo
bring = portare
brinjal = melanzana
brink = orlo
Britain = Gran Bretagna
Brittany = Bretagna
broad = largo
broadcast = trasmettere
bronze = bronzo
broom = granata, scopa
brother = fratello
brother-in-law = cognato
brow = sopracciglio
brown = bruno, marrone
brush = spazzolare, spazzola
brutal = brusco, rude
bubble = vescica
bucket = secchia, secchio
budget = bilancio
buffalo = bufalo
buffet = bar
bug = insetto, origliare
build = costruire
building = edificio
bulb = ampolla, lampadina
bull = toro
bullet = palla
burden = caricare, carico
bureau = ufficio
Burma = Birmania
burn = ardere, accendere, bruciare
burn down = bruciare
burst = crepa, fessura, screpolatura
bury = seppellire
bus = autobus
bush = arbusto
business = affare, faccenda, commercio
business deal = affare, faccenda
businessman = commerciante
busk = osso di balena
busy = occupato
but = eccetto, salvo
butcher = macellaio
butcher's shop = macelleria
butter = burro
butterfly = farfalla
button = pulsante
buy = comperare, comprare, acquisto, compra
buyer = cliente, compratore
by = di, mediante, per mezzo di
by accident = a caso
by chance = a caso
bye = addio, arrivederci
by heart = a memoria
by marriage = per via di matrimonio, imparentato
by means of = mediante, per mezzo di
byname = soprannome
by no means = in nessun modo
by now = già
by the way = a proposito
cabbage = cavolo
cabin = capanna, cabina
cabinet = armadio
cable = cavo
cactus = cacto
Caesar = Cesare
Cain = Caino
Cairo = Cairo
cake = torta
calabash = zucca
calculate = calcolare
calf = vitello, polpaccio
call = chiamare
call on = visitare
calm = calmo, tranquillo, calmare, placare
Canada = Canadà
Canary Islands = Canarie
cancel = annullare un ordine, annullare
capable = abile, adatto, capace, idoneo
Cape Town = Città del Capo
capitulate = arrendersi
Capricorn = Capricorno
captain = capitano
capture = prendere
car = auto, automobile
card = carta
care = cura
care for = guarire
careful = cauto
careless = negligente, noncurante, sbadato
caress = accarezzare
carnation = garofano
carpet = tappeto
carriage = vagone, vettura
carrot = carota
carry = portare
Carthage = Cartagine
case = affare, faccenda, caso
cash = contante
casserole = casseruola
cast = calco
Castile = Castiglia
castle = castello, torre
cat = gatto
catalogue = catalogo
catch = prendere, colpire
catching = infettivo, contagioso
caterpillar = bruco
cathedral = catedrale, duomo
Cato = Catone
cauldron = calderotto
cauliflower = cavolfiore
cause = causare, causa
caution = avvertire
cautious = cauto
cease = cessare
cede = cedere
ceiling = soffitto
celebrate = celebrare
celebration = festa
celery = sedano
cello = violoncello
cemetery = camposanto, cimitero
censor = censura
censurable = biasimevole
censure = criticare, disapprovazione
cent = centesimo
centennial = secolo
centimetre = centimetro
centipede = millepiedi
central = centrale
centre = centro
century = secolo
Cerberus = Cerbero
certain = certo
certainly = certamente
certificate = atto, azione, documento, certificato attestato
chain = catena
chair = sedia
chalk = creta
challenge = contestare, disputare
chamber = camera
champagne = champagne
champion = campione
chance = caso
change = cambiamento, variazone, cambiare, cambiarsi, spicciole
channel = condotto
chaplain = cappellano militare
character = carattere, indole, natura, segno
characteristic = caratteristico
charge = spese, carico
charitable = misericordioso
charity = elemosina
charm = fascino, incanto
charming = affascinante, amabile, grazioso
chase = perseguire, perseguitare, cacciare
chasm = abisso, burrone
chat = pettegolezzo, chiacchierare
chatter = chiacchierare
chatterbox = chiacchierone
chauffeur = autista
cheap = a buon mercato
cheat = imbroglione, ingannare, truffare
check = controllare, verificare, assegno, assegno bancario
checker = controlore
check up on = controllare, verificare
cheek = guancia
cheerful = allegro
cheers = salute
cheese = formaggio
chef = capocuoco
chemist = farmacista, chimico
chemistry = chimica
chemist's shop = farmacia
cheque = assegno, assegno bancario
cherry = ciliegia
cherry-tree = ciliegio
chest = petto, torace
chestnut = castagna
chestnut-tree = castagno
chew = masticare
chicken = gallina, pollo
chief = capo
chiefly = principalmente, soprattutto
chief of police = commissario
child = bambino, fanciullo
Chile = Cile
chilly = freddo
chimney = fumaiuolo
chin = mento
China = Cina
Chinaman = cinese
Chinese = cinese
chisel = scalpello
chive = cipollina
chlorine = cloro
chocolate = cioccolata
choice = scelta
choke = soffocare
choose = eleggere, scegliere
chord = accordo
Christ = Cristo
christen = battezzare
christening = battesimo
Christian = cristiano
Christian name = nome di battetismo
Christmas = Natale
chuck = accarezzare
church = chiesa
church-building = chiesa
cider = sidro
cinder = cenere
cinema = cinema
circle = circolo, compagnia
circus = circo
citadel = cittadella
citation = citazione
cite = citare
city = città
civil = civile
civilian = civile
clap = applaudire, battere le mani
clarify = spiegare
claw = artiglio
clay = argilla
clean = puro, pulire
cleanliness = pulizia
cleanse = pulire
clear = distinto
clergyman = ecclesiastico, curato, prete, sacerdate
clever = abile, destro, lesto, sveglio
client = cliente, compratore
climate = aria, clima
climb = salire
cloakroom = guardaroba
clock = orologio
close = chiudere, prossimo, vicino
closed = chiuso
closet = armadio
clothe = vestire
cloud = nube, nuvola, nuvolo
club = compagnia
clutch = afferrare, frizione
coach = vagone, vettura
coal = carbone
coast = costa
cock = cazzo, gallo
cocoa = cacao
cod = merluzzo
code = codice
codfish = merluzzo
coffee = caffé
coffee-pot = caffettiera
coffin = cassa sa morto
cognac = cognac
coin = moneta
coition = coito
cold = freddo, raffreddore
colleague = collegio
collect = raccogliere
collection = gruppo
college = collega
colour = colore
comb = pettinare
come = discendere, venire
come about = accadere, arrivare, succedere
come across = incontrare
come back = rivenire
come close = avvicinarsi
come closer = avvicinarsi
comedy = commedia
come on = avvicinarsi
come to a halt = fermarsi
come together = unirsi
comfort = consolare
comfortable = comodo
comfortably = piacevolmente
comic = comico
comical = comico
command = comando, ordine
commander = comandante
commence = cominciare
commencement = inizio, principio
commend = lodare, raccomandare, vantare
commerce = commercio
committee = comitato
commodity = merce, prodotto
common = comune, volgare
commonplace = banale
commotion = agitazione, scandalo
communicate = annunciare, comunicare, infettare
communication = annunzio, comunicato
communist = comunista
company = compagnia
compare = confrontare
compartment = scompartimento
compass = bussola
compel = costringere, forzare
compensate = ricompensare
compensation = ricompensa
competition = concorrenza, concorso
complain = lagnarsi
complete = completo, completare, pieno
completed = finito, terminato
completely = completamente
complexion = carnagione
compliment = complimento
component = ingrediente
composer = compositore
comprise = contenere
computer = computer
concave = cavo
conceal = nascondere
conceited = vanitoso
concentrated = denso
concern = importanza, concernere, riguardare, cura
concerning = concernere
concert = concerto
concise = breve, conciso, succinto
conclusion = conclusione, risultato
concord = accordo
concrete = calcestruzzo
concurrence = accordo
condemn = condannare, biasimare, disapprovare
condemnable = biasimevole
condemnation = disapprovazione
conduct = condurre, guidare, condotta
conduct oneself = comportarsi, condursi
confectioner = pasticciere
conference = conferenza
confess = confessare
confession = confessione
confidence = fiducia
confine = limitare, restringere
confined to one's bed = costretto a letto
confirm = confermare
conflict = conflitto
confront = far fronte a, opporsi a
congratulate = felicitare
congress = congresso
connect = legare
connection = coincidenza, banda
conquer = conquistare
conscious = cosciente
consciousness = consapevolezza, coscienza
consecutively = successivamente
consent = concordare, esserer d'accordo, accordo
conservation = conservazione, preservazione
conserve = conservare
consider = considerare, guardare
considerable = considerevole, notevole, ragguardevole
consignee = destinario
console = consolare
constant = costante
construct = costruire
consul = console
consulate = consolato
consultation = consulto
contact = contatto
contagion = contagio
contagious = infettivo, contagioso
contain = contenere
container = cassa, tinozza, vaso
contamination = contagio
contempt = sprezzo
contented = contento
contention = asserzione
contents = contenuto
contest = concorso
continual = costante
continue = durare, continuare
contract = contratto
contradict = contraddire
contrast = contrasto
contribute = contribuire
contribution = contributo
contrite = pentito
control = dominare, governare
controller = controlore
convention = congresso
conversation = conversazione
conversion = cambiamento
convert = convertire
convince = convincere
convoke = convocare
cook = cuoca
cooked = cotto
cookie = biscotto
cool = raffreddare, fresco
cool down = raffreddare
coping = cresta
copper = rame
copy = copiare
cork = sughero
corkscrew = cavatappi
corn = callo, granturco
corner = angolo
corpulent = grosso, spesso
correct = corretto, correggere
correspond = avere la coincidenza
corridor = corridoio
corroborate = confermare
Corsica = Corsica
cost = costare, spese
costly = caro, costoso
costume = abito, costume
cough = tossire
counsel = avvocato, consigliare, raccomandare, avviso, consiglio
counsellor = consigliere
count = calcolare, contare
counter = banco
countermand = annullare un ordine
country = campagna, paese
countryside = campagna
coupé = scompartimento
couple = coniugi, consorti
coupon = cedola
courage = coraggio
course = piatto
court = cortile
courteous = cortese
courtyard = cortile
cousin = cugina, cugino
cover = legatura, coprire, coperta, percorrere
covered = coperto
cow = vacca
cowardice = codardia
crack = crepa, fessura, screpolatura
cradle = culla, luogo d'origine
crayfish = gambero
crazy = matto
cream = panna, crema, scremare
credit = avere, credito
crevice = crepa, fessura, screpolatura
crew = equipaggio
crime = delitto
crisis = crisi
criticism = critica
criticize = criticare
Croatia = Croazia
crockery = stoviglie
crocodile = coccodrillo
cross = irato, croce, attraversare
cross-cut Maryland = tabacco da fumo
crowd = affluenza, folla
crude = crudo
cruel = crudele
crumble = sgretolarsi
crumble away = sgretolarsi
crumble off = sgretolarsi
cry = grido, piangere
cry out = gridare
cultivate = coltivare
cup = tazza
cupboard = armadio
cure = guarire
currant = ribes
current = attuale, corrente, attuale
currently = oggigiorno
curse = bestemmiare
curtain = cortina
curve = curva
curved = curvo
cushion = cuscino
cuss = bestemmiare
custom = costume
customary = consueto, usuale
customer = cliente, compratore
customs = dogana
cut = tagliare
cutlet = costoletta
cycle = bicicletta
cylinder = cilindro
cypres = cipresso
Cyprus = Cipro
Czechoslovakia = Cecoslocacchia
dagger = pugnale
daily = giornaliero, quotidiano, ogni giorno, quotidianamente
daily paper = giornale
dainty = delicato
Dalmatia = Dalmazia
damage = avaria, danneggiare, danno, difetto
Damascus = Damasco
damp = umido
dance = ballo, ballare, danza
dancer = ballerina, ballerino
Dane = danese
danger = pericolo
dangerous = pericoloso
Danube = Danubio
dare = osare
dark = buio, scuro, oscuro, tenebroso
dark blue = blu scuro
darkness = oscurità, tenebre
darling = prediletto
data = materiale
date = dattero, datare, data, appuntamento
daughter = figlia, figliuola, figliola
dawn = alba, aurora
day = giorno
daybreak = alba
daylight = luce del giorno
dazed = confuso, turbato
dead = morto
deaden = ammortizzare
deadly = mortale
deaf = sordo
deaf and dumb = sordomuto
deal with = trattare
dear = caro, costoso
death = morte
death throes = agonia
debt = debito
decayed = decrepito
deceive = ingannare, truffare
deceiver = imbroglione
December = dicembre
decent = decente
decide = decidere
decimetre = decimetro
decision = decisione, decreto, deliberazione
decisive = decisivo
deck = coperta, ponte
declaration = dichiarazione
decline = declinare, deperire, peggiorare, regressione
decorate = decorare
decrease = diminuire
decree = decreto
decrepit = decrepito
deduce = concludere, dedurre
deem = credere, guardare
deep = fondo, profondo
defeat = disfatta
defence = difesa, retroguardia
defend = difendere
defendant = accusato, imputato
defense = difesa
define = definire
defining = definito, determinato, fissato
definite = definitivo
definitive = definitivo
degree = grado
delay = ritardo
delegate = delegato, deputato
deliberately = apposta
delicate = delicato
delivery = consegna
demand = smercio, vendita
democratic = democratico
demolish = demolire
demolition = demolizione
demonstration = manifestazione
Denmark = Danimarca
denounce = denunciare
dense = denso
dentist = dentista
deny = negare
depart = andarsene, partire
departure = partenza
depend = dipendere
dependent = dipendente
depend onldepend upon = dipendere da
deportment = condotta
depression = crisi
depth = profondità
deputy = delegato, deputato
derive = derivare, discendere
descend = scendere
describe = descrivere
descry = accorgersi, intravedere, scorgere
desert = deserto, abbandonare
deserve = meritare
design = disegnare, disegno, progetto
desirable = desiderabile
desire = desiderare, desiderio
desk = banco, scrivania
despise = disprezzare
despot = despota
dessert = dessert
destine = destinare
destroy = distruggere
detachment = brigata
detail = dettaglio, particolare
detain = ritenere
detention = arresto
deter = impaurire, spaventare
determine = definire, fissare
determining = definito, determinato, fissato
deterrent = spaventevole
develop = svilupparsi
device = apparecchio
devil = demonio, diavolo
devilish = diabolico
dew = rugiada
dexterous = abile, destro, lesto, sveglio
diabolical = diabolico
diagram = figura, progetto
dialect = dialetto
diamond = diamante
diarrhoea = diarrea
diary = diario
dictionary = dizionario
die = morire, cubo, dado
die away = morire
diet = dieta, regime
different = differente
differently = diversamente, in modo diverso
difficult = difficile, pesante
dilapidated = decrepito
dim = oscuro, scuro, tenebroso
dimension = dimensione
diminish = diminuire
diminutive = piccolo
din = rumore
dining-room = sala da pranzo
dinner = colazione
diploma = atto, azione, documento, diploma
diplomat = diplomatico
direct = condurre, guidare, destro
director = amministratore delegato, direttore
directory = catalogo
disapprobation = disapprovazione
disapproval = disapprovazione
disapprove = biasimare, disapprovare
disapprove of = biasimare, disapprovare
disciples = partito, seguito
discourage = impaurire, spaventare
discover = scoprire
discovery = scoperta
discrete = discreto
discuss = discutere
disease = malattia
disgust = avversione, ripugnanza
dish = piatto
dislike = avversione, ripugnanza
dismal = abominevole, banale, sgradevole, spiacevole, mostruoso, schifoso, afflitto, triste, buio, scuro, miserabile, misero, povero
dismount = scendere
dispose of = vendere
disposition = disposizione, ingegno, talento
dissolve = risolvere
dissuade from = sconsigliare
distance = distanza
distant = distante, lontano
distil = distillare
distinct = distinto
distinguish = distinguere
distribute = distribuire
district = circondario, distretto
disturb = disturbare
dive = tuffarsi
divide = separare, dividere
divorce = divorzio
do = commettere, fare
doctor = dottore, medico
document = atto, azione, documento
dog = cane
doll = bambola
dolphin = delfino
done = finito, terminato
donkey = asino, ciuco
door = porta, uscio
dose = dose
dot = punto
double = doppio
doubt = dubitare
doubtful = dubbioso
dough = pasta
dove = piccione
dowry = dote
dozen = dozzina
draft = cambiale
drag = tirare
dragon = drago, dragone
draw = attrarre, disegnare, eguaglianza, tirare
drawer = cassetto
drawers = mutande
drawing = disegno
dreadful = terribile
dream = sognare, sogno
dreary = abominevole, sgradevole, spiacevole, mostruoso, schifoso, afflitto, triste, buio, scuro
dress = abito, vestire, vestirsi
drink = bevanda, bibita, bere
drinkable = potabile
drip = goccia
driver = autista
droop = pendere
drop = goccia, diminuire
drown = annegarsi, annegare
drugstore = farmacia
drunk = brillo, ubriaco, ubriacone
dry = secco, seccare
dry-nurse = asciutta, balia
dual = doppio
Dublin = Dublino
duck = anitra
dull = smussato, spuntato
dumb = muto
duplicate = moltiplicare
during = durante
dusk = crepuscolo
dust = polvere
Dutchman = olandese
duty = dovere
dwarf = nano
dwell = abitare, dimorare, stare
dwelling = alloggio, appartamento
dwelling-place = residenza
dwelling-place-residence = residenza
dye = colore
dynamite = dinamite
each = ogni, ognuno, tutto
eager = avido, bramoso
eagle = aquila
ear = orecchio, spiga
early = di buon'ora
earmark = destinare
earn = guadagnare
earnest = serio
earth = terra
earthen = terrestre
earthenware = stoviglie
earthly = terrestre
earthquake = terremoto
east = est
Easter = Pasqua
easy = facile
eat = mangiare
eavesdrop = origliare
edge = orlo
edging = orlo
edible = commestibile, mangiabile
eel = anguilla
effect = risultato
effective = efficace
effectual = efficace
efficacious = efficace
egg = uovo
eggfruit = melanzana
eggplant = melanzana
Egypt = Egitto
eight = otto
eighteen = diciotto
eighth = ottavo
eighty = ottanta
elbow = gomito
elect = eleggere, scegliere
election = scelta
electricity = elettricità
electronic = elettronico
elegant = elegante
element = elemento, fondamento, ingrediente
elements = alfabeto
elephant = elefante
elevator = ascensore
eleven = undici
elm = olmo
Elsass = Alsazia
else = altro, diversamente, in modo diverso
elsewhere = altrove
embassy = ambasciata
embassy building = ambasciata
embrace = abbracciare
emerge = apparire
emergency = crisi
emmet = formica
empire = impero
employ = impiegare, usare
employee = impiegato
employment exchange = ufficio di collocamento
empty = vuoto, vuotare
encounter = incontrare, incontro
encouragement = incoraggiamento
end = finire, terminare, fine
ending = fine
endive = indivia
end up = arrivare
endure = durare, sopportare, tollerare
enemy = nemico
energetic = energico
engine = locomotiva, macchina, motore
engineer = ingegnere
England = Inghilterra
English = inglese
Englishman = inglese
enjoyable = gradevole, piacevole
enlarge = ingrandire
enlighten = illuminare
enormous = enorme
enough = sufficiente, abbastanza
enter = entrare
enterprise = impresa
entertaining = divertente
entertainment = divertimento
enthusiasm = entusiasmo
entire = completo, intero, totale, tutto
entirely = completamente
entomb = seppellire
entrance = entrata
entreaty = domanda, preghiera
envelope = busta
environment = ambiente
environs = ambiente
envy = invidiare, invidia
epic poem = epopea, poema epico
Epiphany = Befana, Epifania
equal = eguale
equality = eguaglianza
equator = equatore
equilibrium = equilibrio
erect = fondere
err = errare, sbagliarsi
errand = messaggio
error = errore, sbaglio
especially = principalmente, soprattutto
establish = fondere, constatare
estate = fattoria
esteem = rispettare, stimare, considerazione, stima, riguardo, rispetto, considerare
estimate = apprezzare, stimare, valutare
etc. = ecc.
et cetera = eccetera
etching = acquaforte
eternal = eterno
Ethiopia = Etiopia
ethos = atmosfera
etiquette = etichetta
Europa = Europa
Europe = Europa
European = europeo
European Union = Unione Europea
Eva = Eva
evade = evitare
even = piano, eguale, perfino, regolare
even if = anche se
evening = sera
evening meal = cena
evening paper = edizione della sera, giornale della sera
Evening Star = Venere
ever = sempre
every = ogni, ognuno, tutto
everybody = ogni, ognuno, tutto
everyday = volgare
every one = ogni, ognuno, tutto
everything = tutto
everywhere = dappertutto
evident = chiaro, evidente, palese
evolve = svilupparsi
exact = esatto, preciso
exactly = giustamente, giusto
exaggerate = esagerare
examination = esame
examine = esaminare
example = esempio
except = eccetto, salvo
except for = eccetto, salvo
excise = dazio consumo
excise-duty = dazio consumo
excite = incitare, spronare
exclude = escludere
exclusively = non ... che, soltanto
excommunication = anatema, scomunica
excuse me = le domando scusa, scusatemi, permesso
executioner = boia
exercise = esercizio
exercise-book = fascicolo
exert = praticare
exhausted = esausto, sfinito
exhibition = esposizione
exhortation = ammonimento, esortazione
exile = bandire, esiliare, esiliato, esule, esilio
exist = esistere
existence = esistenza
exit = uscita, uscire
expect = aspettare
expense = spese
expensive = caro, costoso
expertness = abilità, destrezza
expire = morire
explain = spiegare
explanation = spiegazione
exploit = sfruttare
exposition = esposizione
expression = aria
extension = suffisso
exterior = esteriore
external = esterne
extinguish = spegnere, spengere
extort = estorcere
extraordinary = straordinario
extreme = estremo
extremely = assai, molto, estremamente
eyebrow = sopracciglio
eyelid = palpebra
fabricate = fabbricare
face = far fronte a, faccia, viso
facile = facile
fact = fatto
faction = partito
factory = fabbrica
fag out = affaticare, spossare, stancare
fail = abortire, morire
failure = aborto, fallimento
faint = debole, svenirsi
fair = bazar, biondo
fairy = fata
fairy tale = favola, fiaba
faith = fiducia
faithful = fedele
fall = diminuire
fall ill = ammalarsi
fall off = declinare, deperire, peggiorare
false = falso
family = famiglia
famous = celebre, famoso, rinomato
fanatical = fanatico
fancier = dilettante
fancy = figurarsi
fantasy = fantasia
far = distante, lontano
farewell = addio, congedo
farm = fattoria
farmer = agricoltore, colono, contadino, mezzadro
fast = presto
fasten = fissare
fast train = treno rapido
fat = grosso, spesso, grasso
father = padre
father-in-law = suocero
fatherland = patria
fatigue = affaticare, stancare
fatty = grasso
favor = favorire
favour = favorire
fear = angoscia, aver timore, temere, paura
feather = penna
February = febbraio
feed = mangiare, alimentare
feel = sentirsi
fellow = uomo
female = femminile
female cook = cuoca
female hairdresser = parrucchiera
female journalist = giornalista
female relative = parente
female singer = cantante
female stenotypist = dattilografa
female tailor = sasta
female teacher = maestra
female thief = ladra
feminine = femminile
fertile = fecondo
fertilize = concimare
fervor = ardore, zelo
fervour = ardore, zelo
festival = festa
fetch = portare, ottenere
fever = febbre
fiancée = fidanzata
field = campo
field hospital = ambulanza
fifteen = quindici
fifth = quinto
fifty = cinquanta
fig = fico
fight = combattere, duellare, picchiarsi
fig-tree = fico
figure = figura, calcolare
file = lima
film = film, pellicola
filter = filtro
fin = pinna
finally = alla fine, finalmente
financial = finanziario
find = trovare
find oneself = trovarsi
fine = bello, carino, delicato, multare, contravvenzione, multa
finger = dito
finish = finire, terminare, apprestare, preparare
finished = finito, terminato, pronto
Finland = Finlandia
Finn = finlandese
fir = abete
fire = fuoco
firebrand = attizzatore
first = primo, dapprima, in primo luogo, prima
firstly = dapprima, in primo luogo, prima
first name = prenome
first of all = dapprima, in primo luogo, prima
fish = pescare, pesce
fisherman = pescatore
fishing rod = canna
fission = disintegrazione nukleare
fist = pugno
fit = adattare, aggiustare, apoplessia
fitting = decente
five = cinque
fix = adattare, aggiustare, fissare, riparare
fixed = fermo
fix up = predisporre, sistemare
flag = bandiera, stendardo
flame = fiamma
flannel = flanella
flat = appartamento, piano
flat-iron = ferro da stiro
flatter = lusingare
flavour = aroma
flaw = crepa, fessura, screpolatura
flea = pulce
flee = fuggire
flesh = carne
flight = fuga
float = nuotare
flood = alta marea
floor = piano, pavimento
Florence = Firenze
flour = fiore della farina
flow = fluire, scorrere, corrente
flower = fiore
flowerpot = vaso da fiori
fluid = liquido
flute = flauto
fly = volare, mosca
foam = schiuma
focus = foco
fog = nebbia
fold = piegare
folder = fascicolo
folk = popolo
follow = seguire
following = partito, seguito, seguente
fondle = accarezzare
font = fonte battesimale
food = alimento, cibo
foolish = ignorante, sciocco, stupido
foot = piede
for = durante, considerato che, visto che
for a long time = a lungo, da molto, per molto tempo
forbid = vietare
forbidding = spaventevole
force = costringere, forzare, forza
forecast = predire
forefather = antenato
forehead = fronte
foreign = straniera
foreign country = estero
foreigner = forestiere
forest = bosco
foretell = predire
foreward = avanti
for example = per esempio
forget = dimenticare
for instance = per esempio
formal = formale
former = passato
formerly = davanti
formidable = straordinario
formula = formula
formulate = formulare
forsake = abbandonare
for the greater part = per lo più
for the most part = per lo più
for the rest = d'altronde, inoltre
fortunate = felice
fortunately = per fortuna
fortune = fortuna
forty = quaranta
foster-parents = genitori adottivi
found = fondere
foundation = fondamento, fondo
fountain = fontana, fonte, sorgente
fountain-pen = penna stilografica
fountain pen = penna stilografica
four = quattro
fourteen = quattordici
fourth = quarto
fowl = gallina, pollo
fox = volpe
France = Francia
free = libero
freeze = congelare, gelare
freezing cold = gelo
French = francese
Frenchman = francese
frequently = frequentemente, sovente, spesso
fresh = fresco
Friday = venerdì
friend = amica, amico
friendly = amichevole, benevole, carino, cortese, gradevole, grazioso, amicale
friendship = amicizia
fright = angoscia, paura, timore
frindge = frangia
fringe = orlo
frivolous = vanitoso
frog = rana, ranocchio
frolic = cattivo
frolicsome = cattivo
from = di
from here = da qui
from there = di là
frontier = confine, frontiera
frost = gelo
froth = schiuma
fruit = frutta
fruitful = fecondo
fry = friggere
full = pieno
full payment = pagamento
fully = completamente
fun = divertimento, piacere
function = funzione, impiego
fund = capitale, fondo
fungus = fungo
funny = divertente, comico
fur = pelle
furious = furibondo, furioso
furniture = mobili
furthermore = inoltre
future = avvenire
gag = scherzo
gain = guadagno,. Guadagnare, beneficio, guadagno, profitto, vantaggio
gall = bile
gallery = galleria
gallop = galoppare
game = giuoco
gang = compagnia
gaol = prigione
garage = autorimessa
garbage can = cestino dei rifiuti
garden = giardino
gardener = giardiniere
garlic = aglio
garment = abito
garrison = guarnigione
gas = gas
Gascony = Guascogna
gasolene = benzina
gasoline = benzina
gather = concludere, dedurre, raccogliere
gathering = convegno
gaunt = magro, sottile, afflitto, triste
gay = allegro
gaze = fissare
general = universale, generale
generally = generalmente
generation = generazione
Geneva = Ginevra
Genoa = Genova
gentle = dolce, mite
gentleman = signore
genuinly = davvero, infatti
geography = geografia
German = tedesco
Germany = Germania
gesture = gesto
get = arrivare, ottenere, prendere, ricevere
get cold = raffreddarsi
get married = maritarsi, ammogliarsi, sposare
get off = scendere
get out of a habit = perdere l'abitunide di
get up = alzarsi, salire, alzarsi
get used = abituarsi, avvezzarsi
ghastly = abominevole, sgradevole, spiacevole, orrendo, orribile
gherkin = cetriolino
gift = dono, presente, regalo
gifted = dotato
gill = branchia
giraffe = giraffa
girder = trave
girdle = cintura
girl = piccola, ragazza
give = dare, presentare
give an airing = aerare, arieggiare, ventilare
give back = restituire
give in = cedere
give notice = annunciare, annunziare, pubblicare
give off an odour = sentire
give rise to = causare
give up = cedere
give way = cedere
gladness = gioia
glass = bicchiere, vetro
glasses = occhiali
globe = globo
glow = ardore
glue = appiccicare
go = andare, camminare
goal = proposito, scopo
go astray = perdersi, smarrirsi
goat = capra
go away = andarsene, partire
go back = declinare, deperire, peggiorare, indietreggiare, ritornare
go backwards = indietreggiare
go beyond = attraversare
goblet = calice, bicchiere, boccale
god = dio
godfather = compare
go down = scendere, diminuire, ribassare, scendere
God's acre = camposanto, cimitero
go fast = affrettarsi
go in = entrare
going down = regressione
gold = oro
good = buono
goodbye = addio, addio, congedo, arrivederci
good-bye = addio, congedo
good day = buongiorno
good evening = buonasera
good health = salute
good morning = buongiorno
good-natured = amichevole, benevole, carino, cortese, gradevole, grazioso
good night = buona notte, buonanotte
go off = sparare
go on = continuare
goose = oca
gooseberry = ribes
go out = uscire
gospel = vangelo
go through = percorrere
go to bed = coricarsi
go up = salire
gourd = zucca
govern = dominare, governare
government = governo
gown = abito
grab = afferrare
grade = grado, annotazione, nota
gradually = poco a poco
grammophone disc = disco
grandchild = nipote
granddaughter = nipote
grandfather = nonno
grandmother = nonna
grand-nephew = pronipote
grandparents = nonni
grandson = nipote
grape = acino, chicco d'uva, uva
grapevine = vite
grapple = prendere
grasp = afferrare
grass = erba
grasshopper = cavalletta
gratitude = gratitudine, riconoscenza, grazie
graveyard = camposanto, cimitero
gravy = salsa
grease = grasso
greasy = grasso
great = grande
Great Britain = Gran Bretagna
great-grandfather = bisnonno
great-grandmother = bisnonna
greatgrandson = pronipote
Greece = Grecia
greedy = avido, bramoso
Greek = greco
green = verde
Greenland = Groenlandia
greet = salutare
greeting = accoglienza, saluto
grey = bigio, grigio
grind = macinare
grip = afferrare
grisly = sgradevole, spiacevole
groan = gemere
ground = fondo
ground-floor = pianterreno
group = gruppo
grow = crescere, coltivare
growth = crescimento
gruesome = orrendo, orribile, terribile
gruff = brusco, rude
guarantee = garanzia
guard = capotreno
guess = supporre
guest = ospite
guide = condurre, guidare
guilty = colpevole
Guinea = Guinea
guitar = chitarra
gulf = abisso, burrone
gum = gengiva
gun = fucile
habit = abitudine, vizio, costume
hackneyed = trito e ritrito
Hades = Ade
haggle = mercanteggiare
hail = grandine
hair = capelli
hairdresser = parrucchiera
hairs = capelli
half = mezzo, metà
half-brother = fratellastro
half-sister = sorellastra
halt = fermarsi, fermare
ham = prosciutto
Hamburg = Amburgo
hamlet = paesello
hammer = martello
hamper = rendere difficile
hand = operaio, mano
handicraft = mestiere
handle = tenaglie, trattare
handlebars = remo
handsome = bello, carino
hang = pendere, sospendere
hangman = boia
hang onto = tenere
happen = accadere, arrivare, succedere
happy = felice
harbor = porto
harbour = porto
hard = duro, difficile, pesante, dura
hardly = appena
hard-worked = trito e ritrito
hardworking = attivo, laborioso
hare = lepre
haricot = fagiolo, fagiuolo
harm = nuocere
harmful = nocivo
harmony = accordo
harsh = brusco, rude
haste = fretta
hate = odiare, odio
haul = tirare
have = avere, ricevere
have a bath = bagnarsi
have at one's disposal = disporre
have got = avere
hay = fieno
hazard = caso, arrischiare, rischio
hazelnut = nocciola, nocciuola
he = lui
head = condurre, guidare, testa
health = salute
heap = folla, gruppo
hear = udire
heart = cuore
heat = ardore, riscaldare, calore
heaven = cielo
heel = tallone
he-goat = capro becco
height = altitudine, altura
helix = elica
hello = ciao
helm = remo
help = aiutare, assistere, aiuto, assistenza
helper = assistente
helpful = servizievole
hence = da qui
her = lei
herb = erba
herd = gruppo
here = quà, qui
hereditary = ereditario
herring = aringa
herself = stesso
hesitate = esitare, titubare
hide = pelle, nascondere, nascondersi
hide oneself = nascondersi
hideous = abominevole, orrendo, orribile
high = alto
high tide = alta marea
hill = collina, colle
him = lui
himself = stesso
hind = ultimo
hinder = rendere difficile, impedire, disturbare
hindmost = ultimo
hint = alludere
hinterland = retroterra
hip = anca
hippo = ippopotamo
hippopotamus = ippopotamo
hire = prendere in affitto
his = suo
history = storia
hit = battere, colpire, picchiare
hither = quà, qui
hog = porco
hold = tenere
hold back = ritenere
hole = buco
Holland = Olanda
Hollander = olandese
hollow = cavo
home = casa
honest = onesto
honey = miele
honor = onore
honour = onore
hood = cappotta, coperta
hoof = zoccolo
hook = amo
hooter = tromba, Corno
hope = sperare, speranza
horizon = orizzonte
horn = corno, tromba
horrible = abominevole, orrendo, orribile, sgradevole, spiacevole, mostruoso, schifoso, terribile
horror = orrore, ribrezzo
horse = cavallo
horse-chestnut = castagna
horsepower = cavallo vapore
horseradish = barbaforte
horse-radish = barbaforte
hospitable = ospitale
hospital = ospedale
host = ospite
hotel = albergo
house = casa
housefly = mosca
house of worship = chiesa
how = come
howl = muggire
hug = abbracciare
huge = enorme
human = umano
humble = umile
humid = umido
humour = umore
hundred = cento
Hungarian = ungherese
Hungary = Ungheria
hunger = fame
hunt = cacciare
hurry = affrettarsi
hurt = far male, ferire
husband = marito, sposo
hut = capanna
ice = ghiaccio
Iceland = Islanda
idea = idea, nozione
idol = idolo
if = se
ill = malato
illness = malattia
illuminate = accendere, illuminare
image = illustrazione, immagine, pittura, figura
imagination = immagine
imagine = figurarsi
imitate = imitare
immediately = direttamente, fra poco, immediatamente, subito
immense = enorme
impertinent = impertinente, insolente
imply = significare
important = grave, importante
impossible = impossibile
imposter = imbroglione
improve = migliorare
in = a, dentro
in action = attivo
in addition = d'altronde, inoltre
in a way = come se
in cash = contante
incendiary bomb = bomba incendaria
incite = incitare, spronare
inclined = disposto
include = contenere
inconvenient = difficile, pesante
increase = ingrandire
increasingly = di più in più
incredible = incredibile
incubate = covare
incus = incudine
indeed = di fatto, davvero, infatti
India = India
Indian = indiano, indiano americano
Indian corn = granturco
indicate = indicare, mostrare
indication = augurio, indicazione
Indo-China = Indocina
induce = concludere, dedurre
indulgence = indulgenza
industry = applicazione, diligenza
in exchange for = contro
inexpensive = a buon mercato
in fact = di fatto
infant = bambino, fanciullo
infect = infettare
infection = infezione, contagio
infectious = infettivo, contagioso
infer = concludere, dedurre
inference = conclusione
inform = informare, insegnare
ingredient = ingrediente
inhabitant = abitante
inherit = ereditare
inhibit = impedire
injure = danneggiare
injury = ferita
ink = inchiostroin-law = per via di matrimonio
inner = interno
in no way = in nessun modo
inquiry-office = ufficio d'informazioni
inquisitive = curioso
insane = matto
insect = insetto
inside = a, dentro, interno
insist = insistere
installment payment = pagamento a rate
instantly = direttamente
instigator = attizzatore
instructor = maestro
instrument = strumento
insult = insultare, offendere
insurance = assicurazione
intend = intendere
intention = intenzione
inter = seppellire
intercessor = avvocato
interest = interessare, interesse
interesting = interessante
internal = interno
interrupt = interrompere
intestine = intestino
in the beginning = all'inizio, dapprima, dapprincipio
in the evening = di sera
in the morning = di mattina
in time = in tempo
into = a, dentro
intoxicated = brillo, ubriaco
introduce = presentare
in vain = invano
invent = inventare
invest = investire
investigation = esame
invite = invitare
invite tenders for = dare in appalto
invoice = fattura
in what way = come
Ireland = Irlanda
Irishman = irlandese
iron = ferro, ferro da stiro
irrigate = annaffiare, bagnare, innaffiare
Islam = Islam
island = isola
issue = proclamare, pubblicare
Istria = Istria
Italian = italiano
Italy = Italia
itself = stesso
jack = cricco
jade = affaticare, spossare, stancare
jail = prigione
jam = marmelata
January = gennaio
Japan = Giappone
Japanese = giapponese
jaw = mascella
jawbone = mascella
jealousy = gelosia
Jericho = Gerico
Jerusalem = Gerusalemme
jest = scherzare
Jesus = Gesù
jeweller = gioielliere
job = lavoro, funzione, impiego,. compito
join = congiungere, unirsi, legare
joint = comune
joke = scherzare, scherzo
Jordan = Giordania, Giordano
Joseph = Giuseppe
Joshua = Giosuè
journal = giornale
journalist = giornalista
journey = viaggio
Jove = Giove
joy = gioia
judge = giudice, critico, giudicare
judgement = decreto, deliberazione
judgment = giudizio
jug = brocca, cassa, tinozza, vaso
July = luglio
jump = saltare, salto
June = giugno
Juno = Giunone
Jupiter = Giove
just = non ... che, soltanto, solamente, unicamente, fra poco, immediatamente, subito
keel = chiglia
keep = conservare, osservare, compiere, eseguire, salvare
keeper of the records = archivista
keep on = durare
keep one's hands off = non toccare
keepsake = memoria
kettle = calderotto
key = chiave
keyboard = pianola, tastiera
kidney = rene
kill = ammazzare, uccidere
kind = amichevole, benevole, carino, cortese, gradevole, grazioso, genere, specie
kindle = accendere
kingdom = regno
kiss = baciare, bacio
kitchen = cucina
klaxon = corno, tromba
knee = ginocchio
kneel = inginocchiarsi
knife = coltello
knob = tenaglie
knock = colpire, picchiare
knot = nodo
know = conoscere, sapere
know how = sapere, conoscenze
knowledge = conoscenza
Koran = Corano
Korea = Corea
Kremlin = Cremlino
laborer = operaio
labor exchange = ufficio di collocamento
labourer = operaio
labour exchange = ufficio di collocamento
lack = mancanza
lad = ragazzo
ladder = scala
laddie = ragazzo
lady = signora
Lady Day = Annunciazone
lady help = assistente
laggard = ritardatario
laid up = costretto a letto
lake = lago
lamb = agnello
land = paese, terra
lane = vicolo
language = lingua
Lapland = Lapponia
lapsed = decrepito
large = grande
lark = allodola
lass = piccola, ragazza
last = durare, scorso, ultimo, passato
lasting = continuo, durevole, permanente
last night = ieri sera
late = tardo
Latvia = Lettonia
laud = lodare
laugh = ridere
2. riso
laughter = risa
laundry = lavanderia
laurel = alloro
lawless = dissoluto, licenzioso
lawn = tappeto erboso
lawsuit = processo
lawyer = avvocato
lay down = mettere, ponere
lay hold of = prendere
lazy = pigro
lead = condurre, guidare, piombo
leader = capo
leaf = foglia, foglio
league = banda
lean = sostenere, appoggiarsi, magro, sottile
leap = saltare, salto
leap-year = anno bisestile
learn = imparare
leather = cuoio
leave = andarsene, partire, abbandonare
leave behind = abbandonare, lasciare
Lebanon = Libano
leek = aglio
left = sinistro, sinistra
left side = sinistra
leg = gamba
Leghorn = Livorno
lemon = limone
lentil = lenticchia
less and less = di meno in meno
lesson = lezione
let = affittare
let know = insegnare
letter = lettera
letterbox = buca delle lettere
lettuce = lattuga
level = piano, eguale, livello
level-crossing = passaggio a livello
lever = alzare
librarian = bibliotecario
library = biblioteca
licentious = dissoluto, licenzioso
lid = coperta
lie = mentire, bugia
life = vita
lift = alzare, salire, ascensore
light = accendere, leggero, illuminare, luce, debole, leggero
lighter = accendino
lighthouse = faro
lightning = baleno
like = come, simile, apprezzare
likely = probabile
likewise = anche
limb = membro
lime = calce
lime-tree = tiglio
limit = limitare, restringere, confine, frontiera
limp = zoppicare
linden-tree = tiglio
line = lenza, linea
lineage = discendenza, nascita, origine
lion = leone
lip = labbro
liquid = liquido
liquidate = ammazzare, uccidere
Lisbon = Lisbona
list = lista
listen = ascoltare
listen in = origliare
Lithuania = Lituania
little = piccolo
little by little = poco a poco
Little Red Ridinghood = Cappuccetto Rosso
live = abitare, dimorare, stare, vivere
lively = spiritoso
liver = fegato
living-room = stanza
load = caricare, carico
loaf = pane
loathe = detestare
lobster = aragosta
location = luogo
loch = lago
lock = serratura, serrare a chiave
locust = cavalletta
lofty = alto
logical reasoning = ragione
London = Londra
long = lungo, a lungo, da molto, per molto tempo
look = parere, apparenza, aria, aspetto, guardare
look after = prendere a cuore,. badare
look at = guardare,
look for = cercare
looking-glass = specchio
lord = signore
lorry = autocarro, camion
lose = perdere
loss = perdita
lost = perduto
loudly = ad alta voce, forte
lounge = salotto
louse = pidocchio
lovable = amabile, grazioso
love = amare, volere bene, amore
lovely = gradevole, piacevole, bello, carino, caro, affascinante, amabile, grazioso
low = basso
lower-arm = avambraccio
low tide = bassa marea
loyal = fedele
Lucifer = Satana
luggage = bagaglio
luggage-van = bagagliaio
lukewarm = tiepido
lump = massa, pezzo
lunatic = pazzo
lung = polmone
lurid = acuto, affilato, aguzzo, appuntito, aspro, piccante, tagliente
Machiavelli = Machiavelli
machine = macchina
mackerel = sgombro
mad = matto, rabbioso
madam = signora
magazine = rivista
magpie = gazza
maid = cameriera
mail = posta
mailbox = buca delle lettere
mainly = principalmente, soprattutto
maintain = conservare
maintenance = conservazione, preservazione
maize = granturco
majority = maggioranza
make = commettere, fare
make a contract = concludere
make a mistake = errare, sbagliarsi
make an offer of = offrire
make a project of = progettare
make clean = pulire
make fast = fissare
make use of = impiegare, usare
male = maschio
man = uomo
manage = amministrare, dirigere
management = amministrazione, direzione, gestione
manager = amministratore, amministratore delegato, direttore
manner = maniera, modo
manufacture = fabbricare
map = carta
marble = marmo
march = camminare
mark = segno
market = bazar, sbocco, mercato
marketplace = mercato
mark out = delimitare
marmelade = marmelata
marriage = matrimonio
married = sposato, sposato
married people = coniugi, consorti
marry = maritarsi, ammogliarsi, sposare
marvel = stupirsi
marvel at = stupirsi
masculine = maschio
mass = folla, affluenza, massa
mast = albero
master = maestro, padrone, principale
match = fiammifero
material = materiale
matter = affare, faccenda, caso, materia
mattress = materasso
mature = maturo
maximum = massimo
maybe = forse
mayhap = forse
mayor = sindaco
meager = magro, miserabile, misero, povero
meal = fiore della farina
mealies = granturco
mean = intendere, medio, mezzo, significare, mirare a
meaning = intenzione, significato
means = arnese, strumento. arnesi
measure = misurare, misura
measured = misurato
measurement = dimensione, misura
meat = carne
Mecca = Mecca
mechanic = meccanico
meet = incontrare
meeting = convegno
melon = melone
melt = sgelare
member = membro
memento = memoria
memorable = memorabile
memorize = imparare a memoria, memorizzare
memory = memoria
menace = minacciare, minaccia
mentally deficient = deficiente
mention = menzionare
menu = carta, lista
merchant = commerciante
merciful = misericordioso
merit = meritare
merry = allegro
message = messaggio, annunzio, comunicato
Messiah = Messia
metal = metallo
method = metodo
methylated spirit = alcool denaturato
Mexico = Messico
Mexico City = Città del Messico
midday = mezzodì
midday meal = colazione
middle = medio, mezzo
midget = nano
midnight = mezzanotte
Milan = Milano
mild = mite
milk = latte
milliner = modista
million = milione
mind = osservare
mineral = minerale
ministry = ministero
minority = minorità
mint = menta
minutes = contravvenzione
mirror = specchio
miscarriage = aborto
miscarry = abortire
miscellaneous = di ogni genere, ogni sorta di
miserable = cattivo, afflitto, triste, povero, afflitto, triste, miserabile, misero
miserly = avaro
misery = miseria
mist = nebbia
mistake = errore, sbaglio
Mister = signore
mixture = mistura
moan = gemere
mobile = mobile
mode = maniera, modo
modest = modesto
Mohammed = Maometto
moist = umido
Monday = lunedì
money = denaro, soldi
monitor = origliare
monkey = scimmia
monologue = monologo
monotonous = monotono
monster = mostro
month = mese
monthly = al mese, mensilmente
monthly nurse = asciutta, balia
monument = monumento
mood = atmosfera, umore
moon = luna
moped = ciclomotore
morality = virtú
more and more = di più in più
moreover = d'altronde, inoltre
morning = mattina
Moscow = Mosca
mosquito = zanzara
most = estremamente
mother = madre
mother-in-law = suocera
motion picture = film, pellicola
motor = motore
motor car = auto, automobile
motorcycle = motocicletto
mouldy = ammuffito
mount = adattare, aggiustare
mountain = montagna, monte
mountain chain = montagne
mountain ridge = spigolo
mouse = sorcio, topo
moustache = baffi
mouth = bocca, imboccatura
move = muovere, muoversi
movement = movimento
movie = film, pellicola
movie theatre = cinema
Mr. = signore
Mrs. = signora
much = molto
mud = fango
mudguard = parafango
Muhammad = Maometto
mulberry-tree = gelso
mule = mulo
multiply = moltiplicare
multitude = folla, affluenza
murk = oscurità, tenebre
muscle = muscolo
museum = museo
mushroom = fungo
musician = musicista
mussel = vongola
mustard = mostarda
mute = muto
mutton = carne di montone
my = mio
mysterious = misterioso
nail = chiodo, unghia
naked = nudo
name = nome
napkin = tovagliolo
narrate = raccontare
narrow = stretto
nasty = abominevole, sgradevole, spiacevole
3. mostruoso, schifoso, cattivo, disonesto
nation = popolo
national = nazionale
nationality = cittadinanza
naturally = naturalmente
nature = carattere, indole, natura
nausea = avversione, ripugnanza
navy = marina
near = prossimo, vicino
nearby = vicino, prossimo, vicino
nearly = quasi
near-sighted = miope
Nebuchadnezzar = Nabucodonosor
necessary = necessario, occorrente
neck = collo
necktie = cravatta
need = aver bisogno di, bisogno, fabbisogno
needle = ago
neglect = trascurare
negligent = negligente, noncurante, sbadato
neighbour = vicino
neighbourhood = circondario, distretto
neighbouring = vicino
nephew = nipote
Neptune = Nettuno
nerve = nervo
net = rete
nettle = ortica
network = rete
never = mai, non ... mai
new = nuovo
New Amsterdam = Nuova York
Newfoundland = Terranova
newspaper = giornale
New York = Nuova York
New York City = Nuova York
next = dietro, dopo, in seguito, poi, prossimo, seguente
next to = accanto
nice = gradevole, piacevole, buono
nickname = soprannome
niece = nipote
night = notte
nightingale = usignolo, usignuolo
Nimrod = Nembrod
nine = nove
nineteen = diciannove
ninety = novanta
no = non
nobility = nobiltà
node = nodo
no doubt = si capisce
noise = rumore
no longer = non ... più
non-military = civile
noon = mezzodì
Normandy = Normandia
north = nord
North America = America del Nord
Norway = Norvegia
Norwegian = norvegese
nose = naso
not = no
notary = notaio
not at all = in nessun modo, niente affatto
note = biglietto, annotazione, nota
notebook = fascicolo, taccuino
notice = affisso, cartellone, avviso, osservare, osservazione, annunzio, comunicato
notification = avviso
notion = idea, nozione
not on any account = in nessun modo
nourish = alimentare
nourishment = alimento, cibo
novel = nuovo, romano, romanzo
November = novembre
nowadays = oggigiorno
now and then = di quando in quando, ogni tanto
nowhere = in nessun luogo
nude = nudo
number = numero
numeral = numero
nurse = curare, infermiera, badare, asciutta, balia
nut = madrevite, noce
nuts = matto
oak = quercia
oath = giuramento
oats = avena
obedient = ubbidiente
obey = ubbidire
object = cosa, ogetto
objectionable = biasimevole
obligation = dovere
observation = osservazione
observe = osservare, compiere, eseguire
obstinate = ostinato
obstruct = sbarrare
obtuse = smussato, spuntato
obvious = chiaro, evidente, palese
obviously = evidentemente
occupation = mestiere, occupazione
occupy = occupare
occur = accadere, arrivare, succedere
October = ottobre
odd = strano
of = di
of all sorts = di ogni genere, ogni sorta di
offence = scandalo
offend = insultare, offendere
offer = offrire, offerta, presentare, proporre
offer up = offrire
office = ufficio, funzione, impiego
officer = funzionario, impiegato
official = ufficiale, funzionario, impiegato
offset = distanza
offspring = generazione, discendente
of ill repute = famigerato
of noble birth = aristocratico, nobile
often = frequentemente, sovente, spesso
of use = adatto, capace, idoneo, utilizzabile, utile
oil = olio
okay = buono, bene
old = vecchio, antico
old materials = macerie
olive = oliva
olive-tree = olivo
omen = augurio
omnibus = autobus
omnipotent = onnipotente
omniscient = onnisciente
on = avanti, di, a, dentro, mediante, per mezzo di
once = una volta
once more = ancora, di nuovo
one = un, un', una, uno
one hundred = cento
one thousand = mille
one time = una volta
onion = cipolla
only = non ... che, soltanto, solo, solamente, unicamente
only just = appena
on one's back = a rovescio, supino
on purpose = apposta
on that account = perciò, per quésto
on the left = a sinistra
on the other side of = attraverso
on the right = a destra
on time = esatto, preciso
on top = di sopra
open = aprire, aperto
open up = aprire
operative = operaio
opposed to = contro
opposite = dirimpetto, contro
oppress = premere, serrare, stringere
optician = ottico
option = alternativa
orange = arancia
orange-tree = arancio
orchard = frutteto
ordain = destinare
order = ordinare, ordine
origin = nascita, origine
originate = discendere
Orkney Islands = Orcadi
Orkneys = Orcadi
ornament = decorare
Orpheus = Orfeo
other = altro
other than = eccetto, salvo
out = fuori
outer = esterne
outfit = abito, costume
outline = progetto
outside = esterne, fuori
over = finito, terminato, sopra
overall = completo, intero, totale, tutto
overdrive = affaticare, spossare, stancare
overhead = di sopra
override = affaticare, spossare, stancare
over there = laggiú
overthrow = rovesciare
owe = dovere
owl = gufo
own = possedere, proprio
ox = bue
oyster = ostrica
pace = passo
pack = avvolgere
package = avvolgere
packet = pacco
pad = blocco
padre = cappellano militare
page = pagina
pail = secchia, secchio
pain = dolore
painful = doloroso
paint = tingere, dipingere
painter = pittore
painting = pittura
Pakistan = Pakistan
palace = palazzo
pale = pallido
palm = palma
panties = mutande
pants = calzoni, pantaloni
paper = documento, carta, tappezzare
paper-basket = cestino per la carta
parade = chiamata
paraffin-oil = petrolio
paragraph = capoverso
parallel = parallelo
parapet = parapetto
parcel = pacco
parents = genitori, padre e madre
parents-in-law = suoceri
Paris = Parigi
parlour = salotto
parrot = pappagallo
parsley = prezzemolo
part = ingrediente, parte, porzione
Parthian = parziale, parte, porzione
partial = parziale
partially = in parte, parzialmente
participate = spartire
participle = participio
particular = separato, speciale
partly = in parte, parzialmente
partridge = pernice
party = partito, seguito, festa, partito
pass = passare
passable = praticabile
passage = corridoio
pass away = morire
passenger = passagiere
passenger train = treno omnibus
passion = ardore
passport = passaporto
pass through = percorrere
past = passato
paste = pasta
pastor = curato, prete, sacerdate
pate = testa
path = sentiero
patience = pazienza
paw = gamba, piede
pay = pagare
pay attention = aspettare, attendere
pay attention to = aspettare, attendere
payment = pagamento
pay out = spendere
pea = pisello
peace = pace
peak = punta
peanut = arachide
pear = pera
pear-tree = pero
peculiar = strano
peer = fissare
pelvis = bacino
pen = penna
pencil = lapis, matita
penetrate = penetrare
peninsula = penisola
penitent = pentito
penthouse = tettoia
people = gente, popolo
pepper = pepe
per = a, dentro
perceive = accorgersi, intravedere, scorgere
perchance = forse
perfect = perfetto
perform = apparire, entrare, commettere, fare, compiere, eseguire, presentare
perhaps = forse
peril = pericolo
period = punto
periodical = rivista
permanent = costante
permission = accordo
permit = permettere
perplexed = confuso, turbato
persecute = perseguire, perseguitare
persecution = inseguimento
person = persona
personal = personale, proprio
persuade = convincere
petition = petizione
petitioner = petente, postulante, supplicante
petrol = benzina
petroleum = petrolio
petulant = cattivo
pheasant = fagiano
philosopher = filosofo
photograph = fotografo
photography = fotografia
physical = fisico
physician = dottore, medico
pick = rompere, staccare, pungere
pick out = eleggere, scegliere
pick up = ottenere, raccogliere,. prendere
picture = illustrazione, immagine, pittura, figura
picture postcard = cartolina illustrata
piece = parte, porzione, pezzo
pig = porco
pigeon = piccione
pike = luccio
pile = folla
pilgrimage = pelegrinaggio
pillow = guanciale
pincers = pinzette
pine = pino
pineapple = ananas, ananasso
pine-tree = pino
pink = garofano, rosa
pioneer = iniziatore, pioniere
pipe = condotto
pitcher = brocca
placard = affisso, cartellone
place = adattare, aggiustare, luogo, mettere, ponere
place of birth = culla, luogo d'origine
place of worship = chiesa
plain = piano, distinto
plan = intenzione, progettare, progetto
plane = aereo, aeroplano, pialla
plant = pianta, piantare, pianta
plate = piatto
platform = piattaforma
platter = piatto
play = giocare, suonare
plaza = piazza
plea = argomento
pleasant = gradevole, piacevole
pleasantly = piacevolmente
please = piacere
pleased = contento
pleasure = piacere
plenty = abbondanza, affluenza
plough = aratro
pluck = rompere, staccare
plug = candela
plume = penna
plunge = tuffarsi
Po = Po
poem = poema
poet = poeta
poetry = poesia
point = punta, punto
pointed = appuntato
point out = mostrare
poison = avvelenare, veleno
poisonous = velenoso
Poland = Polonia
pole = barra
police = polizia
policeman = guardia, poliziotto
police-station = questura
policy = politica
polite = cortese
politeness = cortesia
political = politico
politics = politica
pond = stagno
pool = unirsi
poop = poppa
poopdeck = poppa
poor = cattivo, povero
poplar = albero, pioppo
population = populazione
pork = maiale
port = porto
portable = portabile, portatile
portal = entrata
portent = augurio
porter = facchino
port side = babordo
Portugal = Portogallo
Portuguese = portoghese
pose = posare
possess = possedere
possession = possesso
possible = possibile
possibly = forse
post = funzione, impiego, posta
postage = affrancatura
postage stamp = bollo, francobollo
postal code = CAP, codice di avviamento postale
postcard = cartolina postale
poster = affisso, cartellone
postman = portalettere, postino
post office = ufficio postale
potato = patata
pottery = stoviglie
pour = versare
poverty = povertà
power = potere
practicable = praticabile
practical = reale
practice = applicare, esercizio, praticare
praise = lodare
prawn = granchiolino
pray = pregare
prayer = preghiera
precipice = abisso, burrone
precursor = augurio
preferably = piuttosto
pregnant = incinta
prejudice = pregiudizio
premium = premio
prepare = allestire, preparare
prepay = affrancare, pestare
presage = augurio
presence = presenza
present = attuale, dono, presente, regalo, presentare
present-day = attuale
present with = presentare
preservation = conservazione, preservazione
preserve = conservare
press = premere, serrare, stringere
pressure = pressione
presume = supporre
pretty = bellino, grazioso
prevent = impedire
previously = davanti
price = prezzo
pricey = caro, costoso
prick = cazzo
priest = curato, prete, sacerdate
principally = principalmente, soprattutto
principle = principio
print = stampare
printer = tipografo
prison = prigione
prisoner = arrestato, detenuto, prigioniero
private = particulare, privado, senza impiego
prize = premio
probable = probabile
probably = probabilmente
problem = problema
proceed with = continuare
process = azione, processo
proclaim = proclamare, pubblicare
proclamation = dichiarazione, pubblicazione
produce = produrre
product = prodotto
profess = confessare
profession = professione
profit = approfittare, beneficio, guadagno, profitto, vantaggio
profound = fondo, profondo
progress = miglioramento, progresso
prohibit = vietare
project = progetto
promenade = passeggiata
promise = promettere, promessa
promote = promuovere
promotion = promozione
prompt = esatto, preciso
pronounce = pronunciare
proof = prova
propeller = elica
proper = decente
property = fattoria, possesso
prophesy = predire
proportional = proporzionale
propose = proporre
prosecute = perseguire, perseguitare
proselyte = convertito, convertito
prosper = prosperare
protect = proteggere, riparare
protection = protezione
protégé = protetto
protégée = protetta
protest = protestare, protesta
protocol = contravvenzione
proud = fiero, orgoglioso
prove = provare
provided that = se
provoke = incitare, spronare
prow = prua
prudent = sensato
pub = bar
public = pubblico
publication = pubblicazione
public square = piazza
publish = pubblicare
pull = tirare
pull down = demolire
pulse = polso
pulverize = macinare
pump = pompare, pompa
punctual = esatto, preciso
punish = castigare, punire
punishment = punizione
pupil = allievo, scolaro, pupillo
puppet = bambola
purchase = comperare, comprare, acquisto, compra
purchaser = cliente, compratore
pure = puro
purge = pulire
purity = pulizia
purpose = proposito, scopo
purser = commissario
pursue = perseguire, perseguitare
pursuit = inseguimento
push = spingere, spinta, urto
put = mettere, ponere
put down = mettere, ponere
put off = togliere, imbarcare, sbrigarsi di
put on airs = posare
put on stamps = affrancare, pestare
put on the stage = presentare
put onto = affigere
put out = spegnere, spengere
put out to tender = dare in appalto
put up = adattare, aggiustare
put up with = sopportare, tollerare
quarter = circondario, distretto
quarter of an hour = quarto d'ora
quash = distruggere
quay = piattaforma
quell = soffocare
question = domanda, contestare, disputare
quickly = presto
quiet = calmare, placare
quit = abbandonare
quite = abbastanza, assai, molto
quiver = tremare
quotation = citazione
quotation marks = virgolette
quote = citare
quotes = virgolette
rabbit = coniglio
rabid = rabbioso
race = razza
radiation = radioterapia
radio = radio
radish = ravanello
radius = radio, sciopero
ragout = cibreo
railing = parapetto
railroad = ferrovia
railway = ferrovia
railway carriage = vagone, vettura
rain = piovere, pioggia
rainbow = arcobaleno
raise = alzare
ranch = fattoria
rand = orlo
rapier = spada
rare = raro
raspberry = lampone
rat = topo
rate = apprezzare, stimare, valutare
rather = piuttosto, abbastanza
raven = corvo
raw = crudo
ray = sciopero
reach = arrivare
react = reagire
read = leggere
ready = pronto
real = reale
reality = verità
realize = capire, comprendere
really = davvero, infatti
rear = retroguardia
rearguard = retroguardia
rear-lamp = luce di posizione, fanale posteriore
rear-light = luce di posizione, fanale posteriore
reason = causa, ragione
reasonable = sensato
rebuke = biasimare, disapprovare, riprendere
receipt = ricevuta
receive = accettare, accogliere, ricevere
recent = fresco
recently = recentemente
recess = alcova
recipient = destinario
recite = recitare
recognize = riconoscere
recollection = memoria
recommend = raccomandare, vantare
recommendable = raccomandabile
recommendation = raccomandazione
recruit = arruolare, ingaggiare
red = rosso
redeemable = rimborsabile, estinguibile
redemption = ammortizzamento
reduce the price = respingere
reek = sentire
referee = arbitro
refined = delicato
refusal = rifiuto
refuse = rifiutarsi
regard = considerazione, stima, riguardo, rispetto, considerare, guardare
register = raccomandare, vantare
regret = rincrescere
regular = regolare
regularly = frequentemente, sovente, spesso
regulation = regola
reject = rifiutare, rifiutarsi
relate = raccontare
related = congiunto, parento
related by marriage = imparentato
relation = relazione
relations = parentado
relationship = parentado, parentela
relative = parente, relativo
relatives = parentado
release = liberare
relinquish = cedere
remain = resti dietro, stare, restare, rimanere
remit = annullare
remote = isolato, distante, lontano
remote control = telecomando
rendezvous = appuntamento
rent out = affittare
repair = riparare
repayable = rimborsabile, estinguibile
repeat = ripetere
repentance = pentimento, rimpianto
repentant = pentito
reply = replicare, rispondere, risposta
report = informare, insegnare, annunciare, comunicare, annunzio, comunicato
repose = riposarsi, riposo
represent = rappresentare
representation = figura
representative = delegato, deputato
reproach = riprendere
reprove = riprendere
republic = repubblica
request = chiedere
require = aver bisogno di
rescue = salvare
resemble = rassomiglare
reserve = ordinare, riservare
residence = residenza, alloggio, appartamento
respect = rispettare, rispetto
respectable = onorevole, rispettabile
respiration = respirazione
respond = reagire, replicare, rispondere
responsible = responsabile
rest = riposarsi, riposo
restaurant = ristorante
restrain = dominare, governare
restrict = limitare, restringere
result = discendere, risultato, esito
resumé = sommario
retain = ritenere
retardation = ritardo
retarded = deficiente
retention = conservazione, preservazione
return = restituire, ritornare, rivenire
return-ticket = biglietto d'andata e ritorno
reveal = pubblicare
revenge = vendetta
revue = rivista
reward = ricompensare, ricompensa
Rhine = Reno
Rhine barge = chiatta
Rhineland = Renania
rhino = rinoceronte
rhinoceros = rinoceronte
rib = costola
ribbon = nastro
rice = riso
rich = ricco
rickety = decrepito
ride = camminare
ridiculous = ridicolo
rifle = fucile
right = destro, corretto, diritto
right away = fra poco, immediatamente, subito
righthand = destro
right-hand side = destra
right now = fra poco, immediatamente, subito
rigid = rigido
rim = orlo
ring = anello
riotous = dissoluto, licenzioso
ripe = maturo
rise = alzarsi, salire
risk = arrischiare,. rischio
river = fiume
road = cammino, corsia, pista, strada, via
roar = muggire
rob = derubare
robe = abito
rock = roccia
rod = barra
roll = panino
roll-call = chiamata
roller = cilindro
roller-blind = persiana
Roman = romano, romanzo
Rome = Roma
roof = tetto
room = spazio, camera
rooster = gallo
rough = crudo, brusco, rude
round = rotondo, arrotondare, intorno a
round off = arrotondare
rouse = incitare, spronare, stimolare
route = cammino, corsia, pista, strada, via
rubber = gomma
rubbish = macerie
rudder = remo
rude = rozzo, scortese
rudiments = alfabeto
ruin = rovinare
rule = dominare, governare, regola
rump = sedere
run = fuga, correre
run across = colpire
run away = fuggire
rush = affrettarsi
Russia = Russia
Russian = russo
rusty = arrugginito
rye = segale
Sabbath = sabato
sack = borsa
sacrifice = offrire
sad = afflitto, triste
sadness = tristezza
safety = sicurezza
sagacious = saggio
sage = salvia, saggio
sail = vela
sailor = marinaio
salad = insalata
salary = paga, salario
sale = smercio, vendita
sales activity = sbocco
sallow = pallido
salmon = salmone
salon = salotto
salt = sale
salute = salutare
sample = campione
sand = sabbia
Sardina = Sardegna
Sardinia = Sardegna
Sassenach = inglese
Satan = Satana
satisfied = contento
Saturday = sabato
sauce = salsa
saucepan = casseruola
saucer = piattino
Saudi Arabia = Arabia Saudita
sausage = salsiccia
savage = selvaggio
save = salvare
saw = sega
say = dire
say goodbye = dire addio
say goodbye to = dire addio
say yes = affermare
scale = squama
scales = bilancia
scandal = scandalo, maldicenza
scarcely = appena
scare = impaurire, spaventare
scatter = versare
schedule = orario
scheme = progetto
scholar = dotto, erudito, allievo, scolaro
school = scuola
science = scienza
scientist = scienziato
scissors = forbici
scold = riprendere
Scot = scozzese
Scotland = Scozia
Scotsman = scozzese
scratch = raschiare
scream = gridare
screen = schermo
screw = vite
screwdriver = cacciavite
scuffle = battaglia
sculptor = scultore
sculpture = scultura
scythe = falce
sea = mare
sea-dog = foca
seagull = gabbiano
seal = foca
seasickness = mal di mare
seaside = costa
season = stagione
seat = posto
second = secondo
second cousin = pronipote
secret = segreto
secretion = secrezione
section = divisione
secure = fissare
security = sicurezza
see = incontrare, vedere, visitare
seek = cercare
seem = parere
seemly = conveniente
seize = afferrare
seizure = apoplessia
seldom = raramente
self = stesso
self-conscious = timido
self-interested = egoistico
selfish = egoistico
sell = vendere
send = mandare
send about his business = imbarcare, sbrigarsi di
sensible = sensato
sensitive = sensibile
sentence = frase, condannare
separate = separato, separare, dividere
September = settembre
serious = grave, importante, serio
serpent = serpente
servant = servire
serve = servire
service = uffizio divino, servizio
set = apparecchio, gruppo
settlement = pareggiamento dei conti
seven = sette
seventeen = diciasette
seventh = settimo
seventy = settanta
several times = qualche volta, talvolta
severe = severo
sex = sesso
shack = baracca, capanna
shade = ombra
shadow = ombra
shaft = albero
shallow = basso
shame = vergogna
Shanghai = Sciangai
shanty = baracca
share = azione, dividere, spartire, parte, porzione
shareholder = azionista
shark = pescecane
sharp = acuto, affilato, aguzzo, appuntito, aspro, piccante, tagliente, giustamente, giusto
shave = far la barba
she = lei
shed = tettoia, baracca, granaio, versare
sheep = pecora
sheet = foglia, foglio, lenzuolo
sheet metal = latta
she-goat = capra
shelf = asse
shell = conchiglia
shelter = riparo, rifugio, riparare
shine = brillare, risplendere
shiver = tremare
shoe = scarpa
shoemaker = calzolaio
shoot dead = fucilare
shop = negozio
shore = costa
short = corto
shortage = mancanza
shortcoming = mancanza
shorten = abbreviare, accorciare
shortness of breath = asma
short-sighted = miope
shoulder = spalla
shout = gridare, grido
show = mostrare
shower = doccia
shrew = megera
shrub = arbusto
shut = chiudere, chiuso
shy = timido
Siam = Tailandia
Sicily = Sicilia
sick = malato
side = fianco, lato, partito
sideboard = armadio
side-whiskers = baffi
siege = assedio
sigh = sospirare
sight = apparenza, aria, aspetto, vista
sightless person = cieco
sign = augurio, prova, segno, firmare
signal = segno
signalman = cantoniere, casellante
signature = firma
signify = significare
silent = silenzioso
sill = soglia
silver = argento
similar = simile
simple = semplice
since = di, considerato che, visto che
sincere = sincero
sing = cantare
singer = cantante
sir = signore
sister = sorella
sister-in-law = cognata
sit = covare, essere seduto
sit down = sedersi
sitting-room = stanza, salotto
six = sei
sixteen = sedici
sixth = sesto
sixty = sessanta
sizable = considerevole, notevole, ragguardevole
size = grandezza
skeleton = scheletro
sketch = progettare, progetto
skilfulness = abilità, destrezza
skill = abilità, destrezza
skillful = abile, destro, lesto, sveglio
skillfulness = abilità, destrezza
skim = scremare
skimpy = magro
skin = pelle
skinny = magro
skull = cranio
sky = cielo
sky blue = azzurro
slander = calunniare, maldicenza
slay = ammazzare, uccidere
sleep = dormire, sonno
sleeping-car = vettura letti
slender = sottile
slice = tagliare
slime = fango
slug = lumaca
slum = quartiere popolare, rione popolare
small = piccolo
smell = sentire
smell of = sentire di
smile = sorridere, sorriso
smoke = fumare, fumo
smokers = fumatori
smokestack = fumaiuolo
smooth = piano, liscio
snail = chiocciola, chiocciolina
snake = serpente
snore = russare
snow = nevicare, neve
so = così
sober = sobrio
sobriquet = soprannome
social = sociale
society = compagnia
soft = dolce, molle
soil = insudiciare, sporcare, terra
sole = pianta, solo, sogliola
solely = non ... che, solamente, soltanto, unicamente
solicitor = avvocato
soliloquy = monologo
solitary = solo
so long = arrivederci
solve = risolvere
somber = afflitto, triste
sometimes = qualche volta, talvolta
somewhere = in qualche luogo
son = figlio, figliolo
song = canzone
son-in-law = genero
soon = fra poco
soothe = calmare, placare
sorrow = tristezza
sort = genere, specie
so so = così così
so to speak = per così dire
sound = sonare, suono
soup = minestra
sour = acido, agro, brusco, rude
source = fonte, sorgente
south = sud
South America = America del Sud
souvenir = memoria
sow = seminare
spa = bagni, stazione balneare
space = spazio
Spain = Spagna
Spaniard = spagnolo, spagnuolo
spanner = chiave
spark = scintilla
spark plug = candela
sparrow = passero
speak = parlare
special = separato, speciale
specimen = campione
spectacles = occhiali
speechless = muto
speed = velocità, andatura
speed up = accelerare
spell = compitare
spend = spendere, passare
sphere = sfera
spider = ragno
spiked = appuntato
spinach = spinaci
spindle = albero
spine = spina dorsale
spirit = spirito
spiritual = spirituale
spit = sputare
split = fendere
spoil = danneggiare
spoon = cucchiaio
sport = sport
spot = luogo, punto
spring = fonte, sorgente, primavera, molla, saltare
springtime = primavera
spy = spiare
squad = compagnia
square = quadrato, piazza
square decametre = gruppo
squeeze = premere, serrare, stringere
squirrel = scoiattolo
stab = pungere
stable = stabile, stalla
staid = serio
staircase = scala
stairs = scala
stale = trito e ritrito
stall = stalla
stamp = bollo, francobollo
stand = granaio, alzarsi, stare in piedi, alzarsi
standard = stendardo
stand up = alzarsi
stand up to = far fronte a, opporsi a
star = stella
stare = fissare
start = cominciare, inizio, principio
state = asserire, sostenere, stato
statement = dichiarazione
station = stazione
station-master = capostazione
statue = statua
stay = stare, restare, rimanere
stay on = resti dietro
stay over = stare, restare, rimanere
steak = bistecca
steal = rubare
steam-boiler = caldaia
steel = osso di balena, acciaio
steep = ripido
steering-wheel = timone, volante
stem = tronco
stenotypist = dattilografa
step = passo
step-brother = fratellastro
step-father = patrigno
step-mother = matrigno
step-sister = sorellastra
sterile = sterile
stern = poppa
stew = cibreo
stick = appiccicare
sticky = appiccicaticcio
stiff = rigido
still = ancora, calmare, placare
stimulate = incitare, spronare, stimolare
sting = pungere, aculeo, pungiglione
stingy = avaro
stir up = incitare, spronare, stimolare
Stockholm = Stoccolma
stoke = riscaldare
stomach = stomaco
stomach ache = mal di pancia
stone = pierra
stoop = curvarsi
stop = fermata,. Fermarsi, fermare, cessare, interrompere
storage battery = accumulatore
store = negozio
storey = piano
storm = tempesta
story = piano, storia
straggler = ritardatario
straight = destro
straightforward = semplice
strait = stretto
strange = strano
strawberry = fragola
stray off = perdersi, smarrirsi
stream = corrente, ruscello
strech = caricare
street = via
streetcar = tram
strength = forza
stress = accentare, accento
stretcher = barella
strict = severo
stride = passo
strike = battere, colpire, picchiare, fare sciopero, colpire
strike a balance = saldare
stroke = apoplessia, accarezzare
stroke of apoplexy = apoplessia
strong = forte
struggle = battaglia
stubborn = ostinato
student = studente
study = studiare
stupid = ignorante, sciocco, stupido
sty = stalla
subject to = eccetto, salvo
subject to tax = tassabile
subscriber = abbonato
subscription = abbonamento
subsequently = dietro, dopo
succeed = riuscire, succedere
success = successo
successor = discendente
such = così
such a = come
such as = come
suck = succhiare
suckle = allattare
sudden = subitaneo
suddenly = ad un tratto, improvvisamente
suffice = bastare
sufficient = sufficiente
sufficiently = abbastanza
suffix = suffisso
suffocate = soffocare
sugar = zucchero
suggest = indicare, mostrare, proporre
suggestion = suggerimento
suit = abito, costume
suitable = decente, conveniente, adatto, capace, idoneo, utilizzabile, utile
suitcase = valigia
sum = importo, somma
summer = estate
summery = sommario
summit = punta, cima
summon = chiamare
sun = sole
Sunday = domenica
sunrise = levar del sole
sunset = tramonto
superficial = basso
superior = superiore
superstition = superstizione
superstitious = superstizioso
supervise = controllare, verificare
supper = cena
supplication = domanda, preghiera
support = sostenere, poggiare, appoggiare
supporter = membro
supporters = partito, seguito
suppose = supporre
suppress = opprimere, soffocare
sure = certo
surface = cima, superficie
surgeon = chirurgo
surly = brusco, rude
surmise = supporre
surname = cognome
surprise = sorprendere, sorpresa
surrender = arrendersi
surround = circondare
surroundings = ambiente
suspect = sospettare
suspicion = sospetto
sustain = poggiare, appoggiare, sostenere
sustained = costante
swallow = rondine
swear = bestemmiare, giurare
sweat = sudare, traspirare
Swede = svedese
Sweden = Svezia
sweet = dolce
swiftly = presto
swim = nuotare, = imbroglio, inganno, truffa
swindling = imbroglio, inganno, truffa
swine = porco
Swiss = svizzero
switch = accendere, interruttore
Switzerland = Svizzera
swoon = svenirsi
system = sistema
table = tavolo
table-cloth = toviglia
tail = coda
tail-light = luce di posizione, fanale posteriore
tailor = sasta, sarto
take = accettare, accogliere, occupare, prendere
take action = agire
take away = ritirare
take down = demolire
take in = accettare, accogliere
take into account = considerare
take leave = dire addio
take leave from = dire addio
take note = constatare
take off = togliere
take over = comperare, comprare
take part = spartire
take the place of = rilevare
taking = acquisto, compra
taking over = acquisto, compra
talent = ingegno, talento
talented = dotato
talk = parlare
tall = alto
Tangier = Tangeri
tap = origliare
tape-recorder = registratore
tar = catrame
tardy = tardo
target = proposito, scopo
tart = acido, agro
task = compito
taste = gustare, gusto
tattler = chiacchierone
tax = tassare, contribuzione, imposta, tassa
tea = tè
teach = insegnare, instruire
teacher = maestra, maestro
tea-pot = teiera
tear = lagrima
tear off = rompere, staccare
tease = irritare
teeth = dentatura, denti
tell = dire, raccontare
tell a lie = mentire
telltale = chiacchierone
temper = umore
tempest = tempesta
temple = tempia
ten = dieci
tender = dolce, presentare, proporre
tend to = curare
terminate = finire, terminare
terrestrial = terrestre
terrible = terribile
territory = teritorio
test = esame, provare
testimony = certificato attestato
Thailand = Tailandia
Thames = Tamigi
than = che, di
thank = ringraziare
thankful = grato, riconoscente
thankless = ingrato
thanks = grazie
that = che, così
that is = cioé
that much = tanto
that way = così, là, lì
thaw = sgelare
the = i, il, gli, la, le, lo
the Antarctic = Antartico, Antartide, Polo Sud
the Arctic = Artico
theatre = teatro
the day after tomorrow = dopodomani, posdomani
the day before yesterday = ieri l'altro
thee and thou = dar del tu a
theft = furto
The Hague = L'Aia
their = di loro
then = dopo, in seguito, poi, allora
thence = di là
the Netherlands = Olanda
there = là, lì, laggiú
thereafter = dopo, in seguito, poi
therefore = perciò, per quésto
these days = oggigiorno
they = essi
thick = denso, grosso, spesso
thief = ladra, ladro
thigh = coscia
thin = magro, sottile
thing = cosa, ogetto
think = pensare
think ahead = anticipare
think well of = rispettare, stimare
third = terzo
thirst = sete
thirteen = tredici
thirty = trenta
this evening = stasera
this morning = stamattina
this way = quà, qui
thither = là, lì
thorn = spina
thou = tu, voi
though = benche, sebbene
thought = pensiero
thousand = mille
thread = filo
threat = minaccia
threaten = minacciare
three = tre
three times = tre volte
thresh = trebbiare
threshold = soglia
thrice = tre volte
throat = gola, gorga
through = finito, terminato, completamente, mediante, per mezzo di, pronto, attraverso
throw = gettare
throw up = vomitare
thrust = spingere
thumb = pollice
thunder = tuonare, tuono
Thursday = giovedì
thus = così
thwart = rendere difficile
ticket = biglietto
ticket-window = sportello
tie = cravatta, legare, legame
tie up = legare
tiger = tigre
timber = legno
time = tempo
time-table = orario
timid = angoscioso, pauroso
tin = latta, stagno
tin plate = latta
tip = punta, mancia
tire = gomma
tired = stanco
tired out = esausto, sfinito
tire out = affaticare, stancare
to = a
toad = rospo
today = oggi
toe = dito del piede
together = insieme
toilet = cesso, gabinetto, ritirata
toilet-paper = carta igienica
token = prova, segno
tolerate = sopportare, tollerare
tomato = pomodoro
tomorrow = domani
tomorrow evening = domani sera
tomorrow morning = domattina
tongs = pinzette
tongue = lingua
too = anche, troppo
tool = arnese, strumento
too much = troppo
top = cima
topgallant mast = scardola
topical = attuale
torch = fiaccola, torcia
torture = torturare
torturer = boia
touch = toccare
touch lightly on = menzionare
touch on = menzionare
toward = a
towards = a, intorno a
towel = asciugamano
tower = torre
town = città
town-hall = municipio
township = paesello
toy = giuocattolo
trace = delimitare
trace out = delimitare
trade = commercio, mestiere
train = treno
tram = tram
tranquil = calmo, tranquillo
transfer = attraversare
transformation = cambiamento
translate = tradurre
translation = traduzione
transmit = mandare
transparant = trasparente
transport = trasportare, trasporto
travel = camminare, viaggiare
treat = guarire, trattare
treatment = trattamento
treaty = trattato
tree = albero
tree-trunk = tronco
tremble = tremare
triangle = triangolo
trick = abitudine, vizio
tricycle = triciclo
trifle = inezia
trip = viaggio
trite = banale, trito e ritrito
triumph = vittoria
trouble = problema, disturbare
trousers = calzoni, pantaloni
trout = trota
truck = autocarro, camion, autocarro, camion
true = vero
truly = davvero, infatti
trumpet = tromba
trunk = tronco, baule
trust = fiducia
truth = verità
try = provare
tube = condotto, valvola
Tuesday = martedì
tug = tirare, rimorchiatore
tugboat = rimorchiatore
tummy = ventre
tummy ache = mal di pancia
tuna = tonno
tuna-fish = tonno
tune = adattare, aggiustare, sintonizzare
tunny = tonno
Turin = Torino
Turk = turco
turn = svoltare, rovesciare, girare
turnip = rapa
turn on = accendere
turn over = rovesciare
turn to good account = impiegare
tussle = combattere, duellare, picchiarsi
Twelfth-night = Befana, Epifania
twelve = dodici
twenty = venti
twice = due volte
twilight = crepuscolo
twin = gemelli
two = due
type = scrivere a macchina
typewriter = macchina da scrivere
tyrant = tiranno
tyre = gomma
Tyrrhenian Sea = Mar Tirreno
ultimately = alla fine, finalmente
umpire = arbitro
uncle = zio
unconscious = privo di sensi, svenuto
uncover = scoprire
under = sotto
underhand = di nascosto
underneath = sotto, dabbasso, giú
underpants = mutande
understand = capire, comprendere
understandable = comprensibile
undoubtedly = si capisce
unfaithful = infedele
unfortunately = per fortuna, per sfortuna
ungrateful = ingrato
unhappy = infelice
unique = solo, unico
unite = congiungere
United States of America = America, Stati Uniti
unity = unità
universal = universale
university = università
unkind = brusco, rude
unknown = sconosciuto
unlearn = perdere l'abitunide di, disimparare
unpleasant = brusco, rude
unthankful = ingrato
upon = contro
upper-arm = omero
upper arm = omero
upset = confuso, turbato, rovesciare
upstairs = di sopra
up-to-date = attuale
urinate = orinare, pisciare
Uruguay = Uruguai
USA = America, Stati Uniti
US citizen = americano
use = impiegare, usare, impiego, uso
used to = consueto, usuale
useful = utile
use up = logorare
usual = consueto, usuale, generale
utilize = sfruttare, impiegare
vain = vanitoso
valise = valigia
valley = valle
value = valore
valve = valvola
van = furgone
variable = variabile
variation = variazone
variety = variazone
Vatican City = Città del Vaticano
veal = carne di vitello
vegetable = legume
vein = vena
vend = vendere
Venetia = Venezia
vengeance = vendetta
Venice = Venecia
ventilate = aerare, arieggiare, ventilare
venture = arrischiare
Venus = Venere
verify = controllare, verificare
very = assai, molto
very much = assai, molto
vessel = cassa, tinozza, vaso
veterinarian = veterinario
vicar = curato
vice = virtú
victory = vittoria
Vienna = Vienna
Vietnam = Vietnam
view = apparenza, aria, aspetto, vista, guardare
vigour = forza
village = villaggio
vine = vigna, vite
vinegar = aceto
violate = aggredire, assalire
viper = vipera
visit = visitare, visita
vixen = megera
vocabulary = dizionario
voice = voce
void = vuoto
volume = tomo, volume
vomit = vomitare
vote = votare, voce
voyage = viaggio
vulgar = volgare
wage = paga, salario
wager = scommettere
wages = paga, salario
waggon = vagone, vettura
wait = aspettare
waiter = cameriere
wait for = aspettare
waiting = servizio
waiting-room = sala d'aspetto
waiting room = sala d'aspetto
Wales = Galles
walk = camminare
wall = muro,. parete
walnut-tree = noce
want = bisogno, fabbisogno, desiderio, volere
wanton = scatenato, sfrenato
war = guerra
warm = caldo
warn = avvertire
warning = avviso
warrant = garanzia
wash = lavare
wasp = vespa
waste product = sottoprodotto
watch = orologio, guardare
watchmaker = orlogiaio
watch out for = aspettare, attendere
water = acqua, annaffiare, bagnare, innaffiare
waterfall = cascata
wave = onda
waver = esitare, titubare
way = costume, maniera, modo, cammino, corsia, pista, strada, via
way out = uscita
weak = debole
weaken = debilitare
wealth = ricchezza
wealthy = ricco
weapon = arma
wear = portare
wear out = logorare
weather = tempo
Wednesday = mercoledì
week = settimana
weekly = settimanalmente
weep = piangere
weigh = pesare
weight = peso
welcome = bene arrivate, benvenuto
well = bene
well-known = conosciuto, noto
well-mannered = cortese
well-off = ricco
wench = piccola, ragazza
west = ovest
wet = bagnato
whale = balena
whalebone = osso di balena
wharf = piattaforma
what a = come
what's more = d'altronde, inoltre
wheat = frumento
wheel = ruota
wheeziness = asma
when = quando
whereas = durante
while = durante, tempo
whilst = durante
whiskers = baffi
whisper = bisbigliare, sussurrare
whistle = fischiare
white = bianco
whole = completo, intero, totale, tutto
width = larghezza
wife = moglie
wild = selvaggio
wild boar = cinghiale
will = volontà
willingly = volentieri
willingness = volontà
willow = salcio, salice
win = guadagnare
wind = vento
window = finestra, sportello
wind up = caricare
wine = vino
wing = ala
winter = inverno
wire = filo
wireless = radio
wisdom = freccia
wise = saggio
wish = desiderare, desiderio, volere, volontà
with = mediante, per mezzo di, a, su
within = a, dentro
without delay = direttamente
without prejudice = eccetto, salvo
withstand = far fronte a, opporsi a
with young = incinta
witty = spiritoso
wolf = lupo
woman = donna
wonder = stupirsi
wonted = consueto, usuale
wood = legno
woods = bosco
word = parola
work = lavorare, lavoro, opera
worker = operaio
working man = operaio
workman = operaio
work out = calcolare
world = mondo
worldwide = universale
worm = verme
worn-out = trito e ritrito
worn out = esausto, sfinito
worship = adorare, venerare
worship service = uffizio divino
worth = valore
wound = ferire
wrap up = avvolgere
wrench = chiave
wrest = estorcere
wretched = miserabile, misero, povero
wring = estorcere
wrist = polso
write = scrivere
writer = autore
writing-desk = banco, scrivania
writing desk = banco, scrivania
Xanthippe = megera
yard = cortile
yawn = sbadigliare, sbadiglio
ye = tu, voi
year = anno
yearly = annuale,. annualmente
yellow = giallo
yes = sì
yesterday = ieri
yet = ancora, già
yield = cedere
yon = laggiú
yonder = là, lì, laggiú
you = tu, voi
young = giovane
your = tuo, vostro
Yugoslavia = Iugoslavia
Yule = Natale
zeal = ardore, zelo
ZIP code = CAP, codice di avviamento postale
zodiac = zodiaco
zone = cintura
zoo = giardino zoologico
Zurich = Zurigo