#setName = words_en_de_u
#sideOneTitle = ENG
#sideTwoTitle = GER
udder = Euter
ugly = häßlich
Ukraine = Ukraine, die Ukraine
ulcer = Geschwür
ultimately = endlich
ultimatum = Ultimatum
umbrella = Regenschirm
un- = un-
unanimous = einig
uncle = Onkel
unclean = unlauter
uncover = abdecken, entdecken, enthüllen
under = unter, unterhalb
underground = unterirdisch
underline = unterstreichen
underneath = unter, unten, unterhalb, hinunter, nach unten, unterwärts
underpants = Unterhose
understand = begreifen, erfassen, verstehen
understandable = begreiflich, faßbar, verständlich
understanding = Verhältnis, Zusammenhang
undertake = unternehmen, veranstalten, sich anstrengen, sich bemühen, trachten nach
undoubtedly = zweifelsohne
undress = Negligé, entkleiden
undue = übermäßig, überschwenglich, übertrieben
undulate = wallen, wogen
unemployment = Arbeitlosigkeit
unfaithful = treulos
unfortunately = bedauerlich, leider
ungrateful = undankbar
unhappy = unglücklig
unicorn = Einhorn
uniform = Uniform, einförmig
unilateral = einseitig
unimportant = unbedeutend
unique = einzig
unit = Einer, Einheit
unite = fügen, gesellen, einigen, vereinigen
United States of America = Vereinigten Staaten
unity = Einigkeit, Einheit
universal = universal
universe = Universum, Weltall
university = Hochschule, Universität
unkind = brummig, unwirsch
unlearn = abgewöhnen
unleavened bread = ungesäuertes Brot
unload = ausladen
unlock = aufschließen
unpack = auspacken
unpleasant = brummig, unwirsch
unthankful = undankbar
untidy = struppig
untie = entbinden
until = bis
untroubled = heiter, ungetrübt
untrue = falsch
up = aufwärts, empor, herauf, hinauf, nach oben
uphill = aufwärts, empor, herauf, hinauf, nach oben
upholster = polstern
upon = um, gegen, gegenüber, wider, anbelangt, betreffend, über, von, an, auf
upper = Ober-, obere, oberer, oberes
upper-arm = Oberarm
upper arm = Oberarm
upper hand = Überlegenheit, Übermacht
upset = bestürtzt, unpäßlich, kappen, umstoßen, umstürzen, umwerfen
upsilon = Ypsilon
upstairs = oben
up-to-date = aktuell, gegenwärtig
upwards = aufwärts, empor, herauf, hinauf, nach oben
urban = städtisch
urchin = Bube, Bursche
urge = anspornen, antreiben, aufhetzen, herausfordern, drängen, pressieren
urgency = Andrang
urge on = antreiben, anfeuern
urinate = harnen
urine = Harn, Urin
us = uns
USA = Vereinigten Staaten
US citizen = Amerikaner
use = anwenden, benutzen, brauchen, gebrauchen, verwenden, verwerten, Benutzung, Gebrauch
used to = geläufig, üblich
useful = nützlich, vorteilhaft, zweckdienlich
useless = nutzlos, vergebens, vergeblich
use up = abnutzen, aufzehren, konsumieren, verbrauchen, zehren, verzehren
USSR = Sowjetunion
usual = geläufig, üblich, gewöhnlich, allgemein
usurp = ursurpieren
uterus = Gebärmutter, Uterus
utilize = ausbeuten, ausnutzen, exploitieren
utopian = utopisch
Utrecht = Utrecht
utter = ausschließen, aussondern
vacation = Ferien
vain = vergebens, vergeblich, eitel, hinfällig
valerian = Baldrian
valiant = beherzt, dreist, getrost, mutig, tapfer
valid = rechtsgültig, valid
valise = Handkoffer, Felleisen
valley = Tal
valuable = gültig, wertvoll
value = Bedeutung, Geltung, Wert
valve = Klappe, Ventil
vampire = Vampir, Vampyr
vandal = Vandale
vanilla = Vanille
vanity = Eitelkeit
vapor = Dampf
vapour = Dampf
varied = divers, verschieden
variety = Variation
various = divers, verschieden
varnish = firnissen, lacken
vase = Behälter, Gefäß, Vase
vaseline = Vaselin, Vaseline
vast = ausgedehnt, geräumig, weit
vat = Bottich, Bütte, Wanne, Zober, Zuber
Vatican = Vatikan
veal = Kalbfleisch
vegetable = Gemüse
vegetarian = vegetarianisch
vegetate = vegetieren
vehicle = Fuhrwerk, Gefährt, Wagen
veil = beschleiern, verhüllen, verschleiern, Schleier
vein = Ader, Vene
velvet = Sammet
vend = veräußern, verkaufen
vengeance = Rache
Venice = Venedig
ventilate = lüften, ventilieren
ventilator = Ventilator
venture = riskieren, wagen
Venus = Venus
veranda = Veranda
verb = Verb, Verbum, Zeitwort
verbatim = wörtlich
verdict = Verdikt, Wahrspruch
verify = kontrollieren, nachsehen, überwachen
vermouth = Wermut
verse = Strophe, Vers
vertebra = Wirbel, Wirbelbein, Wirbelknochen
vertical = senkrecht, vertikal
verve = Begeisterung, Schwung, Verve
very = sehr
very much = sehr
vessel = Besteck, Krug, Behälter, Gefäß, Vase, Schiff
vest = Unterhemd, Weste
Vesuvius = Wesuwe
vetch = Wicke
veteran = Veteran
vex = ärgern, bekümmern, betrüben, kränken, Kummer bereiten, verdrießen
vibrate = schwirren, vibrieren
vibration = Vibration, Vibrieren
vice = Tugend
vice-president = Vizepräsident
vicious = arg, arglistig, boshaft, hämisch, tückisch, heimtückisch
victory = Sieg
Vienna = Wien
Viennese = Wiener
view = Aspekt, Aussicht, Panorama, anblicken, ansehen, blicken, schauen, zuschauen, zusehen, Anblick, Ansicht, Übersicht, Aussehen, Gesicht, Sehen, Sicht
viewpoint = Standpunkt
vigour = Gewalt, Kraft
vile = gemein, infam
village = Dorf, Ort
villager = Dörfler
vine = Weinberg, Rebe, Weinstock
vinegar = Essig
viola = Bratsche
violate = ein Anschlag ausführen, ein Attentat ausführen, vergewaltigen
violet = Veilchen
violin = Fiedel, Geige, Violine
violoncello = Baßgeige
viper = Natter, Kreuzotter, Viper
virgin = jungfräulich, rein, unberührt, Jungfrau
virginal = jungfräulich, rein, unberührt
virtue = Solidität
virtuoso = Virtuos, Virtuose
visa = Visa, Visum
visé = Visa, Visum
visible = augenscheinlich, bemerkbar, ersichtlich
vision = Erscheinung, Gesicht, Vision
visit = besuchen, einen Besuch abstatten, Besuch, Visite
vivacity = Begeisterung, Schwung, Verve
vixen = Megäre, Weib, Füchsin
viz. = zwar
vocabulary = Wörterbuch
voice = Stimme
void = leer
volcano = Vulkan
Volga = Wolga
volley = Strom
Volt = Volt
volume = Band, Volumen
voluntary = freiwillig
vomit = sich brechen, sich erbrechen, sich übergeben
vote = ballotieren, votieren
vowel = Vokal
voyage = Reise, Tour
vulgar = trivial, üblich, verständlich, vulgär
vulture = Geier
wadding = Watte
wade = waten
waffle = Waffel
wage = Gage, Gehalt, Salär
wager = wetten, Wette
wages = Gage, Gehalt, Salär
wage war = kriegen, Krieg führen
wage war against = bekriegen
wage war on = bekriegen
waggon = Bahnwagen, Wagen, Wagon, Waggon
wail = jammern, lamentieren
wainscot = Paneel
waist = Taille
waistcoat = Weste
waistline = Taille
wait = gewärtigen, harren, warten, erwarten
waiter = Kellner
wait for = gewärtigen, harren, warten, erwarten
waiting = Bedienung, Dienst
waiting-room = Warteraum, Wartesaal
waiting room = Warteraum, Wartesaal
wake = wecken, aufwecken, erwecken, aufwachen, erwachen
wake up = wecken, aufwecken, erwecken, aufwachen, erwachen
Wales = Wales
walk = gehen, laufen, marschieren, treten, Marsch, Tritt, Spaziergang, besteigen
walk upon = besteigen
wall = Mauer, Wand
wall covering = Tapete
wallet = Börse
Wallonia = Wallonien
walnut = Walnuß
walnut-tree = Nußbaum
waltz = Walzer
wand = Gerte, Rute
wander = wandern, bummeln, herumschweifen, irren, streifen, umherstreifen, vagieren
wander about = wandern
want = Bedarf, Bedürfnis, Begehr, Lust, Wunsch, wollen
wanton = aufrührerisch
war = Krieg
warehouse = Geschäft, Kaufladen, Magazin, Warenhaus, Lagerhaus
wares = Ware
warlock = Zauberer
warm = warm
warmth = Wärme
warn = warnen
warning = Warnung
warrant = bürgen, Gewähr leisten, haften, verbürgen, Garantie, Gewähr
Warsaw = Warschau
wart = Warze
wash = spülen, abbeuchen, waschen
washing-accomodation = Waschanstalt
wash-place = Waschanstalt
wash-room = Waschanstalt
wash up = aufwaschen
wasp = Wespe
waste = Ausschuß, vergeuden, verschwenden
watch = Uhr, anblicken, ansehen, blicken, schauen, zuschauen, zusehen
watchmaker = Uhrmacher
watch out for = achtgeben, aufpassen, beachten, zusehen
watch over = hüten, behüten, bewachen, überwachen
watchword = Devise, Wahlspruch
water = Wasser, besprengen
water-bottle = Feldflasche
water-colour = Aquarell
waterfall = Kaskade, Wasserfall
water-melon = Wassermelone
watt = Watt
wave = Welle, Woge, schlingen, schwingen
wave about = schlingen, schwingen
waver = taumeln, wackeln, zagen, zaudern, zögern
wax = Wichse, Wachs
wax candle = Wachskerze
way = Angewohnheit, Brauch, Gebrauch, Gepflogenheit, Gewohnheit, Usus, Art, Manier, Weise, Bahn, Chaussee, Strecke, Weg
way out = Ausgang
weak = flau, gelinde, schwach
weaken = verdünnen, erschlaffen
wealth = Reichtum
wealthy = ausgiebig, reich, vermögend
wear = tragen
weasel = Wiesel
weather = Wetter, Witterung
weave = weben, wirken
weaver-bird = Reisvogel
wed = heiraten
wedding = Hochzeit
wedding-feast = Hochzeit
wedding-party = Hochzeit
wedge = Keil
Wednesday = Mittwoch
weed = jäten, ausjäten
weed out = jäten, ausjäten
week = Woche
weep = tränen, weinen
weigh = wägen, abwägen, schwer sein, wiegen
weight = Gewicht, Wucht
weightlessness = Gewichtslosigkeit, Leichtigkeit
welcome = bewillkommen, willkommen heißen
well = nu, nun, nun wohl, Brunnen, gesund, heil
well-being = Wohl, Wohlsein, Wohlfahrt, Wohlstand
well-beloved = Geliebte
well-informed = gebildet, gesittet
well-known = bekannt
well-mannered = artig, galant, höflich
well-off = ausgiebig, reich, vermögend
well then = nu, nun, nun wohl
well-to-do = wohlhabend
wench = Dirne, Mädchen
Weser = Weser
west = Abendland, Okzident, Westen
western = westlich
wet = naß, befeuchten, wässern
whale = Walfisch
wharf = Bahnsteig, Kai
what = was, was
what a = was für ein, welch, als, wie, inwiefern
what for = aus welchem Grunde, warum, woher, weshalb, weswegen
what kind of = welch, was für ein, welch
what's more = außerdem, übrigens, zudem
what sort of = welch, was für ein, welch
wheat = Weizen
wheel = Rad
wheelbarrow = Karre
wheeziness = Asthma
wheezy = asthmatisch, engbrüstig
when = wann, als, wann, wenn, als, wann, wenn
whence = woher
where = wohin, wo, woselbst
whereas = während
whereby = wodurch, womit
wherefore = weshalb, weswegen
wherein = worin
where ... to = wohin
which = wen, wen, wer, das, der, die, welche, welcher, welches, wer
which one's = deren, dessen, wessen
while = während, Zeit
whilst = während
whim = Eigensinn, Kaprize, Laune
whimstone = Basalt
whip = quirlen, geißeln, stäupen, kasteien, peitschen, Gerte, Peitsche
whipped cream = Schlagsahne
whirl = quirlen
whiskers = Backenbart
whiskey = Whisky
whisky = Whisky
whisper = flüstern
whist = Whist
whistle = pfeifen, Pfeife
white = weiß
white man = Europäer
whiten = bleichen, weißen
whither = wohin
Whitsunday = Pfingsten
who = wer, wen, wen, das, der, die, welche, welcher, welches, wer
whole = ganz, total, Ganze, Gesamtheit
wholesale = engros
wholly = ganz, gänzlich, gar
whom = wem
whose = deren, dessen, wessen
why = warum, aus welchem Grunde, warum, weshalb, weswegen, woher, weshalb, weswegen
wick = Docht
wide = ausgedehnt, geräumig, weit
widely = breit
widow = Witwe
widower = Witwer
width = Breite
wife = Frau, Gemahlin
wig = Perücke
wild = wild
wild boar = Eber, Wildschwein
will = Testament, Vermächtnis, Wille
willing = willig
willingly = bereit, bereitwillig, gern
willingness = Wille
willow = Weide
willowherb = Feuerkraut
win = erringen, gewinnen
wind = Wind, einwickeln, rollen, wickeln
wind around = sich schlängeln
windlessness = Windstille
window = Fenster, Schalter, Schalterfenster, Schiebefenster
window-glass = Fensterscheibe
wind up = hissen, aufziehen, spannen, anspannen, ausspannen, straffen, rollen, wickeln
wine = Wein
wing = Fittich, Flügel
win over = bewältigen, meistern, bemeistern, siegen, besiegen, überwinden
winter = Winter-, winterlich
winter- = Winter-, winterlich
wipe = wischen
wipe off = wischen
wipe out = austilgen, ausrotten, tilgen, vertilgen
wire = Draht
wireless = Radio
wisdom = Weisheit, Klugheit
wise = gescheit, klug, weise
wisent = Wisent
wish = wünschen, Begehr, Lust, Wunsch, wollen, Wille
wit = Geist
witch = Hexe
witchcraft = Zauber, Zaubern
with = in Begleitung von, zusammen mit, zuzüglich, durch, kraft, mit, mittelst, vermittels, an, bei, zu
withdraw = zurückziehen
wither = welken, verwelken
within = in, nach, pro, zu
with one accord = einhellig
without = ohne
without a name = anonym
without delay = gleich, sogleich
without fail = absolut, ausdrücklich, durchaus, unausbleiblich, unfehlbar
with reference to = betreffs, bezüglich
with young = trächtig, schwanger
witness = Zeuge
witticism = Witz
witty = geistreich, sinnreich, witzig
wizard = Zauberer
wizardry = Zauber, Zaubern
Wodan = Wotan
Woden = Wotan
woe = weh, wehe
wolf = Wolf
woman = Frau, Weib
womb = Gebärmutter, Uterus
wonder = sich wundern, staunen, erstaunen, Aufsehen, Verwunderung, Wunder
wonderful = wunderbar
wonted = geläufig, üblich
woo = den Hof machen, poussieren
wood = Holz
wooden cloth = Tuch
woodpecker = Specht
woodpile = Scheiterhaufen
woods = Forst, Wald
wool = Wolle
word = Vokabel, Wort
word-for-word = wörtlich
work = arbeiten, Arbeit, Werk
workbench = Arbeitsbock, Bank, Gestell, Staffel, Staffelei, Werkstuhl
worker = Arbeiter
working man = Arbeiter
workman = Arbeiter
work out = ausarbeiten, erachten, kalkulieren, rechnen, berechnen
workplace = Atelier, Werkstatt
workshop = Atelier, Werkstatt
world = Welt
worldglobe = Erdball, Erdkugel
worldwar = Weltkrieg
worldwide = universal
worm = Wurm
worry = Sorge tragen, sorgen, ärgern, bekümmern, betrüben, kränken, Kummer bereiten, verdrießen
worship = anbeten, verehren, vergöttern
worshipper = Verehrer
worship service = Gottesdienst
worth = Bedeutung, Geltung, Wert
worthless = wertlos
worthy = wert, würdig
worthy = -wert
wound = verletzen, verwunden, Verwundung, Verletzung, Wunde
wounded = wund
wrapper = Banderole, Papierstreifen, Streifen
wrapping-paper = Umschagpapier
wrap up = packen, einpacken
wreath = Gewinde, Girlande, Guirlande
wreathe = flechten, schlingen, winden
wrench = Schlüssel
wrest = erzwingen
wrestle = ringen
wretched = elend, erbärmlich, jämmerlich
wring = erzwingen
wrinkle = Falte, Furche, Runzel
wrist = Handgelenk
write = schreiben, abfassen, verfassen
write down = in Mißkredit bringen, anmerken, aufschreiben, aufzeichnen, notieren
writer = Schriftsteller, Verfasser
writhe = sich sträuben, zappeln
writing = Handschrift
writing-paper = Briefpapier
written = Schrift-, schriftlich
wrong = falsch, irrig, verkehrt
Xanthippe = Megäre, Weib
xylophone = Xylophon
Y = Ypsilon
y = -ei
yacht = Jacht, Yacht
yam = Yamswurzel
yard = Hof, Hofraum
yawn = Gähnen
ye = Sie, du, ihr
year = Jahr
year-book = Almanach
yearly = jährlich, alljährlich
yearn = sich ersehnen, sich sehnen
yell = heulen, zetern
yellow = gelb
yes = ja, doch
yesterday = gestern, gestrig
yet = noch, bereits, schon, aber, doch, dennoch, jedoch
yew-tree = Eibe, Taxus
yield = abtreten, nachgeben, weichen
yoke = Joch
yon = da, dort
yonder = dahin, dorthin, hierhin, nach dort, da, dort, das, der, die, derjenige, jener
you = euch, dir, euch, Ihnen, dir, euch, Ihnen, man, dich, euch, Sie, ihr, Sie, Sie, du, ihr
young = jugendlich, jung
young of a wild boar = Frischling
youngster = Jüngling
young woman = Jungfrau
your = dein, deinig, euer, eurige, Ihr, ihrige
yours = das deine, die deine, der deine, der euere, der Ihre
youth = Jugend, Jüngling
Yugoslavia = Jugoslawien
Yule = Weihnachten
zeal = Eifer, Inbrunst
Zealand = Seeland
zealous = eifrig
zebra = Zebra
zenith = Zenit
zephyr = Zephyr
zero = Null
Zeus = Zeus
zigzag = im Zickzack gehen, im Zickzack verlaufen
zilch = Null
zinc = Zink
zirconium = Zirkonium
zither = Zither
zodiac = Tierkreis, Zodiakus
zone = Zone
zoologist = Zoologe
zoology = Zoologie
Zurich = Zürich