#setName = longlist_en_pl
#sideOneTitle = ENG
#sideTwoTitle = POL
a = w, ktos, po
abandon = opusciæ
abashed = zazenowany
abbreviate = skróciæ
aberration = blad, pomylka
abide = czekaæ, przebywaæ, cierpieæ, doczekaæ siê
abiding = trwaly
abjure = odebraæ
able = zdolny
abode = mieszkanie
abortive = daremny
about = odnosnie, o, wokól, dookola, okolo
above = na górze, u góry, do góry, w górê
above all = zwlaszcza, szczególnie
above-board = uczciwy, szczery
abrasive = ostry
abridge = skróciæ
abroad = za granica
absence = brak
absent = nieobecny
absent onself = usunaæ
absolute = absolutny, bezwzglêdny
absolutely = rzeczywiscie, koniecznie
absorb = dysponowaæ
abstract = powstrzymywaæ, zabraæ
abstruse = tajemniczy
abuse = obrazaæ, zamêczaæ
abysmal = okropny, straszny
academic = student
academy = uczelnia, szkola wyzsza
accede = zgadzaæ siê
accept = przyjmowaæ
accidence = przypadek
accident = wypadek
accidental = dodatkowy
accommodation = urzadzenie, impreza, mieszkanie
accomodate = koñczyæ, pomagaæ
accompany = towarzyszyæ, odprowadzaæ
accomplish = osiagaæ, uzyskaæ, urzeczywistniaæ, zrealizowaæ, wykonaæ, spelniæ
accomplished = doswiadczony
accomplishment = wykonanie, spelnienie
accord = pozwalaæ
according as = wedlug
accordingly = wiêc, przeto, to, przeto, wiêc, zatem
according to = wedlug
accordion = harmonijka
account = konto, wierzyæ, mniemaæ, sadzieæ
account for = wyjasniaæ
accredit = wierzyæ
accrue = rosnaæ, rósæ, zwiêkszyæ siê
accumulation = masa
accurate = akuratny, punktualny, dokladny, precyzyjny
accustom = mieæ zwyczaj, byæ w zwyczaju
acerbic = ostry
ache = boleæ, dolegaæ, ból
achievable = realizowalny
achieve = osiagaæ, uzyskaæ, urzeczywistniaæ, zrealizowaæ, robiæ, czyniæ, wykonaæ, spelniæ
achievement = sukces, powodzenie
acid = ostry
acknowledge = wyznawaæ, przyznawaæ siê
acknowledgement = wyznanie, przyznanie siê
acquaint = informowaæ, zawiadomiæ
acquaintance = znajomy
acquire = kupiæ
acquirement = osiagniêcie
acquisition = kupno, zakup
acquittal = wykonanie, spelnienie
acrid = ostry
acrimonious = ostry
across = po drugiej stronie, poprzez
across from = przeciw, naprzeciw, w zamian
act = robiæ, czyniæ, wplywaæ, przedstawiaæ
activate = powodowaæ, sprawiaæ
active = pracowity
activity = zajêcie
actor = aktor
act out = urzeczywistniaæ, zrealizowaæ
actual = realny, rzeczywisty
actually = rzeczywiscie, faktycznie
actuate = ruszaæ
acute = ostry
ad = ogloszenie
adage = przyslowie
Adam = Adam
add = dodawaæ
addition = dodawanie
additional = dodatkowy
addled = glupi
address = adres
add up = dodawaæ
adept = doswiadczony
adieu = zegnaj
adjourn = odkladaæ, przesuwaæ
adjustment = urzadzenie, impreza
administration = rzad
admiration = podziw
admire = podziwiaæ
admission = wyznanie, przyznanie siê
admit = dopusciæ, wyznawaæ, przyznawaæ siê, pozwalaæ
adorn = ozdabiaæ
advantage = zaleta, korzysæ
adversary = przeciwnik, nieprzyjaciel
adverse = przeciwny
advert = uwazaæ, zwracaæ uwagê
advertisement = ogloszenie
aerodrome = lotnisko
aeroplane = samolot
a few = jacys, kilka, kilkoro
affable = uprzejmy
affair = sprawa, afera
affect = wplywaæ
affection = milosæ
affix = umocowaæ, ustaliæ
affluent = bogaty
afford = pozwalaæ
afoot = piechota
afresh = znowu, ponownie, od nowa
after = potem, za
afternoon = popoludnie
afterwards = potem
again = znowu, ponownie, od nowa
against = przeciw, naprzeciw, w zamian
age = wiek
agent = narzêdzie, instrument, przyrzad
agitate = potrzasaæ
agitated = zdenerwowany
agog = zaciekawiony
agonize = zamêczaæ
agree = uzgodniæ, zgadzaæ siê
agreeable = mily, przyjemny
agreement = zgoda
ague = goraczka
ahead = przedtem, na przodzie
aid = pomagaæ, pomoc
ailment = choroba
aim = cel, staraæ siê
aimless = bezcelowy
air = powietrze
aircraft = samolot
airdrome = lotnisko
airfield = lotnisko
airplane = samolot
airport = lotnisko
ajar = otwarty
alacrity = entuzjazm
alas = niestety
album = album
ale = piwo
Algeria = Algieria
Algiers = Algier
alien = przeciwny
a little = trochê, iles, troszeczkê
all = wszelki, wszelaki, wszystko, kazda ilosæ, wszyscy
all about = wszêdzie
all of it = kazda ilosæ
all over again = znowu, ponownie, od nowa
allow = zostawiæ, pusciæ, pozwalaæ
all the = kazdy
all the more = tym bardziej
all the time = tymczasem
almond = migdal
almost = prawie, niemal
alone = sam
a long time = dlugo
a lot = duzo
alphabet = alfabet, abecadlo
already = juz
also = takze, tez, równiez
altar = oltarz
although = choæ
altitude = wysokosæ
altogether = wszystko
always = zawsze
amaze = zadziwiaæ
American = Amerykanin
among = miêdzy
amount = suma, ilosæ
amphitheatre = amfiteatr
amusing = zabawny
and = i, a, oraz, zas
anew = znowu, ponownie, od nowa
angel = aniol
anger = pasja
angina = angina
angle = róg, kat
angry = rozgniewany
animal = zwierzak, zwierzê
anniversary = rocznica
annotation = nuta, nota
another = inny
answer = odpowiadaæ, odpowiedz
anthem = piesñ
antibiotic = antybiotyk
antidote = odtrutka
Antony = Antoni
any = ktos, jacys, kilka, kilkoro
anybody = ktos
anything = cos
anyway = jakos
anywhere = gdzies
apart = osobno, oddzielnie, szczególnie
apart from = oprócz
apparently = oczywiscie, pozornie
appear = pojawiaæ siê, wygladaæ, mieæ wyglad, zdawaæ siê
appear to be = zdawaæ siê
appellation = nazwa, nazwisko, imiê
apple = jablko
apple-tree = jabloñ
appraise = oceniaæ
appreciate = lubiæ, ceniæ
approach = zblizyæ siê
April = kwiecieñ
aptitude = talent
architect = architekt
architecture = architektura
archive = archiwum
archives = archiwum
argue = spieraæ siê
arise = urodziæ siê
arm = zbroiæ, uzbrajaæ, ramiê
army = armja, wojsko
around = wokól, dookola, okolo
arrange = urzadzaæ, organizowaæ, porzadkowaæ
arrangement = urzadzenie, impreza
arrival = przyjazd, wjazd
arrive = przyjechaæ, przyjsæ
art = sztuka
article = artykul, przedmiot, obiekt
article of clothing = ubranie
artist = artysta
as = gdy, kiedy, jak, wedlug, w ten sposób, poniewaz, bo
as a matter of fact = faktycznie
ascend = isæ w górê
ascertain = stwierdzaæ, konstatowaæ
as for the rest = zreszta
ashtray = popielniczka
Asian = Azjata
as if = niby, jakby
ask = pytaæ, prosiæ
ask for = prosiæ
ask forgiveness = przepraszaæ
assemblage = zebranie, konwent
assigned job = praca
assist = pomagaæ
as though = niby, jakby
at = ku, do, obok, po
at all = zupelnie
at first = poczatkowo
at last = w koñcu, koniec koñców
at least = przynajmniej
at long last = koniec koñców
atmosphere = nastrój
at most = najbardziej
at once = zaraz, natychmiast
at present = teraz, obecnie
at some time = kiedys
attach = umocowaæ, ustaliæ
attain = osiagaæ, uzyskaæ
attempt = staraæ siê, klopot, staranie, zabiegi, próbowaæ
attend = pielêgnowaæ, byæ obecni
attentively = uwaznie
at that place = tam
at the outset = poczatkowo
at the rate of = po
at the same time = jednoczesnie
attract = przyciagnaæ
August = sierpieñ
aunt = ciocia
authentic = autentyczny
author = autor, pisarz
autobus = autobus
automobile = auto, samochód
autumn = jesieñ
average = srodek
avoid = unikaæ
await = czekaæ, doczekaæ siê
away = precz
awfully = okropnie, strasznie
azalea = azalia
bachelor = kawaler
bad = zly
bad job = przykrosæ, nieuprzejmosæ
badly = zle
bag = worek, torba
bairn = dziecko
baker = piekarz
balcony = balkon
ball = bal
ballet = balet
ballpoint pen = dlugopis
banana = banan
bank = brzeg
banquet = bankiet, uczta, przyjêcie, biesiada
bar = przeszkoda
barber = fryzjer
barely = zaledwie
barracks = koszary
barrel = beczka
barrier = przeszkoda
bathe = kapaæ
bathroom = lazienka
bazaar = dom handlowy
be = byæ
be able to = móc
be absent = byæ nieobecnym
be acquainted with = znaæ
be afraid of = baæ siê
be ailing = chorowaæ
be alive = zyæ
beam = promieñ, radio
be angry = gniewaæ siê
bear = cierpieæ
be ashamed = wstydziæ siê
be asleep = spaæ
beast = zwierzê
beat = biæ
beautiful = piêkny, ladny
beautiful woman = slicznotka
beauty = piêknosæ, slicznotka
be aware of = mieæ swiadomosæ
be bold = osmieliæ siê
be bored = nudziæ siê
be born = urodziæ siê
because = poniewaz, bo
be closed = zamykaæ siê
become = stawaæ siê, zostaæ
become accustomed = przyzwyczaiæ siê
be conscious of = mieæ swiadomosæ
bed = lózko
beef = wolowina
beefsteak = befsztyk
beer = piwo
beet = burak
before = przed
be found = znajdowaæ siê
beg = prosiæ
begin = zaczynaæ
beginner = poczatkujacy
beginning = poczatek
be glad = cieszyæ siê, radowaæ siê
behave = zachowywaæ siê
behind = potem, za
behold = oto
be interested = interesowaæ siê
be in the habit of = mieæ zwyczaj, byæ w zwyczaju
be lacking = brakowaæ
be late = spózniaæ siê
believe = wierzyæ
be located = znajdowaæ siê
beloved = kochany
below = pod spodem, na spodzie
be married = wyjsæ za maz, ozeniæ siê
be missing = byæ nieobecnym, brakowaæ
beneath = pod
benefit = zaleta, korzysæ
be painful = boleæ, dolegaæ
be present = byæ obecni
be right = mieæ slusznosæ
Berlin = Berlin, Barlin
beseech = blagaæ
beside = obok
besides = zreszta, oprócz, oprócz tego, dalej
best = najlepszy
be succesful = prosperowaæ, powodziæ siê
be suitable = byæ zdatnym
be taken ill = zachorowaæ
be thirsty = byæ spragnionym
be tired of something = nudziæ siê
better = lepszy
between = miêdzy
beverage = napój
be willing to = chcieæ
be worth = byæ wartym
be worthy of = byæ wartym
beyond = po drugiej stronie, poprzez
bicycle = rower
bid = prosiæ
bide = doczekaæ siê
big = duzy
bike = rower
bill = bilet
bind = wiazaæ, laczyæ
binocular = lorneta
binoculars = lorneta
birch = brzoza
bird = ptak
birthday = urodziny
bishop = biskup
black = czarny
blame = przewinienie
blank = bialy, formularz
bleak = smutny, zimny
blind = slepy
block = blok
bloom = kwiat
blouse = bluzka
blueberry = borówka
blunt = tepy
blushing = czerwony
board of directors = zarzad
boat = lodz
body = cialo
bold = gruby
bomb = bomba
bonbon = cukierek
bon-bon = cukierek
bone = kosæ
book = ksiazka, zamawiaæ
bookcase = szafa na ksiazki
book-keeper = buhalter
bookshop = ksiêgarnia
bookstore = ksiêgarnia
border = brzeg
borrow = pozyczaæ
boss = szef, zwierzchnik, szefo
both = oba, obaj, oboje, obie
bother = krêpowaæ, przeszkadzaæ
bottle = butelka
bouquet = bukiet
boutique = sklep
bovine = byk, wól
bovine animal = byk, wól
box = slabo, pudelko, pojemnik, naczynie
boy = chlopiec
brave = dzielny, odwazny, smialy
bread = chleb
break = lamaæ, rwaæ
breakfast = sniadanie
bribe = przekupiæ
bridge = most
brief = krótki
bright = jasny
bring = przyniesæ
British = brytyjski
broad = szeroki
brother = brat
brown = brazowy, brunatny
brutal = nieuprzejmy
Budapest = Budapeszt
build = budowaæ
building = budowla, budynek
Bulgar = Bulgar
Bulgaria = Bulgaria
Bulgarian = Bulgar
bureau = biuro, urzad
burgomaster = soltys
burn = paliæ siê, spalaæ
burn down = spaliæ
bus = autobus
bush = krzak
business = sprawa, afera, handel
business deal = sprawa, afera
busy = zajêty
but = ale, lecz, jednak
butcher = rzeznik
butter = maslo
button = guzik
buy = kupiæ, kupno, zakup
by = obok, przez, do, wedlug, za pomoca
by accident = przypadkiem
by chance = przypadkiem, z okazji
bye = zegnaj, do widzenia
by fours = we czworo
by means of = za pomoca
by no means = w zaden sposób
by now = juz
by twos = we dwoje
cabin = chata
cabinet = szafa
café = kawiarnia
cake = ciasto
calculate = liczyæ
call = nazwaæ, wynmieniæ, wolaæ
calm = spokój, spokojny
calm down = uspokoiæ siê
camp of tents = obozowisko
Canada = Kanada
candlestick = lichtarz
capable = zdolny
capital = stolica
capital city = stolica
capture = lapaæ, chwytaæ
car = auto, samochód
cardiac = serdeczny
care = troszczyæ siê, dbaæ
care for = leczyæ
carefully = troskliwie, starannie
carnation = gozdzik
carriage = wagon
carry = niesæ, nosiæ
case = sprawa, afera
castle = zamek
cat = kot
catarrh = katar
catch = lapaæ, chwytaæ, trafiæ
cathedral = katedra
cause = czyniæ czyms, sklaniaæ do czegos, powodowaæ, sprawiaæ
cease = przestaæ
celebrate = swiêtowaæ, obchodziæ
centennial = wiek, stulecie
centre = srodek, centrum
century = wiek, stulecie
ceremony = uroczystosæ
certain = pewny, przeswiadczony
certainly = przeciez, wszak
certainty = pewnosæ
chair = krzeslo
chairman = prezes, przewodniczacy
chalice = kieliszek
chamber = pokój
chance = okazja, przypadek, zdarzenie, szansa
change = zmieniaæ, zmieniaæ siê
chap = osobnik
character = natura
characterize = charakteryzowaæ
charming = uroczy
chase = przesladowaæ, goniæ, polowaæ
chat = gawêdziæ
chatter = gawêdziæ
cheap = tani
cheaply = tanio
cheat = lotr
check = czek
cheerful = wesoly
cheese = ser
cheque = czek
cherry = wisnia, owoc wisni
cherry-tree = wisnia, drzewo wisniowe
chest = slabo
chief = szef, zwierzchnik, glówny, szefo
chiefly = zwlaszcza, szczególnie, glównie
child = dziecko
chilli = papryka
chilly = zimny
Chinaman = Chiñczyk
Chinese = Chiñczyk
chocolate = czekolada
choose = wybraæ, wybieraæ
Christ = Chrystus
Christian = chrzescijanin
Christmas = Boze Narodzenie
chunk = bryla
church = kosciól
church-building = kosciól
cigarette = papieros
cinema = kino, sztuka filmowa
circle = towarzystwo
city = miasto
civilization = cywilizacja
civilize = cywilizowaæ
civilized = cywilizowany
clarify = wyjasniaæ
class = kurs
clean = czysty, czysciæ
cleanse = czysciæ
clear = jasny
clearly = jasno, wyraznie
climb = isæ w górê
clip = strzyc
cloak = plaszcz
clock = zegar
clod = bryla
close = zamykaæ, zamykaæ siê, bliski, blisko
closed = zamkniêty
closet = szafa
cloth = material
clothe = ubieraæ
cloud = chmura
club = klub, towarzystwo
club member = klubowicz
coach = wagon
coal = wêgiel
coast = wybrzeze
coat = plaszcz
cocktail = koktajl
coffee = kawa
coffee-house = kawiarnia
coin = moneta
cold = zimny, zimno
colonel = pulkownik
colony = osada, kolonia
colour = kolorowaæ, farbowaæ, kolor
comb = czesaæ, grzebieñ
combat = zwalczaæ
come = pójsæ, przychodziæ
come about = stawaæ siê, zdarzyæ siê, wydarzyæ siê
come across = spotykaæ
come back = powróciæ
come close = zblizyæ siê
come closer = zblizyæ siê
come on = zblizyæ siê
come to a halt = zatrzymaæ siê
come true = realizowaæ siê
comma = przecinek
command = rozkazywaæ
commence = zaczynaæ
commencement = poczatek
commend = chwaliæ, poleciæ
commendable = chwalebny
commerce = handel
commodity = towar
common = wspólny, zwykly
communicate = powiadamiaæ, komunikowaæ
compare = porównywaæ
comparison = porównanie
compel = zmusiæ
complain = skarzyæ siê
complete = uzupelniaæ, pelen, pelny
completely = w pelni
complex = kompleks
compose = komponowaæ, tworzyæ dzielo, pisaæ
composer = kompozytor
composition = kompozycja
comprise = zawieraæ
computer = komputer
conceal = ukrywaæ, chowaæ
concern = dotyczyæ
concerning = odnosnie, o
concert = koncert
concert-room = sala koncertowa
concrete = konkretny
condition = warunek, stan
conduct = kierowaæ, prowadziæ, prowadziæ
conduct oneself = zachowywaæ siê
conference = konferencja
confess = wyznawaæ, przyznawaæ siê
confession = wyznanie, przyznanie siê
confidence = naiwnosæ
confront = przeciwstawiaæ siê
congenital = od urodzenia
Congo = rzeka Kongo
congratulate = gratulowaæ
connect = zwiazaæ, wiazaæ, laczyæ
consent = zgadzaæ siê, zgoda
consequently = przeto, wiêc, zatem
consider = patrzeæ
consist = skladaæ siê, polegaæ
construct = budowaæ
contact = kontakt
contain = zawieraæ
container = pojemnik, naczynie
contend with = zwalczaæ
contented = zadowolony
contents = zawartosæ, tresæ
continue = trwaæ
contrary = przeciwny
control = uruchamiaæ, panowaæ, rzadziæ
conversation = rozmowa
converse = rozmawiaæ
convey = przekazaæ
cook = gotowaæ
cooperate = wspólpracowaæ
co-operate = wspólpracowaæ
copper = miedz
cord = sznur
cordial = serdeczny
corner = róg, kat
corpulent = gruby
correct = poprawiaæ, wlasciwy
correspond = korespondowaæ
cost = kosztowaæ
costly = drogi, kosztowny
cottage = domek, chatka
cough = kaszleæ, kaszel
count = liczyæ
count in = dodawaæ
country = kraj
couple = malzonkowie, malzeñstwo
courage = odwaga
courageous = odwazny, smialy
course = kurs
courtesy = grzecznosæ
cow = krowa
Cracow = Kraków
cream = krem
create = tworzyæ, tworzyæ dzielo, pisaæ
crime = zbrodnia
Croat = Chorwat
crockery set = serwis, zastawa
crook = lotr
cross = rozgniewany, przejsæ
crowd = masa, tlum
cruel = okrulny
cry = plakaæ
cuff = mankiet
culture = kultura
cupboard = szafa
cure = leczyæ
curious = zaciekawiony
curl = fryzowaæ, ukladaæ wlosy
current = obecny, wspólczesny
cushion = poduszka
custom = zwyczaj
cut = strzyc, ciaæ
cycle = rower
Czech = Czech
dad = tatus
daddy = tatus
daily = codziennie
daily paper = dziennik
daisy = stokrotka
damage = szkoda
dance = bal, tañczyæ, taniec
Dane = Duñczyk
danger = niebezpieczeñstwo
dangerous = niebezpieczny
dare = osmieliæ siê
data = material
date = data
day = dzieñ
daydream = marzyæ, marzenie
dear = szanowany, szanowny, drogi, kosztowny
December = grudzieñ
decide = decydowaæ, postanowiæ
decision = decyzja
declaration of policy = program
decorate = ozdabiaæ
dedicate = dedykowaæ, poswiêcaæ
deem = wierzyæ, mniemaæ, sadzieæ, patrzeæ
deer = jeleñ
defend = broniæ
defiantly = wbrew, na przekór
definitely = koniecznie
degree = stopieñ, tytul
delay = spóznienie, odkladaæ, przesuwaæ
delicacy = smakolyk
delight = oczarowaæ
demand = zadaæ, postulowaæ
dentist = dentysta
depart = usunaæ
depend = zalezeæ
deprive = pozbawiæ
deprive ... of = pozbawiæ
descend = zejsæ
describe = opisaæ
descry = zobaczyæ, ujrzeæ
desert = opusciæ
deserving = godny
design = plan
desire = pragnaæ, zyczyæ, zyczenie, pragnienie
despite = pomimo, wbrew, na przekór
destine = przeznaczyæ
destroy = niszczyæ
destruction = zniszczenie
detail = szczegól, detal
determine = ustalaæ, determinowaæ, umocowaæ, ustaliæ
devote = dedykowaæ, poswiêcaæ
diagram = plan
dial = plyta, dysk
dictionary = slownik
die = umieraæ
difference = róznica
different = odmienny, inny, rózny
differently = inaczej, gdzie indziej
difficult = trudny
diligent = pilny
diminutive = maly
dining-room = jadalnia
dinner = obiad
direct = kierowaæ, prowadziæ
directly = wprost, prosto
director = dyrektor
disadvantage = wada
disappear = znikaæ
disarm = rozbroiæ
disc = plyta, dysk
discrete = dyskretny
discuss = dyskutowaæ, omówiæ
discussion = dyskusja
disease = choroba
dislike = nie lubieæ, pogardzaæ
dismal = smutny
dispose of = sprzedawaæ
disposition = dyspozycja, talent
dispute = spieraæ siê
dissolve = rozpuszczaæ, rozwiazywaæ
district = dzielnica
disturb = krêpowaæ, przeszkadzaæ
diverse = rózny, rozmaity
divide = dzieliæ
do = robiæ, czyniæ, fryzowaæ, ukladaæ wlosy
doctor = doktor, lekarz
dog = pies
don't mention it = nie ma za co
door = drzwi
dot = punkt, kropka
double = podwójny
doubt = watpiæ
draw out = wydobyæ
dreadful = okropny, straszny
dream = marzyæ, marzenie, sniæ, sen
dreary = smutny
dress = suknia, ubieraæ
drink = piæ alkohol, napój, piæ
drink to excess = piæ alkohol
drive away = wyjechaæ
drive off = wyjechaæ
drive out = wydobyæ
droop = wisieæ
dry = suchy, suszyæ
dual = podwójny
during = podczas, gdy
dust = kurz, odkurzaæ
Dutchman = Holender
duty = obowiazek
dwell = mieszkaæ
dwelling = mieszkanie
dye = kolor
each = po, kazdy
ear = ucho
early = wczesny, wczesnie
early in the morning = wczesnie rano
earmark = przeznaczyæ
earn = zarabiaæ
earnest = powazny
earth = ziemia
easily = latwo
east = wschód
easy = latwy
eat = jesæ
eat up = zjesæ
eavesdrop = podsluchaæ
edge = brzeg
edit = redagowaæ
editor = redaktor
editorial office = redakcja
effort = klopot, staranie, zabiegi
egg = jajko
eight = osiem
eighteen = osiemnascie
eighteenth = osiemnasty
eighth = ósmy
eight hundred = osiemset
eighty = osiemdziesiat
elect = wybraæ, wybieraæ
elegant = elegancki
elephant = sloñ
elevator = winda
else = inny, inaczej, gdzie indziej, dalej, w dalszym ciagu
elsewhere = w innym miejscu
embody = wcieliæ
emerge = pojawiaæ siê
eminent = wybitny
employ = uzywaæ
encounter = spotykaæ, spotkanie
end = koñczyæ, koniec
endeavour = staraæ siê
ending = koniec
end up = przyjechaæ, przyjsæ
endure = trwaæ, cierpieæ
enemy = nieprzyjaciel
energetic = energiczny
engine = maszyna, silnik
engineer = inzynier
Englishman = Anglik
enigma = zagadka
enjoy = cieszyæ siê, radowaæ siê
enjoyable = mily, przyjemny
enjoy oneself = zabawiaæ siê, bawiæ siê
enormous = olbrzymi
enormously = ogromnie
enough = wystarczajacy
enter = wprowadzaæ do srodka, wejsæ, wpisaæ
entertaining = zabawny
enthusiasm = entuzjazm
entice = kusiæ
entire = calkowity
entirely = zupelnie
envelope = koperta
environment = okolica
environs = okolica
equally = tak samo
erect = zalozyæ, ustanowiæ
err = myliæ siê, bladzieæ
error = blad, pomylka
especially = zwlaszcza, szczególnie
Esperantist = esperantysta
establish = zalozyæ, ustanowiæ, stwierdzaæ, konstatowaæ
estimate = oceniaæ
ethos = nastrój
Europa = Europa
Europe = Europa
European = Europejczyk
evade = unikaæ
even = nawet
evening = wieczór
evening meal = kolacja
event = okazja, przypadek, zdarzenie
ever = kiedys, zawsze
every = kazdy
everybody = kazdy
every kind of = wszelki, wszelaki
every one = kazdy
everyone's = kazdego
everything = wszystko
everywhere = wszêdzie
exact = wlasciwy
exactly = dokladnie, wlasnie, wlasciwie
exaggerate = przesadzaæ
examination = egzamin
examine = egzaminowaæ
exceed = przewyzszaæ
exceedingly = nadzwyczajnie, niezwykle
except = oprócz
except for = oprócz
exclusively = tylko, dopiero
excursion = wycieczka
excuse = uniewinniaæ
excuse me = wybacz
excuse oneself = przepraszaæ
exercise = zadanie
exertion = wysilek
exist = istnieæ
exit = wychodziæ, wyjsæ
expect = czekaæ
expectation = oczekiwanie
expensive = drogi, kosztowny
experience = doswiadczenie, przezycie, przezyæ
experienced = doswiadczony
expert = doswiadczony
expire = umieraæ
explain = wyjasniaæ
explode = wybuchnaæ
express = wydobyæ, wyraziæ, wyrazaæ
expression = mina
extension = przyrostek
external = zewnêtrzny
extraordinarily = nadzwyczajnie, niezwykle
extraordinary = nadzwyczajny, niezwykly
extremely = ogromnie, bardzo
eye = oko
face = twarz
facile = latwy
faction = partia
factory = fabryka
fade = zblednaæ
faint = slaby
fair = sprawiedliwy
fairy tale = bajka
faithful = wierny
fall ill = zachorowaæ
family = rodzina
famous = slawny
fancy = wyobrazaæ, marzyæ
fantasy = fantazja
fare = czuæ siê
farewell = zegnaj, pozegnanie
fast = szybki, szybko
fasten = umocowaæ, ustaliæ
fat = gruby
father = ojciec
father-in-law = tesæ
fatherland = ojczyzna
fault = przewinienie
favor = przysluga
favour = przysluga
fear = baæ siê, strach
feast = uczta, przyjêcie, biesiada
feather = pióro
February = luty
feed = jesæ
feel = odczuwaæ, uczucie
feeling = uczucie
fellow = osobnik, maz, mêzczyzna
fellow-creature = blizni
female = kobieta, samica
female teacher = nauczycielka
fervor = zapal, gorliwosæ
fervour = zapal, gorliwosæ
fetch = przyniesæ
fever = goraczka
fewer = mniej
fewest = najmniej
field = pole
fifteen = piêtnascie
fifteenth = piêtnasty
fifth = piaty
fifty = piêædziesiat
fight = walczyæ, zwalczaæ
fight against = zwalczaæ
figure = liczyæ
files = archiwum
fill = wypelniæ
fill in = wypelniæ
fill up = wypelniæ
film = film
finally = w koñcu
find = znalezæ
find oneself = znajdowaæ siê
fine = piêkny, ladny, znakomity, wyborny, swietny
finger = palec
finish = koñczyæ
finished = gotowy
Finn = Fin
fire = ogieñ, strzelaæ
firing = strzelanina
firmly = mocno, trwale, niezachwianie
first = pierwszy, najpierw, po pierwsze
firstly = najpierw, po pierwsze
first of all = najpierw, po pierwsze
fish = ryba
fisherman = rybak
fit = byæ zdatnym
five = piêæ
fix = ustalaæ, determinowaæ, umocowaæ, ustaliæ, naprawiaæ
fix up = urzadzaæ, organizowaæ
flat-iron = zelazko
float = plywaæ
floor = piêtro, podloga
flour = maka
flower = kwiat
flu = grypa
fly = mucha
fog = mgla
food = potrawa
fool = glupiec
foolish = glupi
foot = stopa
for = podczas, gdy, poniewaz, bo
for a long time = dlugo
forbid = zabraniaæ
force = zmusiæ, sila, moc
forefather = praojciec
foresee = przewidywaæ
forest = las
for every reason = z kazdego powodu
forget = zapominaæ
forget-me-not = niezapominajka
forgive = przebaczaæ
form = formowaæ, ksztaltowaæ, ksztalt, forma, formularz
former = poprzedni, przedni
formerly = przedtem, na przodzie
formidable = nadzwyczajny, niezwykly
for no reason = z zadnego powodu
forsake = opusciæ
for some reason = z jakiegos powodu
for the rest = zreszta
fortress = warownia, twierdza
forty = czterdziesci
found = zalozyæ, ustanowiæ
four = cztery
fourth = czwarty, æwiartka
fraction = ulamek
France = Francja
free = wolny
freedom = wolnosæ
freezing cold = mróz
Frenchman = Francuz
frequent = uczêszczaæ, czêsty
frequently = czêsto
fresh = swiezy
Friday = piatek
friend = przyjaciel
friendly = uprzejmy
friendship = przyjazñ
from = przez, do, z
from where = skad
frost = mróz
fruit = owoc
full = pelen, pelny, syty
full of zeal = gorliwy, zapalony
fully = w pelni
fun = przyjemnosæ
function = dzialaæ, funkcjonowaæ
funny = zabawny
further = dalej, w dalszym ciagu
furthermore = dalej
futile = daremny
gain = zarabiaæ
gallant = dzielny
gallery = galeria
gape at = gapiæ siê
garden = ogród
gardener = ogrodnik
garment = ubranie
gate = brama
gateway = brama
gathering = zebranie, konwent
gaunt = smutny
gay = wesoly
gazette = gazeta
general = general
generally = ogólnie, generalnie
generation = generacja
gentle = slodki
gentleman = pan
genuine = autentyczny
genuinly = rzeczywiscie
German = niemiecki, Niemiec
get = przyjechaæ, przyjsæ, osiagaæ, uzyskaæ, czyniæ czyms, sklaniaæ do czegos, zostaæ, stawaæ siê, wziaæ, braæ, otrzymaæ
get married = wyjsæ za maz, ozeniæ siê
get off = zejsæ
get tired = zmêczyæ siê
get wet = zmoknaæ
gift = podarunek
gin = jalowcówka, dzin
give = daæ, dawaæ, przedstawiaæ
give back = oddawaæ
give rise to = powodowaæ, sprawiaæ
give utterance to = wydobyæ
gladness = radosæ
glove = rêkawiczka
go = isæ, pojechaæ, jechaæ
goal = cel
goat = koza
go away = usunaæ
go beyond = przejsæ
goblet = kieliszek
go down = zejsæ
go fast = spieszyæ siê
go for a walk = spacerowaæ
go in = wejsæ
gold = zloto
good = dobrzy
goodbye = zegnaj, pozegnanie, do widzenia
good-bye = pozegnanie
good day = dzieñ dobry
good evening = dobry wieczór
good morning = dzieñ dobry
good-natured = uprzejmy
goodness = dobroæ
good night = dobranoc
go out = wychodziæ, wyjsæ
go through = doswiadczyæ, dozyæ
go to bed = polozyæ siê do lózka
go to sleep = zasnaæ
go up = isæ w górê
govern = panowaæ, rzadziæ
government = rzad
gown = suknia
grade = stopieñ, nuta, nota
grandfather = dziadek
grandmother = babka
granny = babcia
grapple = lapaæ, chwytaæ
great = znakomity, wyborny, swietny, duzy
great-grandfather = pradziadek
greatgrandson = prawnuk
Greek = Grek
green = zielony
greeting = pozdrowienie
grey = szary, siwy
grip = grypa
groschen = grosz
ground = teren
grounds = teren
group = grupa
grow = zostaæ, stawaæ siê, rosnaæ, rósæ
gruesome = okropny, straszny
gruff = nieuprzejmy
guarantee = gwarantowaæ
guard = gwardia, druzyna
guess = przypuszczaæ
guest = gosæ
guide = kierowaæ, prowadziæ, przewodnik, prowadziæ
guidebook = przewodnik
guilt = przewinienie
guiltless = niewinny
guy = osobnik
gypsy = Cygan
habit = zwyczaj
hail = grad
hair = wlos
hairdresser = fryzjer
half = polowa
halt = zatrzymaæ siê, zatrzymaæ
ham = szynka
hand = podawaæ, wrêczaæ, robotnik, rêka, przekazaæ
handbook = przewodnik
hand over = podawaæ, wrêczaæ, przekazaæ
handsome = piêkny, ladny
hang = wisieæ, powiesiæ
happen = stawaæ siê, zdarzyæ siê, wydarzyæ siê
harbor = port
harbour = port
hard = trudny
hardly = zaledwie, trudno
hardworking = pilny, pracowity
hare = zajac
harsh = nieuprzejmy
hat = kapelusz
hate = nienawidzieæ
have = mieæ, otrzymaæ
have a good time = zabawiaæ siê, bawiæ siê
have a tendency = byæ sklonnym
have at one's disposal = dysponowaæ
have compassion on = wspólczuæ
have got = mieæ
have the right to = mieæ prawo
have to = musieæ
hazard = przypadek
he = on
head = kierowaæ, prowadziæ, glowa
headache = ból glowy
heading = tytul
health = zdrowie
healthy = zdrów, zdrowy
heap = masa
hear = slyszeæ
heart = serce
heart- = serdeczny
hearty = serdeczny
heaven = niebo
height = wysokosæ
hello = czesæ, czolem
helmet = kask
help = pomagaæ, pomoc
her = swój, swoje, swoja, swe, ona, jej
here = tu
here are = oto
here is = oto
heroin = bohaterka
heroine = bohaterka
herself = sam, osobiscie
hesitate = wahaæ siê
hide = ukrywaæ, chowaæ
high = wysoki
him = on
himself = sam, osobiscie
hinder = krêpowaæ, przeszkadzaæ
hip = biodro
his = jego, swój, swoje, swoja, swe
hit = biæ, uderzaæ, pukaæ, trafiæ
hobby = hobby
hog = swinia
holder = pochwa, futeral
Holland = Holandia
holy = swiêty
home = dom
honest = uczciwy
honor = zaszczyt, honor
honour = zaszczyt, honor
hooter = róg
hope = mieæ nadziejê, nadzieja
horn = róg
horrible = okropny, straszny
horse = koñ
hospitable = goscinny
hot = goracy
hotel = hotel
hour = godzina
house = dom
housefly = mucha
house of worship = kosciól
how = jak
however = jednak
how many = ile, który
how much = ile
huge = olbrzymi
human being = czlowiek
human race = ludzkosæ
hundred = sto
Hungarian = Wêgier
hungry = glodny
hunt = polowaæ
hurry = spieszyæ siê, ponaglaæ, byæ pilnym
hurt = boleæ, dolegaæ
husband = maz
hut = chata
hymn = piesñ
ice = lody, lód
icecream = lody
idea = pomysl, idea, mysl
if = jezeli, o ile
ill = chory
illness = choroba
image = obraz
imagine = wyobrazaæ
immediately = zaraz, natychmiast
immense = olbrzymi
impartial = neutrala
imply = mieæ znaczenie, znaczyæ
important = powazny
impossible = niemozliwy
impress = robiæ wrazenie
impression = impresja, wrazenie
in = w
in addition = oprócz tego, dalej
in a way = niby, jakby
inborn = od urodzenia
inbred = od urodzenia
incendiary bomb = bomba zapalajaca
include = zawieraæ
inconvenient = trudny
incorrect = niewlasciwy
increase = zwiêkszyæ siê
indeed = faktycznie, przeciez, wszak, rzeczywiscie
in detail = szczególowo, detalicznie
indicate = pokazaæ
industrial = przemyslowy
industrious = pilny
industry = pilnosæ, przemysl
in every way = w kazdy sposób
in exchange for = przeciw, naprzeciw, w zamian
inexpensive = tani
in fact = rzeczywiscie, faktycznie
infant = dziecko
influence = wplywaæ
influenza = grypa
inform = informowaæ, zawiadomiæ
in front of = przed
ingenious = genialny
ink = atrament
inkpot = kalamarz
ink-well = kalamarz
innate = od urodzenia
innocent = niewinny
in no way = w zaden sposób
inquisitive = zaciekawiony
insert = wprowadzaæ do srodka
inside = w
in spite of = pomimo, wbrew, na przekór
instant = chwila, moment
instruction = pouczenie, nauczka
instructor = nauczyciel
insult = obrazaæ
intend = zamierzaæ
interest = zaciekawiaæ
interesting = ciekawy
interrupt = przerwaæ
interview = wywiad
in that way = w ten sposób
in the beginning = poczatkowo
in the evening = wieczorem
in the meantime = tymczasem
in the morning = rano
into = w
introduce = przedstawiaæ
in vain = daremnie
investigation = egzamin
invitation = zaproszenie
invite = zaprosiæ
in what way = jak
iron = zelazo, prasowaæ, zelazko
iron clothes = prasowaæ
island = wyspa
issue = wydaæ
it = ono, to
Italian = Wloch
its = swój, swoje, swoja, swe
itself = sam, osobiscie
jacket = marynarka
January = styczeñ
Japanese = Japoñczyk
jealous = zazdrosny
jeer at = szydziæ
jest = zatrowaæ
Jew = Zyd
jewel = klejnot
jeweller = jubiler
job = robota, praca
join = przylaczyæ siê, dolaczyæ siê, polaczyæ, zwiazaæ, wiazaæ, laczyæ
joint = wspólny
joke = zatrowaæ
Joseph = Józef
journal = dziennik
journalist = dziennikarz
journey = podróz
joy = radosæ
jubilee = jubileusz
jug = dzban, pojemnik, naczynie
juice = sok
July = lipiec
jump = skakaæ
jungle = dzungla
just = sprawiedliwy, tylko, dopiero, zaraz, natychmiast, wlasnie, wlasciwie, dopiero co, przed chwila
just now = dopiero co, przed chwila
keep = wykonaæ, spelniæ
keep on = trwaæ
keepsake = pamiatka
kilo = kilogram
kind = uprzejmy, usluzny, uczynny
kindness = uprzejmosæ
king = król
kiss = calowaæ, pocalunek
kitchen = kuchnia
klaxon = róg
knee = kolano
knife = nóz
knock = uderzaæ, pukaæ
knot = wiazaæ, wêzel
know = znaæ, wiedzieæ
know how = wiedzieæ, potrafiæ
laborer = robotnik
labourer = robotnik
lack = brak
lad = chlopiec
laddie = chlopiec
ladies and gentlemen = pañstwo
lake = jezioro
lamp = lampa
land = wyladowaæ, kraj, ziemia
large = duzy
last = poprzedni, przedni, trwaæ, ostatni
lasting = trwaly
late = pózny, pózno
laud = chwaliæ
laugh = smiaæ siê
lay down = klasæ
lay hold of = wziaæ, braæ
lazy = leniwy
lead = kierowaæ, prowadziæ
leader = szef, zwierzchnik
leaf = arkusz, kartka, lisæ
leap = skakaæ
learn = uczyæ siê
least = najmniej
leave = usunaæ, opusciæ, zostawiæ, pusciæ
leave behind = pozostawiæ
lector = lektor
lecture = prelekcja
lecturer = lektor
left = lewy
leg = noga
legend = legenda
legible = czytelny
lemon = cytryna
lend = pozyczyæ
lengthwise = wzdluz
less = mniej
lesson = lekcja
let = zostawiæ, pusciæ
let know = zawiadomiæ
letter = list, litera
level = poziom
library = biblioteka
lie = lezeæ
lie down = polozyæ siê
lieutenant = porucznik
life = zycie
lift = winda
light = jasny, lekki, swiatlo, slaby, lekki
lightly = slabo
like = jak, lubiæ, ceniæ
like this = w ten sposób
likewise = takze, tez, równiez, tak samo
lilac = bez, lilak
line = linia
linguistic = jêzykowy
lion = lew
listen = sluchaæ
listener = sluchacz
liter = litr
literal = doslownie
literature = literatura
litre = litr
little = maly
live = mieszkaæ, zyæ
lively = sprytny, dowcipny
live through = przezyæ
live to see = doswiadczyæ, dozyæ
loaf = chleb
loan = pozyczaæ
location = miejsce, miejscowosæ
loch = jezioro
lofty = wysoki
London = Londyn
long = dlugi, dlugo
look = wygladaæ, mieæ wyglad, oto, patrzeæ, spojrzenie
look after = zadbaæ
look at = patrzeæ
lord = pan
lose = gubiæ, traciæ
lounge = salon, sala
love = kochaæ, milosæ
loved = kochany
lovely = mily, przyjemny, piêkny, ladny, przepiêkny, przesliczny, drogi, uroczy
lower-arm = przedramiê
luck = szczêscie, traf, szansa
lump = bryla
lunatic = szaleniec
lung = pluco
lurid = ostry
lust = pasja
lyric = tekst
machine = maszyna
magazine = gazeta, czasopismo, rewia
mail = poczta
main = glówny
mainly = zwlaszcza, szczególnie
major = glówny
make = robiæ, czyniæ, czyniæ czyms, sklaniaæ do czegos
make a mistake = myliæ siê, bladzieæ
make a noise = halasowaæ
make clean = czysciæ
make fast = umocowaæ, ustaliæ
make fun of = szydziæ
make glad = uradowaæ, ucieszyæ
make use of = uzywaæ
male = mêski
malicious = zlosliwy
mam = mama, mamusia
mammy = mama, mamusia
man = czlowiek, maz, mêzczyzna
manager = dyrektor
mankind = ludzkosæ
mansion = gmach
mantle = plaszcz
manuscript = rêkopis, manuskript
many = wielu, liczni
margarine = margaryna
maritime = morski
married people = malzonkowie, malzeñstwo
marry = ozeniæ, wydaæ za maz, wyjsæ za maz, ozeniæ siê
marvel = dziwiæ siê
marvel at = dziwiæ siê
masculine = mêski
mask = maska
mass = masa, tlum
master = nauczyæ siê, wyuczyæ siê
match = zapalka
material = material
maternal uncle = wuj
matter = sprawa, afera
may = mieæ prawo
maybe = moze
mayhap = moze
mayor = soltys
meal = maka
mean = zamierzaæ, srodek, mieæ znaczenie, znaczyæ
means = narzêdzie, instrument, przyrzad
meanwhile = tymczasem
medical = leczniczy
medicine = medycyna
meet = spotykaæ
meeting = zebranie, konwent
memento = pamiatka
memory = pamiêæ
menu = jadlospis
merchandise = towar
merry = wesoly
metal = metal
metropolis = stolica
Mexico = Meksyk
Mexico City = miasto Meksyk
midday = poludnie
midday meal = obiad
middle = srodek
milk = mleko
million = milion
mine = kopalnia
mineral = mineralny
minister = minister, górnik
minus = minus
minute = minuta
mischievous = zlosliwy
miserable = zly, smutny, biedny
mist = mgla
mistake = blad, pomylka
Mister = pan
misunderstand = zle rozumieæ
misunderstanding = nieporozumienie
mitten = rêkawiczka
mock = szydziæ
model = wzorzec, model
modern = nowoczesny
modest = skromny
modesty = skromnosæ
mom = mama, mamusia
moment = chwila, moment
mommy = mama, mamusia
Monday = poniedzialek
money = pieniadze
month = miesiac
monument = pomnik
mood = nastrój
moon = ksiêzyc
more = bardziej, wiêcej, dalej, w dalszym ciagu
moreover = zreszta, oprócz tego, dalej
morning = ranek
Moscow = Moskwa
most = najbardziej, najwiêcej
mother = matka
mother-in-law = tesciowa
motion picture = film
motor = silnik
motor car = auto, samochód
motto = dewiza, zasada postêpowania, waluta
mountain = góra
mourn = oplakaæ
mouse = mysz
mouth = usta
move = ruszaæ, zmieniæ miejsce
movement = ruch
movie = film
movie theatre = kino
Mr. = pan
Mr. and Mrs. = pañstwo
multicoloured = wielobarwny
multitude = masa, tlum
murder = mordowaæ
museum = muzeum
music = muzyka
musical = muzyczny
must = musieæ
mutiny = bunt, powstanie
my = mój, moja, moje, moi
mysterious = tajemniczy
name = nazwa, nazwisko, imiê
namely = mianowicie
narrate = opowiadaæ
narrative = opowiadanie
nasty = brzydki, zly, zlosliwy
nation = naród
national = narodowy
native = od urodzenia
nature = natura
naught = zero
near = obok, bliski, blisko
nearby = obok, bliski, blisko
nearly = prawie, niemal
nearness = bliskosæ
near to = obok
necessary = konieczny
neck = szyja
necklace = naszyjnik, kolia
necktie = krawat
need = potrzebowaæ
needle = szpilka
needlewoman = krawcowa
neglect = lekcewazyæ
Negro = Murzyn
neighbour = sasiad, blizni
neighbourhood = dzielnica
neither = ani, nikt
nervous = zdenerwowany
neutral = neutrala
never = nigdy
nevertheless = jednak
new = nowy
news = nowina, rzecz nowa
newspaper = gazeta, dziennik
next = potem, bliski
next to = obok
nice = mily, przyjemny, dobrzy, smaczny
Nigeria = Nigeria
night = noc
nine = dziewiêæ
no = nie
nobody = nikt
node = wêzel
no doubt = niewatpliwie
noisy = halasliwy
none = nikt
noon = poludnie
no-one = nikt
no-one's = niczyj, nikogo
nor = ani
north = pólnoc
Norwegian = Norweg
nose = nos
not = nie
not an ace = zadna ilosæ
not at all = w zaden sposób, wcale nie, zupelnie nie
note = bilet, nuta, nota
not easily = trudno
nothing = nic
notice = zauwazyæ, uwaga, spostrzezenie
not on any account = w zaden sposób
notwithstanding = pomimo
nought = zero
novel = nowy, powiesæ
novelty = nowina, rzecz nowa
November = listopad
now = no, teraz, obecnie
nowhere = nigdzie
null = zero
number = numer
numeral = numer
nurse = pielêgnowaæ
obey = byæ poslusznym
object = przedmiot, obiekt
obligation = obowiazek
obliging = usluzny, uczynny
observation = uwaga, spostrzezenie
observe = wykonaæ, spelniæ
obviously = oczywiscie
occasion = raz
occupation = zajêcie
occupy = zajmowaæ
occur = zdarzyæ siê, wydarzyæ siê
occurence = okazja, przypadek, zdarzenie
o'clock = godzina
October = pazdziernik
Oder = Odra
of = przez, do
of course = oczywiscie, rozumie siê
offend = obrazaæ
offer = przedstawiaæ, proponowaæ
office = biuro, urzad
officer = oficer, urzêdnik
official = urzêdowy, sluzbowy, urzêdnik
often = czêsto
of the sea = morski
of the winter = zimowy
of which = czyj, którego
oil = olej
oil of olives = oliwa
okay = dobrzy, dobrze, wlasnie, wlasciwie
old = stary
old man = starzec
olive = oliwka
olive-oil = oliwa
omnibus = autobus
on = przez, do, w, za pomoca, dalej, w dalszym ciagu, o, na
once = pewnego razu
once more = znowu, ponownie
one = ktos, jeden, pewien
one at a time = pojedynczo
one hundred = sto
one thousand = tysiac
on foot = piechota
only = tylko, dopiero, sam
only just = zaledwie
on occasion = pewnego razu, z okazji
on that account = dlatego
on the contrary = przeciwnie
on the left = po lewej
on the other hand = z drugiej strony
on the other side of = po drugiej stronie, poprzez
on the right = po prawej stronie, na prawo
on time = akuratny, punktualny
on top = na górze, u góry
open = otwieraæ, otwarty
open up = otwieraæ
opera = opera
operate = dzialaæ, funkcjonowaæ, uruchamiaæ
operative = robotnik
opine = mniemaæ, sadzieæ
opinion = opinia
opponent = przeciwnik
opportunity = okazja, przypadek, zdarzenie
opposed to = przeciw, naprzeciw, w zamian
opposite = przeciw, naprzeciw, w zamian, przeciwny
oppress = sciskaæ
or = albo, lub
orange = pomarañcza
orchestra = orkiesta
orchid = orchidea
ordain = przeznaczyæ
order = zamawiaæ, zamówienie, porzadek, rozkazywaæ
ordinarily = zwykle
ordinary = zwykly
ornament = ozdabiaæ
ornamental = zdobniczy
other = inny
otherwise = przeciwnie
ought to = musieæ
our = nasz
outer = zewnêtrzny
outing = wycieczka
out of = z
outside = poza, na zewnatrz, zewnêtrzny
outside of = poza, na zewnatrz
overall = calkowity
overcoat = plaszcz
overhead = na górze, u góry
over there = tam
own = wlasny
owner = wlasciciel
pace = krok
packet = paczka
pad = blok
page = strona
pain = ból
paint = kolorowaæ, farbowaæ, malowaæ
painter = malarz
painting = obraz
pair = para
palace = palac
pale = blady
pants = spodnie
paper = papier
paprika = papryka
paradise = raj
parcel = paczka
pardon = przebaczaæ
parents = rodzice
Paris = Paryz
parish = parafia
park = park
parlour = salon, sala
part = czêsæ
Parthian = czêsæ
partially = czêsciowo
participate = uczetniczyæ
partly = czêsciowo
party = partia
pass = spêdzaæ, przekazaæ
pass away = umieraæ
passion = pasja
passport = paszport
pass the night = przenocowaæ
pate = glowa
paternal uncle = stryj
patience = cierpliwosæ
patient = pacjent
pauper = biedak
paw = noga, stopa
pawn = zolnierz
pay = placiæ
pay attention = uwazaæ, zwracaæ uwagê
pay attention to = uwazaæ, zwracaæ uwagê
pay out = wydawaæ
peace = pokój
peaceful = pokojowy
pear = gruszka
pear-tree = grusza
pen = pióro
pencil = olówek
pepper = pieprz
per = w, po
perceive = zobaczyæ, ujrzeæ
percent = procent
percentage = procent
perchance = moze
perfect = udoskonalaæ
perform = pojawiaæ siê, wejsæ, robiæ, czyniæ, wykonaæ, spelniæ, przedstawiaæ
perhaps = moze
peril = niebezpieczeñstwo
period = punkt, kropka
periodical = gazeta, czasopismo, rewia
perish = ginaæ, umrzeæ
permission = zgoda
permit = pozwalaæ
persecute = przesladowaæ
person = osoba, osobnik
personal = wlasny
petticoat = halka
phonograph = gramofon
photograph = fotografia, zdjêcie, zdjêcie, fotografia
physician = lekarz
physics = fizyka
pianist = pianista
pianoforte = fortepian
pick out = wybraæ, wybieraæ
pick up = wziaæ, braæ
picture = obraz
picture postcard = widokówka, pocztówka
pie = tort
piece = czêsæ
piece of furniture = mebel
pig = swinia
pile = masa
pill = pigulka
pin = szpilka
pink = gozdzik
pitcher = dzban
pity = wspólczuæ
place = miejsce, lokal, miejscowosæ, klasæ
place of worship = kosciól
plan = planowaæ, plan
plane = samolot, plan
platform = peron, program
plausible = wiarygodny
play = graæ, bawiæ siê, sztuka teatralna
plaza = plac
pleasant = mily, przyjemny
please = proszê, zachciej, racz, podobaæ siê
pleased = zadowolony
pleasing = przyjemny, ladny
pleasure = przyjemnosæ
plume = pióro
plus = plus
pocket = kieszeñ
poet = poeta
poetry = poezja
point = punkt, kropka
point out = pokazaæ
poison = trucizna
Poland = Polska
politeness = grzecznosæ
Pomerania = Pomorze
poor = zly, biedny
poor man = biedak
poppy = mak
pork = wieprzowina
port = port
portal = brama
Portuguese = Portugalczyk
pose = pozowaæ
possibility = mozliwosæ
possible = mozliwy
possibly = moze
post = poczta
postman = listonosz
postpone = odkladaæ, przesuwaæ
postulate = zadaæ, postulowaæ
potato = ziemniak
pour = laæ
practical = praktyczny, realny, rzeczywisty
practice = zadanie
practice of medicine = medycyna
Prague = Praga
praise = chwaliæ
pray = modliæ siê
precede = wyprzedzaæ
precise = dokladny, precyzyjny
prefer = woleæ
preferably = raczej
prehistory = prehistoria
premier = premier
prepare = przygotowaæ
present = podarunek, obecny, wspólczesny, przedstawiaæ
presentation = przedstawienie
present with = przedstawiaæ
president = prezes, przewodniczacy
press = prasa, sciskaæ, ponaglaæ, byæ pilnym
presume = przypuszczaæ
pretty = ladny
previous = poprzedni, przedni
previously = przedtem, na przodzie
price = cena
pricey = drogi, kosztowny
prime minister = premier
prince = ksiazê
principal = glówny
principally = zwlaszcza, szczególnie
print = drukowaæ
prior = poprzedni, przedni
private = prywatny
probably = prawdopodobnie
problem = problem
produce = realizowaæ
profess = wyznawaæ, przyznawaæ siê
professional = zawód
professor = profesor
programme = program
prohibit = zabraniaæ
promise = obiecywaæ
prompt = akuratny, punktualny
pronounce = wymawiaæ
proper = wlasciwy
property = cecha
propose = proponowaæ
prosecute = przesladowaæ
prospectus = prospekt
prosper = prosperowaæ, powodziæ siê
proud = dumny
proverb = przyslowie
provided that = jezeli, o ile
province = prowincja
provost = soltys
proximity = bliskosæ
pseudonym = pseudonim
public square = plac
publish = wydaæ
publisher = wydawnictwo
publishing house = wydawnictwo
pull out = wydobyæ
pullover sweater = sweter
punctual = akuratny, punktualny
punish = karaæ
purchase = kupiæ, kupno, zakup
pure = czysty
purge = czysciæ
purpose = cel
purse = portfel
pursue = przesladowaæ
put = klasæ
put down = klasæ
put in = wprowadzaæ do srodka
put in order = porzadkowaæ
put off = zdjaæ
put on = nalozyæ
put on the stage = przedstawiaæ
put to sleep = usypiaæ
put up with = cierpieæ
puzzle = zagadka
quality = cecha
quarrel = klóciæ siê
quarter = dzielnica
quarter of an hour = kwadrans
quash = niszczyæ
quay = peron
question = pytanie, problem, zagadnienie
quick = szybki
quickly = szybko
quiet = spokój
quinsy = angina
quit = opusciæ
quite = mniej wiêcej, bardzo, nader, zupelnie
quiver = drzeæ
radio = radio
radius = promieñ
railroad = kolej
railway = kolej
railway carriage = wagon
rain = deszcz
rapid = szybki
rate = oceniaæ
rather = trochê, iles, troszeczkê, przeciez, wszak, srednio, w srodku, raczej
ray = promieñ, radio
reach = osiagaæ, uzyskaæ
read = czytaæ
read again = przeczytaæ ponownie
reader = czytelnik
readiness = gotowosæ
reading matter = czytanka
read over again = przeczytaæ ponownie
ready = gotowy
real = realny, rzeczywisty
reality = prawda
realize = rozumieæ, mieæ swiadomosæ
really = rzeczywiscie
rebellion = bunt, powstanie
recall = pamiêtaæ, przypomnieæ
receive = przyjmowaæ, otrzymaæ
recent = swiezy
recline = lezeæ
recognize = rozpoznaæ, uznaæ
recollect = pamiêtaæ, przypomnieæ
recollection = pamiêæ
recommend = poleciæ
record = plyta, dysk
record-player = gramofon
records = archiwum
recover = wyzdrowieæ
red = czerwony
reflect on = przemysleæ
regard = patrzeæ
register = poleciæ
regrettably = niestety
regularly = czêsto, regularnie
rejoice = cieszyæ siê, radowaæ siê
relate = opowiadaæ
release = zostawiæ, pusciæ
religion = religia
relish = lakomiæ siê
remain = zostawaæ
remember = pamiêtaæ, przypomnieæ
repair = naprawiaæ
repeat = powtarzaæ
repeatedly = wielokrotnie
replete = syty
reply = odpowiadaæ, odpowiedz
report = informowaæ, powiadamiaæ, komunikowaæ
repose = wypoczywaæ
request = prosiæ
require = potrzebowaæ, zadaæ, postulowaæ
re-read = przeczytaæ ponownie
reserve = zamawiaæ, rezerwowaæ
residence = mieszkanie
respond = odpowiadaæ
rest = wypoczywaæ
restaurant = restauracja
restrain = powstrzymywaæ, panowaæ, rzadziæ
retardation = spóznienie
return = oddawaæ, powróciæ, powrót
reveal = ujawniæ, odkryæ
review = recenzja
revolt = bunt, powstanie
revue = czasopismo, rewia
rice = ryz
rich = bogaty
rich man = bogacz
riddle = zagadka
ride = jechaæ
ridiculous = smieszny
right = prawy, wlasciwy, wlasnie, wlasciwie
right away = zaraz, natychmiast
righteous = sprawiedliwy
righthand = prawy
right now = zaraz, natychmiast
river = rzeka
roam = wlóczyæ siê
rob = okrasæ
robe = suknia
rogue = lotr
roll = bulka
Roman = powiesæ
Romania = Rumunia
Romanian = Rumun
Rome = Rzym
roof = dach
room = pokój
root = zakorzeniæ siê, przyjaæ siê, rdzeñ
rope = sznur
rose = róza
rose-bush = krzak rózy
rough = nieuprzejmy
round = wokól, dookola, okolo
ruin = rujnowaæ, ruina
rule = panowaæ, rzadziæ
run = dzialaæ, funkcjonowaæ, biec
run across = trafiæ
rush = spieszyæ siê
Russian = Rosjanin
Sabbath = sobota
sack = worek, torba
sacred = swiêty
sad = smutny
sagacious = madry
sage = madry
sallow = blady
salon = salon, sala
salt = sól
saltshaker = solniczka
same = taki sam, to samo
sandwich = kanapka
sap = sok
Sassenach = Anglik
satisfied = zadowolony, syty
Saturday = sobota
save = oszczêdzaæ
say = powiedzieæ
scales = waga
scarcely = zaledwie
scatter = laæ
school = szkola
science = nauka
scientific = naukowy
scissors = nozyczki
Scot = Szkot
Scotsman = Szkot
script = scenariusz
sculptor = rzezbiarz
sculpture = rzezba
sea = morski, morze
sea- = morski
seamstress = krawcowa
seaside = wybrzeze
seat = siedziba
second = drugi
secret = tajemnica
secure = umocowaæ, ustaliæ
see = spotykaæ, widzieæ, troszczyæ siê, dbaæ
seem = zdawaæ siê
seemingly = pozornie
seldom = rzadko
self = sam, osobiscie
self-conscious = zazenowany
sell = sprzedawaæ
send = posylaæ
sensation = uczucie
sense = odczuwaæ
sensitive = uczuciowy
sentence = zdanie
separate = dzieliæ
separately = osobno, oddzielnie, szczególnie
September = wrzesieñ
Serb = Serb
sergeant = sierzant
serious = powazny
serve = sluzyæ
settlement = osada, kolonia
seven = siedem
seventeen = siedemnascie
seventeenth = siedemnasty
seventh = siódmy
seventy = siedemdziesiat
severe = ostry, srogi
shack = chata
shake = potrzasaæ
shallowly = powierzchownie
shape = formowaæ, ksztaltowaæ, ksztalt, forma
share = dzieliæ, czêsæ, porcja
sharp = ostry, dokladnie
shave = goliæ
shawl = szalo
she = ona
shear = strzyc
shed = laæ
sheep = owca
sheet = arkusz, kartka, lisæ
shelf = pólka
shine = blyszczeæ, swieciæ
ship = statek
shirt = koszula
shiver = drzeæ
shock = potrzasaæ
shoot = strzelaæ
shop = sklep
shore = brzeg, wybrzeze
short = krótki
shortage = brak
shortcoming = brak
shorten = skróciæ
short story = nowela
should = musieæ
shoulder = plecy
show = pokazaæ, przedstawienie
shower = przysznic, natrysk
shrub = krzak
shut = zamykaæ, zamkniêty
shy = zazenowany
sick = chory
side = strona, bok, partia
sideboard = szafa
sightseeing trip = wycieczka
signify = mieæ znaczenie, znaczyæ
silence = spokój
Silesia = Slask
silver = srebro
simple = prosty, zwykly
since = przez, do, poniewaz, bo
sincere = szczery
sincerity = szczerosæ
sing = spiewaæ
singer = spiewak
single = pojedynczy
singly = pojedynczo
sir = pan
sister = siostra
sit = siedzieæ
sit down = usiasæ
sitting-room = salon, sala
six = szesæ
sixteen = szesnascie
sixteenth = szesnasty
sixth = szósty
sixtieth = szesædziesiaty
sixty = szesædziesiat
size = wielkosæ
ski = jezdziæ na nartach, narta
skin = skóra
skirt = spódnica
sky = niebo
sky blue = blêkitny
Slav = Slowianin
sleep = spaæ
sleepy = senny
slender = zgrabny
slice = ciaæ
slim = zgrabny
slogan = dewiza, zasada postêpowania, waluta
Slovak = Slowak
small = maly
smile = usmiechaæ siê, usmiech
smoke = paliæ, dymiæ
sneeze = kichaæ
snow = snieg
so = wiêc, przeto, to, przeto, wiêc, zatem, w ten sposób
soap = mydlo
social = socjalny
society = klub, towarzystwo
socket = pochwa, futeral
sofa = sofa
soft = slodki
soil = ziemia
soldier = zolnierz
sole = sam
solitary = sam
so long = do widzenia
solve = rozpuszczaæ, rozwiazywaæ
somber = smutny
some = trochê, iles, ktos, pewien, jakis, jacys, kilka, kilkoro
somebody = ktos
somehow = jakos
some kind of = jakis
someone = ktos
some one = ktos
someone's = czyjs
something = cos
something new = nowina, rzecz nowa
sometime = kiedys
sometimes = pewnego razu
somewhat = trochê, iles
somewhere = gdzies
son = syn
song = piesñ
soon = wkrótce
soul = dusza
soup = zupa
sour = nieuprzejmy
south = poludnie
souvenir = pamiatka
Spaniard = Hiszpan
spare = oszczêdzaæ
spare time = urlop, wczasy
speak = mówiæ
spectacle = przedstawienie
speed = szybkosæ
speedy = szybki
spend = wydawaæ, spêdzaæ
spend the night = przenocowaæ
spider = pajak
spiderweb = pajêczyna
spinach = szpinak
spinster = panna
spoon = lyzka
sport = sport
spot = miejsce, miejscowosæ, punkt, kropka
spring = wiosna, skakaæ
springtime = wiosna
square = plac
squeeze = sciskaæ
stage = stacja
stage-manager = rezyser
staid = powazny
staircase = schody
stairs = schody
stand = staæ
stand up to = przeciwstawiaæ siê
star = gwiazda
start = zaczynaæ, poczatek
state = stan, pañstwo
statement of policy = program
station = dworzec, stacja
stature = postawa, budowa ciala
stay = pobyt, zostawaæ
stay for = doczekaæ siê
stay over = zostawaæ
steak = befsztyk
steal = krasæ
steam = para, opar
steamship = parowiec
step = krok
step-father = ojczym
still = jeszcze
stipulation = warunek
stomach = zoladek
stone = kamieñ
stop = przystanek, postój, zatrzymaæ siê, zatrzymaæ, stacja, przestaæ
store = sklep
storey = piêtro
story = piêtro, opowiadanie
straigh ahead = wprost, prosto
straightforward = prosty, zwykly
strech = napinaæ
street = ulica
streetcar = tramwaj
strength = sila, moc
strict = ostry, srogi
stride = krok
strike = biæ, zakorzeniæ siê, przyjaæ siê, uderzaæ, pukaæ, trafiæ
striking = trafny
string = sznur
strive for = dazyæ
stroll = spacerowaæ
strong = mocny, silny
strongly = mocno, silnie
struggle = walczyæ
student = student
study = studiowaæ
stupid = glupi
style = styl
subdue = podporzadkowaæ
subject = temat
subjugate = podporzadkowaæ
subordinate = podwladny
subsequently = potem, przeto, wiêc, zatem
subtract = odejmowaæ
subtraction = odejmowanie
suburb = przedmiescie
succeed = mieæ powodzenie, odniesæ sukces
success = sukces, powodzenie
such = taki, w ten sposób
such a = jak, taki
such as = jak
suffer = cierpieæ
sufficient = wystarczajacy
suffix = przyrostek
sugar = cukier
suggest = proponowaæ, sugerowaæ
suit = byæ zdatnym
suitcase = walizka
sum = suma, ilosæ
summer = lato
summon = wolaæ
sun = sloñce
Sunday = niedziela
superficial = powierzchniowy
superior = wyzszy
superscription = napis
supper = kolacja
suppose = przypuszczaæ
sure = pewny, przeswiadczony
surely = przeciez, wszak
surly = nieuprzejmy
surmise = przypuszczaæ
surname = nazwisko
surpass = przewyzszaæ
surprise = niespodzianka
surroundings = okolica
survive = przezyæ
Swede = Szwed
Sweden = Szwecja
sweet = slodki, smakolyk
swift = szybki
swiftly = szybko
swim = plywaæ
swine = swinia
Swiss = Szwajcar
switch = wlaczaæ
syllable = sylaba
sympathetic = sympatyczny
symphonic = symfoniczny
syrup = syrop
table = stól
take = przyjmowaæ, zajmowaæ, wziaæ, braæ
take an interest = interesowaæ siê
take away = zabraæ
take care = troszczyæ siê, dbaæ
take in = przyjmowaæ
take note = stwierdzaæ, konstatowaæ
take off = zdjaæ
take one's measure for = przymierzyæ
take over = kupiæ
take steps = staraæ siê
taking = kupno, zakup
taking over = kupno, zakup
tale = opowiadanie
talent = talent
talk = mówiæ
talkative = gadatliwy
tall = wysoki
tango = tango
tardy = pózny
target = cel
tart = tort
Tartar = Tatar
task = praca
taste = gust
tasty = smaczny
Tatar = tatarski
taxi = taksówka
tea = herbata
teach = nauczaæ
teacher = nauczycielka, nauczyciel
teapot = czajnik
telephone = telefonowaæ, telefon
television = telewizja
television set = telewizor
tell = powiedzieæ, rozkazywaæ, opowiadaæ
temperature = temperatura
tempt = kusiæ
ten = dziesiêæ
tendency = sklonnosæ
tender = slodki, przedstawiaæ, proponowaæ
tend to = pielêgnowaæ
tented camp = obozowisko
tenth = dziesiaty
terminate = koñczyæ
terms = warunek
terrace = taras
terrain = teren
terrible = okropny, straszny
test = egzamin, próbowaæ
text = tekst
textbook = podrêcznik
than = niz, od
thank = dziêkowaæ
thanks = dziêkujê, dziekujemy
thank you = dziêkujê, dziekujemy
that = ze, co, kto, który, w ten sposób
that kind of = taki
that much = tyle
that one = tamten
that one over there = tamten
that one's = tego
that ... over there = tamten
that over there = tamto
that way = w ten sposób
the = tym, im...
theatre = teatr
theatre play = sztuka teatralna
the day after tomorrow = pojutrze
their = ich, swój, swoje, swoja, swe
theme = temat
then = wiêc, przeto, to, wtedy
the Netherlands = Holandia
there = oto, tam
there are = sa
therefore = wiêc, przeto, to, dlatego
there is = sa
these = to
they = oni, one
thick = gruby
thief = zlodziej
thimble = naparstek
thing = rzecz, przedmiot, obiekt
think = mniemaæ, sadzieæ, mysleæ, przemysleæ
think about = przemysleæ
thirsty = spragniony
this = to, ten
this here = to
this way = w ten sposób
those = tamto
thou = ty, pan, pani, panna, wy
though = choæ
thought = mysl
thousand = tysiac
three = trzy
thrifty = oszczêdny
throat = gardlo
through = za pomoca, gotowy, przez, na wskros
throw = rzucaæ
Thursday = czwartek
thus = przeto, wiêc, zatem, w ten sposób
ticket = bilet
tidbit = smakolyk
tidy = porzadkowaæ
tie = krawat, wiazaæ, laczyæ
tie up = wiazaæ, laczyæ
till = do, az do
time = raz, godzina, czas
time off = urlop, wczasy
tired = zmêczony
title = tytul
to = ku, do
today = dzisiaj
together = razem
tomato = pomidor
tomorrow = jutro
tone = tona
tongue = jêzyk
too = takze, tez, równiez, za, zbyt, zbytnio
tool = narzêdzie, instrument, przyrzad
too much = za, zbyt, zbytnio
tooth = zab
toothache = ból zêba
topic = temat
torment = zamêczaæ
to some extent = trochê, iles
to tell the truth = prawdê mówiac
tourist = turysta
toward = ku, do
towards = ku, do, wokól, dookola, okolo
towel = rêcznik
town = miasto
toy = zabawka
trade = handel
tradition = tradycja
traditional = tradycyjny
traffic = ruch
tragic = tragiczny
train = pociag
tram = tramwaj
tranquil = spokojny
transfer = przejsæ, zmieniæ miejsce
translate = tlumaczyæ
transmit = posylaæ
transport = przenosiæ
travel = jechaæ
treasure = skarb
treat = leczyæ
tree = drzewo
tremble = drzeæ
trip = podróz
trouble = problem, krêpowaæ, przeszkadzaæ
troublesome = zenujacy, krêpujacy
trousers = spodnie
truly = rzeczywiscie
truth = prawda
try = próbowaæ
Tuesday = wtorek
tulip = tulipan
Turk = Turek
turn = obróciæ
turn around = obróciæ
turn on = wlaczaæ
turn round = obróciæ
TV = telewizja
TV set = telewizor
twenty = dwadziescia
twin = blizniak
twist = twist
two = dwa
two hundred = dwiescie
type = pisaæ na maszynie
typewriter = maszyna do pisania
ugly = brzydki
ultimately = w koñcu
umbrella = parasol
uncle = stryj, wujek, wuj
under = pod
underground = podziemny
underneath = pod, pod spodem, na spodzie
understand = rozumieæ
undertake = staraæ siê
undoubtedly = niewatpliwie
undress = rozebraæ
unfortunately = niestety
unite = polaczyæ
United States of America = Stany Zjednoczone
university = uniwersytet
unkind = nieuprzejmy
unmarried woman = panna
unpleasant = nieuprzejmy
until = do, az do
up = do góry, w górê
uphill = do góry, w górê
upon = przeciw, naprzeciw, w zamian, o, na
upper-arm = nadramiê
upper arm = nadramiê
upstairs = na górze, u góry
upwards = do góry, w górê
urge = ponaglaæ, byæ pilnym
urgently = pilnie
USA = Stany Zjednoczone
US citizen = Amerykanin
use = uzywaæ
useless = daremny
usual = zwykly
usually = zwykle
utter = wydobyæ
vacation = urlop, wczasy
vain = daremny
valiant = odwazny, smialy
valise = walizka
valley = dolina
value = wartosæ
vapor = para, opar
vapour = para, opar
variable = zmienny, urozmaicony
varied = rózny, rozmaity
various = rózny, rozmaity
veiled = skryty
vend = sprzedawaæ
verbatim = doslownie
very = bardzo, nader
very much = bardzo, nader
vessel = pojemnik, naczynie, statek
vice-versa = odwrotnie
vicious = zlosliwy
victory = zwyciêstwo
view = panorama, patrzeæ, widok
viewpoint = punkt widzenia
vigour = sila, moc
village = wies
violet = fiolek
violin = skrzypce
virtuoso = wirtuoz
visible = widoczny
visit = wizyta, odwiedziny
visit regularly = uczêszczaæ
vitamin = witamina
viz. = mianowicie
vocabulary = slownik
voluntary = chêtny
voyage = podróz
waggon = wagon
wait = czekaæ, doczekaæ siê
waiter = kelner
wait for = czekaæ, doczekaæ siê
waiting-room = poczekalnia
waiting room = poczekalnia
wall = sciana, mur
wallet = portfel
waltz = walc
wander = wlóczyæ siê
want = zyczenie, pragnienie, chcieæ
war = wojna
warehouse = magazyn, duzy sklep, dom towarowy
wares = towar
warm = serdeczny, cieply
warmly = cieplo
warning = ostrzezenie
warrant = gwarantowaæ
Warsaw = Warszawa
wash = myæ
watch = zegarek, zegar, patrzeæ
watch out for = uwazaæ, zwracaæ uwagê
watchword = dewiza, zasada postêpowania, waluta
water = woda
way = zwyczaj
weak = slaby
weakly = slabo
wealthy = bogaty
wear = niesæ, nosiæ
weather = pogoda
wed = ozeniæ, wydaæ za maz
Wednesday = sroda
week = tydzieñ
weep = plakaæ
weigh = wazyæ, mieæ ciêzar, wazyæ
weight = odwaznik
welcome = witaæ
well = dobrze, kalamarz, no, zdrów, zdrowy
well-off = bogaty
well then = no
west = zachód
wet = mokry
wharf = peron
what = co
what a = jaki, jak
what for = dlaczego
what kind of = jaki
what number = który
what's more = zreszta
what sort of = jaki
when = gdy, kiedy
whence = skad
where = gdzie
whereas = podczas, gdy
which = kto, który
which one's = czyj, którego
while = podczas, gdy, czas
whilst = podczas, gdy
white = bialy
who = kto
whole = calkowity, calosæ
wholly = zupelnie
whose = czyj, którego
why = dlaczego
wife = zona
willing = chêtny
willingly = chêtnie
win = zarabiaæ
wind = wiatr
window = okno
wind up = napinaæ
wine = wino
winter = zimowy, zima
winter- = zimowy
wireless = radio
wise = madry
wisely = madrze
wish = pragnaæ, zyczyæ, zyczenie, pragnienie, chcieæ
with = z, za pomoca
with difficulty = trudno
within = w
without = bez
without fail = koniecznie
withstand = przeciwstawiaæ siê
with wisdom = madrze
witness = byæ obecni
witty = sprytny, dowcipny
woman = kobieta
wonder = dziwiæ siê
wonderful = cudowny, wspanialy
woods = las
word = slowo
word-for-word = doslownie
work = dzialaæ, funkcjonowaæ, uruchamiaæ, pracowaæ, robota, praca, dzielo
worker = robotnik
working man = robotnik
workman = robotnik
work out = liczyæ
workplace = pracownia, zaklad
world = swiat
worry = troszczyæ siê, dbaæ
worth = wartosæ
worthy = godny
wrangle = klóciæ siê
write = pisaæ, tworzyæ dzielo, pisaæ
writer = autor, pisarz
writing = pismo, dokument
wrong = niewlasciwy
ye = ty, pan, pani, panna, wy
year = rok
yellow = zólty
yes = tak
yesterday = wczoraj
yet = jeszcze, juz, jednak
yon = tam
yonder = tam, tamten
you = ty, pan, pani, panna, wy
young = mlody
youngster = mlodzieniec
young woman = dziewczyna
your = twój, wasz
you're welcome = nie ma za co
youth = mlodosæ, mlodzieniec
Yule = Boze Narodzenie
Zaire = rzeka Kongo
zeal = zapal, gorliwosæ
zealous = gorliwy, zapalony
zero = zero
zilch = zero
