#setName = words_en_pt_.a.txt
#sideOneTitle = ENG
#sideTwoTitle = POR
.. ago = há ...
agog = curioso
agonize = agonizar, tortuar, atormentar, supliciar, torturar, mortificar
agony = agonia, passamento, aflição, angústia, ânsia, transe
agoraphobia = agorafobia
agrarian = agricultor
agree = acordar, anuir, concordar, estar de acordo
agreeable = ameno, aprazível, agradável, prazeroso
agreeably = agradavelmente, de maneira agradável
agreed = de acordo
agreement = afinação, acorde, acordo, ajuste, concordância, conformidade, convenção, consenso, consentimento
agricultural = agronômico
agricultural labourer = trabalhador rural
agricultural worker = trabalhador rural
agriculture = agricultura, agronomia
agriculturist = agrônomo, engenheiro agrônomo
agrimony = agrimônia
Agrippa = Agripa
agronomics = agronomia
ague = febre
ah = ah
aha = <interjeição que exprime a constatação de algo esperado>, ah-ah, ah
ahead = anteriormente, antes, em lugar anterior, adiante, avante, para frente
ahoy = eh, olá
ai = preguiça
aid = assistente, assistir, ajudar, auxiliar, socorrer, ajuda, auxílio, socorro
aide-de-camp = ajutante de ordens
AIDS = AIDS
aileron = <válvula para dar movimento rotativo ao avião>
ailment = doença
aim = apontar, mirar, tender, ter em vista, ter por fim, visar a, alvo, fim, ponto de mira, dar-se ao trabalho de, empenhar-se em, esforçar-se
aimless = inútil, vão
Ainu = ainu
air = ar, vento, ária
air-balloon = aeróstato
airbrush = pistola de pintura
aircraft = avião
airdrome = aeródromo, aeroporto
airfield = aeródromo, aeroporto
air force = aeronáutica
air letter = aerograma
air out = arejar, ventilar
airplane = aeroplano, avião
airport = aeroporto
airship = aeronave
airy = aguado, falhado, ralo, raro
airy-fairy = traquinas
Ajax = Ajax, Ájax
akin = aparentado
alabaster = alabastrino, alabastro
alacrity = avidez, cobiça, entusiasmo, furor, vida
alarm = dar alarma, aparelho de alarma, alarma, alarme, rebate, éctima, susto, atordoar, bestificar, desconcertar, consternação, estupefação, inquietar, apoquentar, afligir, alarmar, horror, terror, pavor, amedrontar, despertador
alarmclock = despertador
alarming = inquietante, alarmante
alas = infelizmente, lamentavelmente
Alaska = Alasca
alb = alva
Albania = Albânia
Albanian = albanês
albatross = albatroz
Albert = Alberto
albino = albino
Albion = Álbion
album = álbum
albumen = albúmen
alburnum = alburno
alchemy = alquimia
alcohol = bebida alcoólica, álcool
alcoholic = alcoólico, bêbado
alcoholism = alcoolismo
alcove = alcova
aldehyde = aldeído
alder = amieiro
ale = cerveja
alert = ágil, alerta, animado, bem disposto, vivo, vigoroso, expedito
Aleutian Islands = Aleutas
Alex = Alex
Alexander = Alexandre
Alexandria = Alexandria
alexandrine = alexandrino
Alfred = Alfredo
alga = alga
algebra = álgebra
algebraic = algébrico
Algeria = Algéria, Argélia
Algerian = argeliano
Algiers = Argel
algorithm = algoritmo
alibi = álibi
alien = abominável, repugnante, extrangeiro, alienígena, estrangeiro, estranho, nauseante
alike = igualmente, semelhante, similar, parecido
alimony = alimento
a little = um pouco, um tanto
alkali = álcali
alkaline = alcalino
all = cada espécie de, toda a qualidade, toda espécie de, cada coisa, toda a quantidade, tudo, todas, todos
all about = em toda a parte, em todo o lugar
Allah = Alá
allegedly = o chamado
allegory = alegoria, parábola
allergic = alérgico
allergy = alergia
alley = beco
alliance = aliança
alligator = caimão, crocodilo, jacaré
alliteration = aliteração
all of a sudden = de repente, subitamente
all of it = toda a quantidade, tudo
allot = lotear, repartir
all over again = de novo, novamente, outra vez
allow = deixar, largar, aquiescer, consentir, permitir
alloy = liga
all-powerful = onipotente
all the = cada, cada um, toda a pessoa, todo
all the same = igualmente
all the time = continuamente, sem cessar
allude = aludir, fazer alusão a, reportar-se
allusion = alusão
alluvion = aluvião
alluvium = aluvião
almanac = almanaque
almighty = onipotente
almond = amêndoa, mígala
almost = perto de, por pouco, quase
alms = esmola
almshouse = asilo
aloe = aloés, babosa
alone = isolado, sozinho, único, não ... mais que, só, somente
alongside = ao lado de
a lot of = muito, um grande número de
alp = alpe
alpaca = alpaca
Alpenrose = rododentro
alpha = alfa
alphabet = alfabeto, cartilha de abc, conhecimento elementar, abc, alfabeto
alphabetical = alfabético
alpine = alpestre
Alpinist = alpinista
Alps = Alpes
already = já
Alsace = Alsácia
also = ainda, idem, outrossim, também
altar = altar
altarpiece = retábulo
alteration = mudança
alternate = alternado, alternativa, alterno, alternar
alternating = alternado, alternativa, alterno
alternation = alternação
alternative = alternativa, intercorrência
although = ainda que, conquanto, posto que
altitude = altura
altogether = em suma, na sua generalidade, numa palavra, cada coisa, tudo
altruism = altruísmo
altruist = altruísta, filantropo
altruistic = altruísta, filantrópico, humanitário
alum = alume, alúmen, pedra-ume
alum earth = alumina
alumina = alumina
aluminium = alumínio
aluminum = alumínio
always = em todo o tempo, eternamente, sempre
a.m. = de manhã
Amadeus = Amadeu
amalgamate = amalgamar
amaranthus = amaranto
amaryllis = amarílis
amass = acumular, amontoar, empilhar
amateur = amador, curioso, diletanto, não profissional
amaze = admirar, atordoar, estontear
Amazon = Amazonas, amazona
ambassador = embaixador
amber = âmbar-cinzento
ambiguous = ambíguo
ambition = ambição, aspiração, pretensão
ambitious = ambicioso
ambivalence = ambivalência
ambrosia = ambrosia
ambulance = ambulância, hospital militar móvel
ambush = estar em uma emboscada, cilada, emboscada, tocaia
amen = amém, âmen
amendment = emenda
America = América
American = dos Estados Unidos, norteamericano, americano, cidadão estadunidense
American Indian = índio, pelevermelha
americium = amerício
amethyst = ametista
Amman = Amã
Ammon = Amon
ammonia = amoníaco
ammunition = munição, munição de guerra
amnesty = anistiar, anistia, indulto geral
amoeba = ameba
among = entre, no meio de
amorphous = amórfico, amorfo
amortize = amortecer, amortizar
amount = número, importância, quantia, soma
ampère = ampère, ampério
amphetamine = anfetamina
amphibian = anfíbio
amphitheatre = anfiteatro
amphora = ânfora
ample = amplo, extenso
amplitude = amplitude
amputate = amputar
amputation = amputação
Amsterdam = Amsterdão
amuck = <espécie de alienação com tendência à prática do homicídio>
amulet = amuleto, figa, talismã, patuá
Amur = Amur
amuse = divertir, recrear
amusement = distração, divertimento, recreio
amusing = divertido, recreativo
an = um
anachronism = anacronismo
anaconda = anaconda, sucuri
anaemia = anemia
anaemic = anêmico
anaesthesia = anestesiação, anestesia
anaesthesist = anestesista
anagram = anagrama
anal = anal, relativo ao ânus
analogous = análogo
analogy = analogia, relação analógica, símile
analyse = analisar, decompor
analysis = análise
analyst = analista
analytical chemist = analista
anapaest = anapesto
anarchic = anárquico
anarchical = anárquico
anarchism = anarquismo
anarchist = anárquico, anarquista, anarquista
anarchy = anarquia
Anastasia = Anastácia
anathema = anátema, excomunhão
Anatolia = Anatólia, Ásia Menor
anatomist = anatomista
anatomy = anatomia
anchor = âncora, ferro, <estar ancorado no ancoradouro>
anchorage = ancoradouro
anchovy = enchova, biquerão, bocaréu, manjuba, anchova
ancient = antigo, velho, vetusto
and = e, mais
Andalusia = Andaluzia
Andalusian = andaluz
Andalusian woman = andaluza
Andes = Andes
Andorra = Andorra
Andromeda = Andrômeda
and so on = e assim por diante, et cetera
anecdotal = anedótico
anecdote = anedota, historieta
anemone = anemona, anêmona
anew = de novo, novamente, outra vez
angel = anjo
angelic = angelical, angélico
angelica = angélica
angelus = ângelus
anger = enfado
angina = angina
angina pectoris = angina do peito
angle = ângulo, canto
Anglican = anglicano
anglicism = anglicismo
Anglo-Saxon = anglo-saxão
Angola = Angola
Angora = Ancara, Angorá
Angora cat = gato angorá
anguish = aflição, angústia, ânsia, transe
aniline = anilina
animal = alimária, animal, besta, bicho
animate = agir como mestre de ceremônias, animar, dar acção
anion = ânion, aniônio, anionte
anise = semente do anis, anis
Ankara = Ancara, Angorá
ankle = artelho, maléolo, tornozelo
Ann = Ana
annex = anexar, incorporar a
annexation = anexação
anniversary = aniversário
annotation = apontamento, nota
announce = anunciar, noticiar, notificar
announcer = anunciante
annoy = afligir, magoar, molestar
annoyance = aflição, amargura, dor, pena, pesar
annual = anual
annul = anular, declarar sem efeito, revogar
Annunciation = Anunciação
anode = anódio, ânodo
anoint = lambuzar, rebocar, ungir, untar
anomaly = anomalia
anonymity = anonimato
anonymous = anônimo, sem nome
anonymous writer = anônimo
another = diferente, diverso, outro, outrem
another man = outrem
answer = corresponder, responder, resposta
ant = formiga
Antarctic = antárctico, do pólo sul
Antares = Antares
ant-eater = tamanduá
antecedent = avanço, primeiro plano
antedate = antedatar
antediluvian = antediluviano
antelope = antílope
antenna = antena
anthem = hino
anthology = antologia, crestomatia, florilégio, selecta
anthracite = antracite
anthropologist = antropólogo
anthropology = antropologia
antibiotic = antibiôtico
antibody = anticorpo
Antichrist = Anticristo
anticipate = antecipar
anticipation = antecipação
antidote = antídoto, contraveneno
Antilles = Antilhas
Antillian = antilhano, natural das Antilhas
antimony = antimônio
Antioch = Antioquia
antipode = antípoda
antique = antigo, velho, vetusto
antique dealer = antiquário
anti-Semite = anti-semita
anti-Semitism = anti-semitismo
antiseptic = antisséptico, anti-séptico
antitank = antitanque
anti-tank gun = bazuca
antithesis = antagonismo, antítese
Antony = Antônia
Antwerp = Antuérpia
Anubis = Anúbis
anus = ânus
anvil = bigorna
anxiety = ansiedade
anxious = ansioso, inquieto, desassossegado, aflicto
any = alguém, algum, uma pessoa, alguns, certo número de, vários, quem quer que seja, seja lá quem for
anybody = alguém, algum, uma pessoa
anything = algo, alguma coisa
anyway = de qualquer jeito
anywhere = algures
aorta = aorta
apache = apache, bigorrilha, vadio
apart = avulso, especial, isolado, particular, peculiar, reservado, à parte, em separado
apart from = excepcionalmente, além de, com exclusão de, exceto de, fora
apartment = apartamento, aposentos
apathetic = apático, indolente
apathy = apatia, indolência, langor
ape = macaco, símio
Apennines = Apeninos
aperture = abertura, boca, bocal, fenda, fresta, orificio, vão
aphasia = afasia
aphorism = aforismo, prolóquio
aphrodisiac = afrodisíaco
Aphrodite = Afrodite
apiarist = apicultor
apiary = colmeal
aplomb = altivez, aprumo, desembaraço, pose
apocalyptic = apocalíptico, difícil de compreender, relativo ao Apocalipse
apocryphal = apócrifo, falso, não autêntico
Apollo = Apolo
apology = apologia, desculpa, excusa
apoplectic fit = apoplexia
apostate = apóstata
apostatize = apostatar
apostle = apóstolo
apostleship = <dignidade e função de apóstolo>
apostolate = <dignidade e função de apóstolo>
apostolic = apostolar
apostrophe = apóstrofe
apotheosis = apoteose
appal = atordoar, bestificar, desconcertar
apparatus = aparelho, máquina
apparently = evidentemente, aparentemente
appeal = agravar, apelar, recorrer, apelação, <enfileiramento periódico de soldatos para controle>
appeal to = apelar, chamar, invocar
appear = aparecer, publicar-se, sair à luz, vir a lume, representar, ter aspecto de, mostrar-se, parecer, ter aparência de
appearance = aparicão, visão, aspecto, semblante, aparência, exterioridade
appear to be = mostrar-se, parecer, ter aparência de
appease = tranqüilizar, acalmar, sossegar
appellation = nome
appendicitis = apendicite
appendix = apêndice
appetite = apetite, desejo, desfastio, gana
appetizing = aperitivo, apetitoso
applaud = aclamar, ovacionar, aplaudir, aprovar, bater palmas, louvar
apple = maçã
apple-tree = macieira
application = aplicação
apply = aplicar, por em prática
appointment = rendez-vous
appointment book = agenda, canhenho, memento, ritual
appraise = ajuizar, avaliar, orçar, taxar, estimar, apreciar, apreçar
appreciate = apreciar, dar merecimento a, estimar, gostar de, prezar
apprehension = prisão
approach = dirigir-se, aproximar-se
appropriate = adequado, apropriado, conveniente
approval = aclamação, ovação, aplauso, aprovação
approve = aplaudir, aprovar, assentir, deferir
approximately = aproximadamente, cerca
apricot = abricó, abricoque, abricote, albricoque, damasco
apricot-tree = abricoteiro, damasqueiro, abricoqueiro, albricoqueiro
April = abril
apron = avental
apsis = ábside
aptitude = talento, engenho
aquamarine = água-marinha
aquarium = aquário
Aquarius = Ânfora, Aquário
aquatic = aquático, aquoso
aqueduct = aqueduto
Aquitaine = Aquitânia
aquittal = absolvição
Arab = árabe
arabesque = arabesco
Arabia = Arábia
Arabian = árabe
Arabic = árabe
Arachne = Aracne
Ararat = Ararat
araucaria = araucária, pinheiro brasileiro
arbiter = árbitro, arbitrariedade, arbítrio
arbitrary = arbitrário, discrionário
arbitration = arbitragem, arbítrio
arbitrator = árbitro, arbitrariedade, arbítrio
arboreal = arbóreo
arbutus = medronheiro
arbutus fruit = medrono
arc = arco
Arcadia = Arcádia
arch = abóbada, arcada, arco
archaeologist = arqueólogo
archaeology = arqueologia
archaic = antiquado, arcaido, obsoleto
archaism = arcaísmo
archangel = arcanjo
archbishop = arcebispo
archduke = arquiduque, grão-duque
Archimedes = Arquimedes
archipelago = arquipélago
architect = arquiteto, arquitecto
architectonic = arquitectônico
architectural = arquitectônico
architecture = arquitectura
architrave = arquitrave
archive = arquivo
archives = arquivo
archivist = arquivista
Arctic = ártico
Arcturis = Arcturo
Ardennes = Ardenas
ardent = ardente
are = colecção, grupo, reunião, are
area = área
arena = arena, liça
Areopagus = Areópago
Ares = Ares
Argentina = Argentina
Argentine = argentino
Argentinean = argentino
argon = argônio
argue = contender, disputar, porfiar
argument = argumentação
argumentation = argumentação
Argus = Argos, Argólida, Argo
aria = ária
Ariadne = Ariadne
Aries = Áries, Carneiro
arise = estabelecer-se, produzir-se, levantar-se, nascer, vir à luz
aristocracy = aristocracia
aristocrat = aristocrata
aristocratic = aristocrático
Aristotle = Aristóteles
arithmetic = aritmética
Arizona = Arizona
ark = arca
arm = armar, prover de armas, braçal, perna, travessa, braço
arm- = braçal
armadillo = armadílio, tatu
armature = armação, armadura
armchair = cadeira de braços, poltrona
Armenia = Armênia
Armenian = armênio
Armorica = Armórica
armour = couraça
armoury = arsenal
armpit = axila, sovaco
army = exército
arnica = arnica
aroma = aroma, fragrância, odor
aromatic = aromática, fragrante
around = ao derredor de, cerca de, em redor de, em torno de, em volta de
arouse = acordar, despertar
arrack = araca
arrange = dispor, preparar, arranjar, arrumar, ordenar
arrangement = arranjo, disposição
arrest = apresar, apreender, capturar, prender, prisão
arrested person = preso
arrival = chegada
arrive = aportar, chegar
arrogance = arrogância, impertinência
arrogant = altivo, arrogante, impertinente, soberbo, ufano
arrow = flecha, seta
arrowroot = araruta
arse = ânus
arsenal = arsenal
arsenic = arsênico, arsênico-branco, mata-ratos
art = arte
Artemis = Ártemis
arteriosclerosis = arteriosclerose
artery = artéria
artesian = artesiano
arthritis = artrite
Arthur = Artur
artichoke = alcachofra, alcachofra hortense
article = objecto posto à venda, mercadoria, verbete, assunto, coisa, complemento, objecto, objeto, artigo
article of clothing = veste, vestido, vestimenta, roupa, roupagem, traje, fato
articulate = articular
artificial = afectado, artificial
artillery = artilharia
artilleryman = artilheiro
artist = artista
artistic = artificial
arum = arão, árum
Aryan = ariano
as = ao tempe que, quando, de que modo, na qualidade de, como, de que modo, qual, na qualidade de, quanto, ao longo de, conforme, de acordo de, relativamente a, assim, daquela maneira, desta maneira, deste modo, pois que, porque, visto que
asafoetida = assa-fétida
as a gift = como um presente, grátis
as a matter of fact = de facto, efectivamente
as ... as = qual ... tal
as a whole = em suma, na sua generalidade, numa palavra
asbestos = amianto
ascend = levantar-se, altear, elevar-se, ascender, subir
Ascension = Ascensão
ascertain = achar, constatar, reconhecer, verificar
ascorbic acid = ácido ascorbático, vitamina C
aseptic = asséptico
as for the rest = aliás, além disso
ash = cinza, freixo
ashtray = cinzeiro
Ash Wednesday = quarta-feira de cinzas
Asia = Ásia
Asia Minor = Anatólia, Ásia Menor
Asian = asiano, asiático
Asiatic = asiático
as if = como que, como se
as is being said = o chamado
ask = indagar, interrogar, inquerir, perguntar, questionar, pedir
ask for = pedir
ask forgiveness = <por gentileza pedir escusas de alguém>
as one pleases = a seu bel-prazer, à sua vontade
asparagus = aspárago, aspargo, espargo
aspect = aparência, aspecto, semblante
aspen = choupo tremedor, faia preta
asphalt = asfaltar, cobrir com asfalto, asfalto
asphodel = asfódelo, gamão
aspidistra = aspidistra
aspiration = aspiração, pretensão
aspire = aspirar, desejar vivamente, pretender
aspire to = aspirar, desejar vivamente, pretender
aspirin = aspirina
ass = asno, besta, burro, jumento
assailant = agressor, assaltante, atacante
assault = abordar, acometer, agredir, assaltar, atacar, atentar, cometer um atentado, infringir, ultrajar, violar, atentado, <correr no alcance de alguém para atacar>
assemblage = assembléia, reunião
assemble = reunir-se, montar
assembler = programa de tradução
assembly = acumulação, amontoamento, assembléia
assent = dizer sim, responder que sim, sim
assert = afiançar, assegurar, asseverar, certificar, garantir, sustenar
assertion = afirmacão, asserção, garantia
asset = aquisição
assets = activo, voz activa
assign = consignar, designar, empenhar verba, intimar, cometer, confiar, entregar
assign a number = numerar
assigned job = carga, empreitada, tarefa, gravame, encargo, incumbência
assimilate = assimilar
assimilation = assimilação
assist = assistir, ajudar, auxiliar, socorrer
assistance = assistência
assistant = adjunto, auxiliar, assistente
associate = reunir-se, associar-se, unir-se
association = associação, companhia, grêmio, parceria, sociedade
ass's = asenino
assumingness = arrogância, impertinência
assure = afirmar, assegurar, confirmar
Assyria = Assíria
Assyrian = assírio
astatine = astatínio
aster = áster, astropólio
asterisk = asterisco
asteroid = asteróide
asthma = asma
asthmatic = asmático
asthmatic patient = asmático
as though = como que, como se
astringent = adstringente
astrologer = astrólogo
astrology = astrologia
astronaut = astronauta
astronomer = astrônomo
astronomic = astronômico
astronomical = astronômico
astronomy = astronomia
Asturias = Astúrias
astute = sagaz, astuto
asylum = albergue, asilo, guarida
as you wish = à sua vontade, à vontade
at = para, junto de, perto de, próximo a, ao, com, a por, a por, à razão de, a, ao pé de, em, entre, junto a
Atalanta = Atalanta
at all = quer que, totalmente, absolutamente
atavism = atavismo
atelier = atelier
atheism = ateísmo
atheist = ateísta, ateu
Athena = Atenas, Atena
Athene = Atenas, Atena
Athenian = ateniense
Athens = Atena, Atenas
athlete = atleta
athletic = atlético
athletics = atletismo
at home = em casa
Atilla = Átila
Atlantean = atlante
Atlantic = Oceano Atlântico
Atlantic Ocean = Oceano Atlântico
atlas = atlas
at last = em fim, finalmente, por fim
at least = ao menos, pelo menos, sequer
atmosphere = atmosfera, ambiência
atmospheric = atmosférico
atmospheric phenomenon = fenômeno atmosférico, meteoro
at most = no máximo, ao mais
atoll = atol
atom = átomo
atom bomb = bomba atômica
atomic = atômico
atomic weight = peso atômico
atonal = atonal
at once = sem delonga, diretamente, directamente, imediatamente, sem demora, logo, depressa
at present = ora, agora
atrophy = atrofiar, causar atrofia, atrofiar-se, atrofia
at some time = um dia, uma vez, outrora
attach = acrescentar, aplicar, apor, aprazar, cravar, determinar, fixar
attaché = adido, adido de embaixada, attaché
attack = abordar, acometer, agredir, assaltar, atacar, crise, agressão, ataque
attacker = agressor, assaltante, atacante
attain = adquirir, arranjar, abranger, alcançar, atingir, chegar a, obter, tocar
attempt = dar-se ao trabalho de, empenhar-se em, esforçar-se, ensaiar, experimentar, provar, esforço
attend = cuidar, tratar, zelar, fazer visita, fazer visitas, ir ver, visitar, assistir, estar presente
attend a congress = reunir-se em congresso
attendant = aeromoço, tafeiro
attention = atenção
attentive = atento, atencioso
attest = atestar, certificar, provar, testemunhar
at that place = acolá, aí, além, ali, nesse, nesses, lugar, lugares, naquele
at the back = junto ao dorso
at the rate of = a por, à razão de
at the right time = a propósito, a tempo, oportunamente
at the same time = ao mesmo tempo, a tempo, a par, simultaneamente
at this moment = neste momento
attic = mansarda, trapeira, água-furtada, sótão
Attica = Ática
attitude = atitude, postura
attitudinize = afectar, fingir
attract = atrair, engodar, seduzir
attractive = atraente
attribute = atributo
attune = acomodar, adaptar, ajeitar, ajustar
at will = à sua vontade, à vontade
aubade = serenata matinal
aubergine = berinjela
Auckland = Auclanda
auction = almoeda, arrematação, hasta, leilão, praça
auctioneer = leiloeiro
audacious = audaz, arriscado, ousado
audacity = audácia
audience = auditório, audiência, ouvintes
audio tape = fita-cassete
audio-visual = audiovisual
audit = conferir, fiscalizar, inspecionar, supervisionar
auditor = inspetor geral
auditorium = salão nobre
auditory = auditório, ouvintes
Augeas = Augias
augment = aumentar
August = Agosto
Augustus = Augusto
aunt = tia
aura = aura
aureole = auréola, halo
aurochs = uro, auroque
aurora = aurora
auspices = auspício, bom augúrio
Australia = Austrália
Australian = australiano
Austria = Áustria
Austrian = astríaco, austríaco
autarky = autarquia
authentic = autêntico
authenticity = autenticidade
author = artífice, escritor, autor
authorative = autorizado
authoritative source = instância
authority = competência, autoridade, chefe, competente, estado de chefia
authorize = autorizar, habilitar
autism = autismo
autobiography = autobiografia
autobus = ônibus, auto-ônibus
autocracy = autocracia, autocratismo
autocrat = autócrata
autocratic = autocrático
autodidact = autodidata
autogenous = <que dá continuação a si mesmo>
automate = automatizar, tornar automático
automatic = automático
automatically = automaticamente
automation = automatização
automobile = auto, automóvel, carro
automoton = autômato, aparelho automático
autonomic = autônomo, independente
autonomous = autônomo, independente
autonomy = autonomia
autopsy = autópsia, necropsia, necropse
autumn = outonal, outono
auxilary = auxiliar
avail = ser útil
available = acessível
avalanche = avalanche
avaricious = avarento, avaro
avenge = desforrar, vingar, vingar-se
avenge oneself = desforrar, vingar, vingar-se
Aventine = Aventino
avenue = alameda, aléia, avenida arborizada, rua, avenida
average = média aritmética, central, mediano, médio, centro, meio, metade
aversion = antipatia, ojeriza, quezília, repugnância
aviary = aviário
aviate = avionar, viajar de avião
aviation = aeronáutica, aviação
avidity = avidez, cobiça
avoid = esquivar, evadir, evitar, poupar, presumir, prevenir
await = aguardar, esperar, estar à espera de
awaken = acordar, despertar
award a prize = premiar
awareness = conhecimento, consciência, sentimento de si
away = fora, longe
away we go = comecemos, vamos
awful = abominável, repugnante
awkward = desgracioso, desajeitado, desastrado
axe = machado
axiom = axioma
axis = eixo, veio
axle = eixo, veio
azalea = azálea, azaléia
Azerbaijan = Azerbaijão
Azerbaijani = habitante do Azerbaijão
azimuth = azimute
Azoic = azóico
Azoic era = azóico
Azores = Açores