#setName = words_en_pt_ee.txt
#sideOneTitle = ENG
#sideTwoTitle = POR
each = a por, à razão de, cada, cada um, toda a pessoa, todo
eager = ávido, cobiçoso, sedento, sequioso
eagerness = avidez, cobiça
eagle = águia
ear = orelha, ouvido
earl = conde
early = precoce, prematuro, cedo
earmark = aprazar, destinar, reservar
earn = auferir, ganhar, lucrar, ganhar dinheiro com seu trabalho
earnest = grave, sério, sisudo
earphone = estetoscópio, fone, receptor
earring = brinco
earth = chegar terra, chão, solo, terra
earthen = argiloso, terrestre, terreno, terreal, terráqueo
earthenware = <objecto feito de argila>, faiança, faiença
earthly = terrestre, terreno, terreal, terráqueo
earthquake = tremor de terra, terremoto
earthquake shock = tremor de terra
earth's crust = crosta terrestre
earth up = chegar terra
earthworm = minhoca
easel = banco, bastidor, cavalete, mesa
easily = facilmente
east = leste, oriente
Easter = Páscoa
eastern = oriental
easy = brando, fácil, suave
eat = comer
eat up = devorar
eavesdrop = ouvir secretamente
ebony tree = ébano
ecclesiastic = eclesiástico
echo = ecoar, fazer eco, ressoar, eco
economics = economia
economy = economia
ecstasy = embevecimento, enlevo, êxtase
ecstatic = extático
Ecuador = Equador
edelweiss = edelvais
Eden = Eden
edge = margem, beira, margem, borda
edging = beira, margem, borda
edible = comestível
edify = edificar
Edinburgh = Edimburgo
edit = redegir
edition = edição, emissão
editor = redator
editorial office = redação
educate = criar, educar
education = educação
eel = anguia, enguia
eelworm = anguilula
effect = impressão, acção, efeito, conclusão, resultado
effective = eficaz, eficiente
effectual = eficaz, eficiente
efficacious = eficaz, eficiente
egg = ovo
eggfruit = berinjela
eggplant = berinjela
Egypt = Egipto
Egyptian = egipciano, egípcio
Eiffel Tower = Torre de Eiffel
eight = oito
eighteen = dezoito
eighth = oitavo
eighty = oitenta
einsteinium = einstênio
either ... or = ou ... ou
elastic = elástico
Elba = Elba
Elbe = Elba
elbow = cotovelo
elderly = velho
elect = designar, eleger, escolher, nomear, optar
elected = eleito
election = designação, eleição, escolha
electric = eléctrico
electric fan = ventilador
electricity = electricidade
electric plug = bucha, rolha, tampa
electric socket = tomada
electron = eléctron, electrônio
electronic = electrônico, eletrônico
electronics = electrônica, eletrônica
elegant = airoso, elegante, garboso, gentil, gracioso
elegy = elegia
element = componente, meio, rudimento, elemento, partícula, alicerce, base, fundamento
elemental = elementar, rudimentar
elementary = elementar, rudimentar
elements = abc, alfabeto, cartilha de abc, conhecimento elementar
elephant = elefântico, elefantino, elefante
elephant- = elefântico, elefantino
elephantine = elefântico, elefantino
elephant's = elefântico, elefantino
elevator = ascensor, elevador
eleven = onze
elf = elfo
elide = elidir
eliminate = afastar, eliminar, expulsar
elision = elisão
elk = alce, grã-besta
elm = olmo, ulmo, ulmeiro
eloquent = eloqüente
Elsass = Alsácia
else = diferente, diverso, outro, mais
elsewhere = alhures, em outro lugar
Elysium = Elísio
embalm = embalsamar
embankment = dique
embark = embarcar-se
embarrass = embaraçar, estorvar
embarrassment = aperto, embaraço, estorvo, óbice, perplexidade
embassy = embaixada
embassy building = embaixada
embellish = tornar mais belo
emblem = emblema, insígnia, naipe
embrace = abarcar, abarcar, abraçar
embroider = bordar, lavrar, recamar
emerald = esmeralda
emerge = aparecer, publicar-se, sair à luz, vir a lume
emergency = crise
eminent = alto, distinto, eminente, excelente, notável
emmet = formiga
emotion = abalo, comoção, emoção
emperor = imperador
emphasis = ênfase
emphasize = enfatizar, sublinhar
emphatic = enfático
empire = império
employ = assalariar, contratar, engajar, tomar a serviço, empregar, servir-se de, usar, despender
employee = assalariado, empregado, mercenário
employer = empregador
employment = aplicação
empty = vácuo, vazio
enamel = esmalte dos dentes, esmaltar, esmalte
encore = bis, mais, outra vez
encounter = achar, encontrar, encontro
encourage = impelir, incitar, instigar, alentar, encorajar, despertar, animar
encyclopaedia = enciclopédia
end = beira, extremidade, ponta, topo, encerrar, finalizar, acabar, terminar, conclusão, fim
endanger = arriscar, aventurar, pôr em perigo
endeavour = dar-se ao trabalho de, empenhar-se em, esforçar-se
ending = desinência, terminação, conclusão, fim
endive = almeirão, endívia, escarola
endlessly = infinitamente
endorse = endossar, transferir
endorsement = endosso
endorser = endossante
endow = dotar
end up = aportar, chegar, acabar, terminar
endure = continuar, durar, permanecer, prolongar-se, aguentar, agüentar, padecer, sofrer, agüentar, tolerar, suportar, aturar
enemy = inimigo
energetic = enérgico, resoluto, vigoroso
energy = energia
engage in a controversy = polemizar
engine = locomotiva, máquina, motor
engineer = engenheiro
England = Inglaterra
English = inglês
English Channel = Canal da Mancha
Englishman = inglês
engrave = estampar, gravar
engraving = gravação, gravura
engulf = sorver
enigma = adivinhação, enigma
enjoy = alegrar-se, regozijar-se, desfrutar, fruir, gozar
enjoyable = agradável, ameno, aprazível
enjoy oneself = brincar, distrair-se, divertir-se
enlarge = aumentar
enlighten = iluminar
enlist = alistar-se, engajar-se
enmity = inimizade
enormous = muito grande, enorme, imenso
enormously = extremamente, muitíssimo, sumamente
enough = suficiente, assaz, bastante, em quantidade suficiente
entangle = enredar, envolver, implicar
enter = inserir, introduzir, entrar, entrar em
enterprise = empresa
enterprising = empreendedor
entertain = desviar a atenção, distrair, divertir, entreter, hospedar, mimosear, obsequiar, regalar
entertaining = divertido, recreativo
entertainment = divertimento
enthusiasm = entusiasmo, furor, vida
enthusiastic = entusiasta
entice = desencaminhar, seduzir, induzir em tentação, tentar
entire = inteiro, todo, total
entirely = completamente, totalmente, absolutamente
entirety = soma, todo, total
entomb = enterrar, sepultar
entrance = entrada
entrust = comissionar, incumbir, confiar, contar com, crer, ter confiança em
enuresis = enuresia, enurese
envelop = envolver
envelope = envelope, invólucro, sobrecarta
envious = invejoso
environment = meio, ambiente, arrabalde
environs = ambiente, arrabalde
envy = invejar, inveja
Eocene = eoceno
epaulet = dragona
epic = épico
epic poem = epopéia
epilepsy = epilepsia, gota-coral
Epiphany = Epifania
epiphyte = epífito
episcopal = episcopal
episode = episódio
epistle = epístola
epoch = época, idade, quadra
epsilon = épsilon
equal = igual, parelho, ser igual, não diferir
equality = igualdade
equally = ídem, igualmente
equator = equador
equestrian = cavalar, hípico
equilibrium = equilíbrio
equinox = equinócio
equip = aparelhar, aprestar, equipar
equipment = equipamento
equivalent = equivalente
er = -ista
era = época, idade, quadra, era
eradicate = arrancar com a raiz
erase = pôr goma
eraser = goma
erbium = érbio
erect = estabelecer, fundar, instalar
Erin = Erin
Eritrea = Eritréia
erotic = erótico
err = cair em erro, enganar-se, equivocar-se, errar
errand = comissão, comunicação, mensagem
erroneous = errôneo
error = defeito, erro
eryngo = cardo-corredor
erysipelas = erisipela
escalator = escada rolante
escape = escapar, escapar de, escapada
escort = acompanhamento, escoltar, escolta
escudo = escudo
Eskimo = esquimau, esquimó
especially = em especial, principalmente, sobretudo
Esperantist = esperantista
Esperanto = Esperanto
essay = tese
essence = essência
essential = básico, essencial
establish = estabelecer, fundar, instalar, achar, constatar, reconhecer, verificar
establishment = estabelecimento
estate = bens de raiz, domínio, fazenda, granja, propriedade, roça, terras, herança
esteem = apreciar, avaliar, estimar, gostar, prezar, apreciação, estima, considerar, refletir
estimate = ajuizar, avaliar, orçar, taxar, estimar, apreciar, apreçar
Estonia = Estonujo
Estonian = estoniano, estônio
eta = eta
etc. = etc.
et cetera = e assim por diante, et cetera
etching = água-forte
eternal = eterno, imperecível, perene, perpétuo
eternity = eternidade
ether = éter
ethic = ética
ethical = ético
ethics = ética
Ethiopia = Etiópia
Ethiopian = etíope
ethnic group = gênero, raça, tribo
ethos = ambiência
etiquette = cerimonial, etiqueta, pragmática
Etna = Etna
Etruria = Etrúria
Etrurian = etrusco
Etruscan = etrusco
eunuch = eunoco
euphonious = eufónico, harmonioso, sonoro
Euphrates = Eufrates
euro = euro
Europa = Europa
Europe = Europa
European = branco, homem da raça branca, europeu
European Union = União Europeia
europium = európio
Euxine Sea = Mar Negro
Eva = Eva
evacuate = evacuar
evade = esquivar, evadir, evitar, poupar, presumir, prevenir
evangelic = evangélico
evaporate = vaporizar, vaporizar-se
even = chão, chato, plano, raso, aplanar, alisar, nivelar, igual, parelho, acertar, ajustar, igualar, até, mesmo, até mesmo, desobrigado, quite, par, regulamentar, regular
evening = noite, tarde, véspera, vesperal
evening dress = casaca, fraque
evening meal = ceia
evening paper = vespertino
evening-primrose = enotera
Evening Star = Vênus
event = evento, acontecimento, acontecimento, ocorrência
eventual = contingente, eventual
eventuality = eventualidade
ever = um dia, uma vez, outrora, em todo o tempo, eternamente, sempre
ever = quer que
Everist = Evereste
everlasting = eterno, perpétuo
ever since = atrás de, desde, depois de
every = cada, cada um, toda a pessoa, todo
everybody = cada, cada um, toda a pessoa, todo
everyday = comum, ordinário, vulgar, batido, grosseiro
every kind of = cada espécie de, toda a qualidade, toda espécie de
every one = cada, cada um, toda a pessoa, todo
everyone's = de cada um, de todos
everything = cada coisa, tudo
everywhere = em toda a parte, em todo o lugar
evident = evidente, inequívoco, manifesto, óbvio, patente
evoke = evocar
evolution = evolução
evolve = evolucionar, evoluir, evolver
ex- = ex-
exact = certo, rigoroso, requisitar, afinado, correcto, correto, exacto, exato, preciso
exactitude = exactidão
exactly = pontualmente, precisamente, com precisão, exactamente, exatamente, justamente
exactness = precisão
exaggerate = exagerar
examination = exame, prova, teste
examine = ensaiar, examinar, inspecionar, revistar, buscar, escavar, explorar, investigar, pesquisar
example = exemplo
exceed = exceder, ser superior, superar, suplantar
excellency = <título geral de cortesia>
except = excepcionalmente, exceptuar, além de, com exclusão de, exceto de, fora
except for = além de, com exclusão de, exceto de, fora
exception = excepção
exceptional = excepcional
excess = demasia, excesso, exorbitância
excessive = demasiado, excessivo
exchange = central, câmbio, permutação, troca
exchange rate = câmbio, cotação
excise = imposto de consumo
excise-duty = imposto de consumo
excitation = excitação
excite = acirrar, aguçar, atiçar, estimular, excitar, inflamar, concitar, incitar, provocar
excitement = excitação doentia, excitação
exciting = excitante
exclude = deixar excluído, excluir, exceptuar
exclusive = exclusivo
exclusively = exclusive, não ... mais que, só, somente, apenas
excommunication = anátema, excomunhão
excrement = excremento, matéria fecal
excursion = excursão
excuse = desculpar, excusar, justificar
excuse me = desculpe, perdoe-me
excuse oneself = <por gentileza pedir escusas de alguém>
execute = executar
executioner = algoz, carrasco
exercise = ensaiar, exercer, exercitar, treinar, exercício
exercise-book = caderno, fascículo
exert = exercer, praticar
exhale = axalar, expirar
exhausted = esgotado
exhibit = apresentar, expor, expor
exhibition = exposição
exhortation = admoestação, repreensão
exile = banir, degredar, desterrar, exilar, exilado, proscrito, exílio
exist = existir, haver
existence = existência
exit = porta, saída, sair
Exodus = Êxodo
exotic = exótico
expansion = expansão
expect = aguardar, esperar, estar à espera de
expectation = espera
expedition = expedição
expel = afugentar, rechaçar
expense = gastos
expenses = gastos, despesas
expensive = caro
experience = experiência, lição da vida, atravessar, viver
experienced = experiente, perito, versado
experiment = fazer experiências, experiência, experimento
experimental = experimental
expert = experto, louvado, especialista, expert, competente, experiente, versado, perito
expire = acabar, terminar, falecer, morrer
explain = explicar
explanation = explicação
explode = estalar, explodir, fazer explosão, prorromper
exploit = explorar
exploration = exploração, investigação, pesquisa
explore = buscar, escavar, explorar, investigar, pesquisar
explosion = explosão
explosive device = explosivo
export = exportar
expose = apresentar, expor
exposition = exposição
express = expresso, expressar, exprimir
express condolences = dar pêsarmes a, expressar condolências a
expression = aparência, cara, expressão, fisionomia
expressway = auto-estrada, rodovia, autopista
extend = amplitude, amplidão, dimensão, extensão, grandeza, desdobrar, estender, espraiar, estirar
extension = sufixo
extensive = amplo, espaçoso, extenso, grande, lato
exterior = aparência, exterior
exterminate = abolir, eliminar, exterminar, extinguir, suprimir
external = adventício, exterior, externo
extinguish = apagar, extinguir
extort = extorquir
extra = extra, figurante
extract = extratar
extraordinary = extraordinário
extravagant = extravagante
extreme = extremo
extremely = extremamente, muitíssimo, sumamente
exult = dar gritos de alegria, jubilar-se ruidosamente
exultation = júbilo
eye = olho
eyebrow = sobrancelha, sobrolho, supercílio
eyelid = pálpebra