#setName = words_en_pt_dd.txt
#sideOneTitle = ENG
#sideTwoTitle = POR
dabbler = amador, diletanto, não profissional
dad = papai
daddy = papai
dagger = punhal
Daghestan = Daguestão
dahlia = dália
Dahomey = Daomé
daily = cotidiano, diário, quotidiano, de cada dia, ordinário, banal, diáriamente, dia a dia
daily paper = jornal
dainty = brando, delicado, fino, grácil, meigo, mimoso, sutil
dairy = leitaria, leiteria
daisy = mal-me-quer, margaridinha
Dalmatia = Dalmácia
Dalmatian = dálmata
dam = barragem
damage = arruinar, avariar, danificar, deteriorar, estragar, avaria, dano, estrago
Damascus = Damasco
dame = dama, mulher, senhora
damn = condenar ao inferno, danar, tornar maldito
Damocles = Dâmocles
damp = úmido, húmido
dam up = deter, represar
dance = bailar, dançar, baile, dança
dancer = dançarina, dançarino
dandelion = dente-de-leão
dandy = almofadinha, janota, dândi
Dane = dinamarquês
danger = perigo, risco
dangerous = arriscado, perigoso
Danish = dinamarquês
Danube = Danúbio
daphne = dafne
dare = atrever-se, aventurar-se a, ousar, ter coragem de
daring = audaz, arriscado, ousado, audácia
dark = escuro
dark blue = azul-ferrete
darkness = escuridão, trevas
dark-room = câmera escura, quarto sem janela
darling = amado
darn = com os diabos
dash-board = painel
data = material
date = tâmara, datar, data, rendez-vous
date-palm = tamareira
date palm = tamareira
daughter = filha
David = Davi, David
dawn = aurora, madrugada, romper do dia, amanhecer
day = dia
daybreak = madrugada, romper do dia, amanhecer
daydream = devanear, fantasiar, sonhar, devaneio, sonho
daylight = <luz do sol durante o dia>
dazzle = cegar
deacon = diácono
dead = mortal, sem vida, morto
deaden = amortecer, amortizar
deaf = surdo
deal = distribuir
deal in secondhand goods = alborcar
deal with = agenciar, tratar
dean = deão, decano
dear = querido, caro
death = morte, óbito
death throes = agonia, ânsia, passamento
debate = debate, discussão
debauch = viver em farra, viver no deboche
debauchery = farra, deboche, dissipação
debit = débito, deve
debris = escombros, destroços, ruínas
debt = dever, dívida
decade = década
decametre = decâmetro
decant = decantar
decanter = garrafa, jarra
decayed = caduco, decrépito, frágil
Deccan = Decão
deceitful = enganador, falaz
deceive = enganar, iludir, lograr, burlar, embair, fraudar, ludibriar
deceived one = enganado
deceived person = enganado
deceiver = enganador
December = Dezembro
decent = conveniente, decoroso, próprio
decently = como é justo, como se deve, decentemente
deceptive = enganoso
decide = decidir, deliberar, dirimir, haver por bem, julgar, resolver
decimetre = decímetro
decipher = decifrar
decision = decisão
decisive = decidido, resoluto, decisivo
deck = coberta, convés
declaim = declamar, recitar
declaration = declaração, declaracão, depoimento
declaration of policy = programa
declare = declarar, declinar, depor
decoction = decocção
décor = decoração
decorate = fazer decoração, adornar, decorar, ornamentar
decoration = decoração
decoy = atrair, engodar, seduzir
decrease = abaixar
decree = decretar, decreto
decrepit = caduco, decrépito, frágil
dedicate = consagrar, dedicar, oferecer, votar
deduce = concluir, deduzir, inferir
deduct = descontar, tirar
deem = acreditar, crer, julgar, opinar, ser de opinião, observar, mirar, olhar
deep = entranhado, fundo, profundo
deer = cervo, veado
defeat = derrota, debelar, derrotar, levar de vencida, sobrepujar, superar
defecate = defecar
defence = <destacamento que protege a retaguarda de um exército>, defesa
defend = defender, proteger, pugnar por, resguardar
defendant = acusado
defense = defesa
defiantly = por acinte, por desafio
deficit = deficit
defile = desonrar, profanar, violar
define = definir, designar, destinar, determinar, fixar, indicar, marcar
definite = decisivo, definitivo
definite article = artigo definido
definitely = definitivamente, absolutamente, impreterivelmente, infalivelmente, sem falta
definition = definição, designação, fixação
definitive = decisivo, definitivo
defraud = defraudar
defy = arrostar, desafiar, provocar, reptar
degenerate = corromper-se, degenerar
degrade = degradar, rebaixar
degree = grau, cabeçalho, epígrafe, título, tratamento
delay = atraso, adiar, procrastinar, adiamento, demora, protelação
delegate = delegar, deputar, delegado, deputado
delegation = embaixada, delegação
delete = apagar, varrer, enxugar, limpar
Delhi = Deli
deliberately = de propósito, intencionalmente, deliberadamente
delicacy = acepipe, guloseima
delicate = brando, delicado, fino, grácil, meigo, mimoso, sutil
delight = embevecer, encantar, extasiar
delightful = encantador, maravilhoso
delight in = desfrutar, fruir, gozar
delirious = delirante
delirium = delírio
deliver = dar, entregar, fornecer, ministrar
delta = delta
delude = iludir
deluge = dilúvio
delusive = enganoso
deluxe = luxuoso, luxuriante
de luxe = luxuoso, luxuriante
demand = boa aceitação, saída fácil, exigir, postular, reclamar
Demeter = Deméter
demigod = semideus
democracy = democracia
democrat = democrata
democratic = democrático
demon = demo, demônio
demonic = demoníaco, diabólico
demonstrate = demonstrar, apresentar, expor, fazer manifestação, declarar, manifestar
demonstration = demonstração, manifestação
demonstrative = demonstrativo
demonstrative pronoun = demonstrativo
den = cabana, casebre, choça, caverna, furna, ninho
Denmark = Dinamarca
denounce = delatar, denunciar
dense = basto, cerrado, compacto, denso, espesso
dental = dentário
dentist = dentista
deny = dizer não, negar
deny oneself = abnegar
depart = pôr-se a caminho, afastar-se, ausentar-se, partir, retirar-se
department = departamento, compartimento, especialidade, secção
departure = partida
depend = depender
depend onldepend upon = depender de
depict = figurar, representar
deport = deportar
deportment = comportamento, conduta, procedimento
depose = destronar
deposit = depositar
depository = depósito, armazém
depress = abater, deprimir, desanimar
depression = depressão, crise
depth = fundo, profundeza, profundidade
deputation = delegação
depute = deputar
deputy = deputado
derive = fazer vir de, derivar, provir, vir de
descend = descer
describe = descrever
descry = avistar, divisar
desert = deserto, ermo, páramo, tapera, abandonar
deserve = merecer, valer
deserving = digno
design = descrever, desenhar, traçar, desenho, plano, planta, posição, projeto, esboço
desirable = desejável
desire = desejar, pretender, querer, anseio, desejo, pretensão
desk = estante, carteira, escrivaninha
desolate = entristecedor, melancólico, nebuloso
despair = desesperar, perder a esperança, desespero
desperate = desesperador, desesperado
despise = desprezar, querer mal
despite = a despeito de, apesar de, não obstante, por acinte, por desafio
despot = déspota
despotic = autocrata, despótico, tirano
dessert = sobremesa
destine = aprazar, destinar, reservar
destiny = destino, sina, sorte
destroy = defazer, demolir, destruir, subverter
destruction = destruição
detachment = destacamento, equipe, turma, turno
detail = detalhe, minúcia, particularidade
detailed = circunstanciado, detalhado, pormenorizado
detain = deter, reter
detective = detective, investigador
detention = prisão
deter = afugentar, enxotar
determine = definir, designar, destinar, fixar, indicar, marcar, aprazar, cravar, determinar, fixar
Deuteronomy = Deuteronômio
develop = engendrar, estabelecer, pruzir, provocar, evolucionar, evoluir, evolver, revelar
developing country = país em desenvolvimento
development = evolução
deviate = apresentar aberração
deviating = anômalo
deviation = diferença, erro
device = aparelho, máquina
devil = diabo
devilish = diabólico
devote = consagrar, dedicar, oferecer, votar
devoted = dedicado
dew = orvalho, rocio
dexterous = ágil, hábil, jeitoso
dharma = darma
diabetes = diabete
diabolical = diabólico
diagram = figura, imagem, vulto configuração, plano, planta, posição, projeto
dial = mostrador de relógio, discar, disco
dialect = dialecto
dialogue = diálogo
diameter = diâmetro
diamond = diamante
Diana = Diana
diarrhoea = diarréia
diary = diário
dice = cortar em pedaços pequenos
dictate = dictar
dictator = dictator
dictatorship = dictadura
dictionary = dicionário
die = falecer, morrer, dado, dado de jogar
diesel = motor Diesel
diet = dieta
dietary = dietético
differ = diferir, ser diferente
difference = diferença
different = desigual, díspar, diferente
differentiate = diferenciar
difficult = afanoso, difícil, dificultoso
difficulty = dificuldade
dig = desenterrar, exumar, cavar, revolver
digest = digerir, fazer digestão
digestion = digestão
digit = algarismo, cifra, número
dignified = digno
dignity = brio, decoro, dignidade, pundonor
dig up = desenterrar, exumar
dike = dique
dilapidated = caduco, decrépito, frágil
dilemma = dilema
dilettante = amador, diletanto, não profissional
diligent = aplicado, assíduo, diligente, esforçado
dill = aneto
dilute = adulterar
Diluvium = diluvião
dim = escuro
dimension = amplitude, amplidão, extensão, grandeza, dimensão
diminutive = pequeno
din = barulho, ruído
dining-room = refeitório, sala de jantar
dinner = jantar, almoço
Diogenes = Diógenes
dip = imergir
diploma = acto, auto, escritura, instrumento, diploma
diplomat = diplomata
direct = encaminhar, gerir, governar, conduzir, dirigir, guiar, direito, direto, reto
direction = direcção
directions = instrução
directly = directamente, diretamente
director = director, regente
directory = catálogo
dirty = sujo
dis- = in-
disabled = inválido
disabled person = inválido
disappear = desaparecer, sumir-se
disappearance = desaparecimento
disappoint = desiludir-se, desenganar-se, desiludir
disappointment = aflição, amargura, dor, pena, pesar
disapprobation = reprovação
disapproval = reprovação
disapprove = desaprovar, reprovar
disapprove of = desaprovar, reprovar
disarm = desarmar
disc = disco
discharge = demitir, destituir, exonerar, despedir
discharge pus = supurar
disciple = discípulo
disciples = <grupo não organizado>
discipline = disciplina
discount = abater, descontar, abatimento, desconto
discourage = afugentar, enxotar
discover = descobrir, desvendar, revelar
discovery = descobrimento
discuss = discutir, tratar de
discussion = discussão
disease = doença
disembark = desembarcar-se
disgust = náusea
disgusting = nauseante
dish = travessa, prato, travessa
dish cloth = pano de limpeza
dishevel = arrepiar, desembaraçar, dilacerar, retorcer, revolver
disinfect = desinfectar
disintegrate = dividir, separar
dislike = antipatia, ojeriza, quezília, repugnância
dislocate = luxar
dismal = repugnante, banal, comun, trivial, vulgar, coitado, lastimável, desagradável, enjoado, abominável, horrível, horrendo, sombrio, triste, macambúzio, miserável, entristecedor, melancólico, nebuloso
dismay = atordoar, bestificar, desconcertar
dismiss = demitir, destituir, exonerar, despedir
dismount = apear-se, descer do cavalho
disorder = desordem
dispassionately = friamente, insensivelmente
dispatch = noticiar por despacho, aviar, despachar, expedir
dispensing chemist = farmacêutico
display = alardear, desfilar, formar em parada, parada, ostentação
disposal = afeição, inclinação
dispose of = ceder, colocar, vender
disposition = disposição, talento, engenho
dispute = contender, disputar, porfiar, disputa
disquiet = causar perturbação, perturbar, perturbação
dissemble = fingir, proceder com hipocrisia
disseminate = disseminar, espalhar
dissipation = farra, deboche, dissipação
dissolve = solver, dissolver, resolver
distance = distância
distant = afastado, distante
distil = distilar
distinct = claro, distinto
distinction = distinção
distinctive = distinto, excelente
distinguish = diferençar, distinguir
distract = desviar a atenção, distrair, divertir, entreter
distraction = distracção
distribute = distribuir
distribution = distribuição
district = circunscrição administriva, comarca, districto, termo, bairro
disturb = importunar, incomodar, molestar
disturbance = perturbação
ditch = cava, fossa
divan = divã
dive = mergulhar, afogar-se
diver = mergulhador
divergent = anômalo
diverse = diverso, vário, que oferece várias aspectos
diversion = distracção
divert = desviar a atenção, distrair, divertir, entreter
divide = apartar, separar, separar, desmembrar, dividir, repartir
divine = divino
division = divisão
divorce = divórcio
dizziness = tontura, vertigem
dizzy = que causa vertigem
do = fazer, formar, executar, cometer, confeccionar, frisar
do a favor = dispensar favores a, obsequiar, servir
do a favour = dispensar favores a, obsequiar, servir
do away with = afastar, banir
dock = doca, recolher à garagem
doctor = doutor, escriba, facultativo, médico
document = acto, auto, escritura, instrumento, documento
doe = corça
dog = cão
dogma = dogma
doll = boneca, boneco
dollar = dólar
Dolomites = Dolomitas
dolphin = boto, delfim, golfinho
dome = cúpula, zimbório, abóbada
domestic = relativo ao país mesmo, familiar
dominate = dirigir, dominar, possuir, reger
Dominica = Dominica, Domingos
dominion = domínio
donate = brindar, doar, fazer doação de, oferecer, presentear
Don Juan = dom-joão
donkey = asenino, asno, besta, burro, jumento
donkey- = asenino
donkey-driver = almocreve
Don Quixote = dom-quixote
don't mention it = de nada, não há de que, não importa, pouco importa
door = porta
do penance = fazer penitência
Dorian = dórica
Doric = dórica
dose = dose
do something crooked = agir como patife
dossier = dossiê
dot = ponto
double = dúplice, duplo, dobrar
doubt = duvidar, estar em dúvida, ter dúvida, dúvida, incerteza
doubtful = aleatório, duvidoso, que merece dúvidas
dough = massa, pasta
dove = pombo
down = lanugem, pêlo, penugem, para baixo
downstairs = abaixo, para baixo
dowry = dom, dote
doze = cochilar, dormitar
dozen = dúzia
draft = letra de câmbio, rascunho, saque
drag = sacar, tirar, arrastar, levar de rastos, puxar
dragon = dragão
drain = drenar
draining = drenagem
dram = aperitivo
drama = drama
drape = armar, cobrir, drapejar, guarnecer de armação, revestir
drastic = drástico, enérgico, violento
draw = descrever, desenhar, igualdade, atrair, riscar, traçar, sacar, puxar, tirar
draw attention = chamar a atenção de
draw back = retirar, retrair
drawer = gaveta
drawers = cuecas, calças, ceroulas
drawing = desenho
draw lots = sortear, tirar a sorte
dreadful = horrível, terrível
dream = devanear, fantasiar, devaneio, sonhar, sonho
dreary = repugnante, deserto, ermo, desagradável, enjoado, abominável, horrível, horrendo, sombrio, entristecedor, melancólico, nebuloso, triste, macambúzio
dress = aplicar curativo, pensar, beca, vestido, cobrir, vestir, revestir, vestir-se
dress-coat = casaca, fraque
dresser = cômoda, cómoda
drift = derivar
drill = abrir buraco, brocar, furar, perfurar
drink = beber em excesso d'alcoólico, bebida, beber, libar
drinkable = potável
drink to excess = beber, beber em excesso d'alcoólico
drip = pingar, gota, pingo
drive = tanger, tocar, conduzir, transportar
drive away = afugentar, rechaçar, ausentar-se, partir
drive off = ausentar-se, partir
drive on = tanger, tocar
driver = piloto, condutor, motorista, cocheiro, boleeiro, chofer
dromedary = dromedário
droop = estar pendente, pender
drop = gota de água, cair, desabar, tombar, ruir, derrubar, gota, pingo
droplet = gotícula
drop of water = gota, gota de água
drown = afogar-se, imergir-se, sossobrar, submergir-se, afogar, imergir, mergulhar, meter a pique
drug = droga, remédio, entorpecente, narcótico, estupefazar, narcotizar
drugstore = botica, farmácia
drum = tambor, caixa de rufo
drummer = <pessoa que toca tambor>
drunk = embriagado, ébrio, bêbado
drunkenness = bebedeira, ebriedade, embriaguez
dry = árido, enxuto, seco, enxugar, secar
dual = dúplice, duplo
duchess = duquesa
duchy = ducado
duck = anás, pato
dude = almofadinha, janota, dândi
dues = cota
duke = duque
dull = embrutecer, estúpido, imbecil, tolo, obtuso
dumb = calado, mudo
dump = derramar, entornar
dung = excremento, matéria fecal
Dunkirk = Dunquerque
duplicate = multiplicar
during = durante
during the day = de dia, durante o dia
dusk = anoitecer, crepúsculo
dust = pó, poeira
dust rag = pano de limpeza
Dutch = holandês
Dutchman = holandês
duty = dever, obrigação
dwarf = nanico, anão
dwell = estar hospedado, habitar, morar
dwelling = aposento, habitação, morada
dwelling-place = domicílio
dwelling-place-residence = domicílio
dye = tinta, cor, tingir, tintura
dynamite = dinamite
dyspepsia = dispepsia, indigestão
dysprosium = disprósio