#setName = words_en_pt_Bb
#sideOneTitle = ENG
#sideTwoTitle = POR
Baal = Baal
Babel = Babel, Babilônia
baboon = babuíno, bugio, cinocéfalo
baby = bebê, criancinha
Babylon = Babel, Babilônia
Babylonia = Babilônia
baby's bottle = mamadeira
Bacchus = Baco
bachelor = celibatário, solteiro
back = costas, dorso, para trás
back and forth = para lá e para cá
background = fundo
back of the neck = cerviz, nuca
backpack = alforje, mochila, sacola
backside = garupa, traseira
backwards = para trás
bacon = lardo, toicinho, toucinho
bacterium = bactéria
bad = mau, ruim, podre, pútrido
badge = insígnia
badly = mal
Baffin Bay = Baía de Bafim
bag = saco
bagasse = bagaço
baggage = bagagem, embrulho
Baghdad = Bagdá
bah = ai, bah
Bahama Islands = Bahamas
Bahamas = Bahamas
Bahrein = Barém
Baikal = Baical
bairn = criança
bait = engodo, isca
bake = assar, cozer, fornear
baked goods = fornada, pastelaria
bakelite = baquelite
baker = padeiro
bakery = padaria
balalaika = balalaica
balance = balanceiro, balançar-se, ondular, oscilar, saldo
balance sheet = balanço
balata = balata
balcony = balcão, sacada
bald = calvo, careca
baldachin = baldaquim, dossel, pálio
Balearic Islands = Baleares
Bali = Bali
Balkans = Balcãs
ball = baile, globo, orbe, bola, seringa, esfera, tenar
ballad = balada, xácara
ballade = balada, xácara
ballast = lastro, balastro, estiva
ball-bearing = bola, globo, orbe
ballerina = bailarina
ballet = bailado, balé
ballet dancer = bailarina, bailarino
ballet girl = bailarina
ballistics = balística
ball of the thumb = tenar
balloon = aeróstato, balão
ballot = eleição, escrutínio
balloting = eleição, escrutínio
ballpoint pen = caneta esferográfica
balm = balsâmico, bálsamo
balsam = balsâmico, balsâmina, bálsamo
Baltic Sea = Mar Báltico
bamboo = bambu, cana-brava, taboca, taquara
ban = anátema, excomunhão
banality = coisa banal, trivialidade, vulgaridade, banalidade
banana = banana
banana-plant = bananeira
banana plant = bananeira
band = bando, cáfila, facção, malta, quadrilha, súcia
bandage = ligadura, venda, penso, atadura, bandagem, enfaixar, enrolar, envolver, pensar, vendar
bandit = bandido, bandoleiro, cangaceiro, facínora
Bangkok = Bancoc
banjo = banjo
bank = banco, borda, margem, banco de areia
bank clerk = banqueiro
banker = banqueiro
bank manager = banqueiro
banknote = cédula, nota
bank-note = cédula, nota
bank note = cédula, nota
bank official = banqueiro
bankrupt = falido
bankruptcy = falência, quebra
banner = bandeira, pavilhão
banquet = comer em banquete, ágape, banquete
banyan = figueira-da-índia
baobab = adansônia, baobá, baobabe, embondeiro
baptism = batismo
baptist = batista
baptistery = batistério
baptize = batizar
bar = barrar, interceptar, tapar, trancar, bária, briquete, atrapalhar, prejudicar, bar
barbarian = bárbaro
barbaric = bárbaro, cruel, desalmado
barbarism = barbarismo
barbarity = acto de bárbaro, barbaria, barbaridade
barbarousness = barbaria, barbaridade
barbed-wire = arame farpado
barbed wire = arame farpado
barbel = barbo
barber = barbeiro, cabeleireiro, frisador
barberry = bérberis, uva-espim
Barcelona = Barcelona
bard = bardo
bare = despido, nu
barely = apenas, logo que, mal, quase não
Barentsz Sea = Mar de Barents
bargain = pechinchar, regatear
barge = barcaça
baritone = barítono
barium = bário
bark = barco, ladrar, latir, casca, crosta
barley = cevada
barn = barraca, celeiro, guarita, tenda
Barnabas = Barnabé
barometer = barômetro
baron = barão
baroness = baronesa
barony = baronia
baroque = barroco
barque = barco
barrack = barraca
barracks = caserna, quartel
barrel = barrica, barril, casco, pipa, cano, canudo, tubo
barricade = barricar, barricada
barrier = barreira, obstáculo, bária
barrister = advogado
barrister-at-law = advogado
Bartolomew = Bartolomeu
basalt = basalto
base = apoio, base, fundamento, basear, dar base
baseball = beisebol
Basel = Basiléia
basement = adega, despensa
basic = basal, basilar
basil = basílico
basilica = basílica
basin = lago, alguidar, bacia, tijela
basis = apoio, base, fundamento
basket = cesta, cesto
basketball = basquete
Basle = Basiléia
Basque = basco
bas-relief = baixo-relevo
bass = baixo
bass voice = baixo
bast = entrecasca, liber
bastard = bastardo
bastardy = bastardia, degeneração
bastion = baluarte, bastião
bat = morcego
Batavia = Batávia
Batavian = batavo
Batavian Republic = República Batávica
bath = banheira, banho
bathe = banhar, molhar, banhar-se
bathing-suit = fato de banho, roupa de banho
bathing suit = fato de banho, roupa de banho
bathroom = quarto de banho, banheiro, quarto de banho, sala de banho
batiste = batista, cambraia
baton = bastão, bengala, bordão, cacete, pau
battalion = batalhão
battery = acumulador, bateria
battle = batalha, combate, luta, peleja, pugna
battlefront = frente, fronte, vanguarda
baud = baud
bauxite = bauxita
Bavaria = Baviera
Bavarian = bávaro
bay = baía
bayonet = baioneta
bazaar = bazar, feira, mercado, <grande estabelecimento comercial>
bazooka = bazuca
be = achar-se, estar, existir, ser
be able to = poder, ter a faculdade de
be about = circular
be absent = estar ausente, faltar
beach = praia
be acquainted with = conhecer, saber
bead = conta
be adrift = derivar
be advised = informar-se
be afraid of = recear, temer, ter medo de, acanhar-se
be a guest of = hospedar-se
be a hit = estar em voga
be ailing = estar doente
beak = bico
be alive = viver
beam = raio, barrote, biga, trave
bean = fava
be appropriate = convir, ser apropriado, ser conveniente
bear = baixista, aguentar, agüentar, tolerar, dar a luz, parir, padecer, sofrer, suportar, urso
beard = barba
bearded = barbado, barbudo
beardless = imberbe, glabro
bear fruit = frutificar
bear's-ear = arícula
bear witness of = atestar, certificar, provar, testemunhar
be ashamed = envergonhar-se, vexar-se
be asleep = dormir
beast = animal selvagem, fera, alimária, animal, besta, bicho
beastly = animal
beast of prey = animal carnívoro'besta-fera
beat = bater, dar pancada, maçar, malhar
be at loggerheads = batalhar uns contra os outros
beat off = debater, discutir
beautiful = belo, bonito, formoso, pulcro
beautifully = em bela maneira
beautiful woman = mulher bela
beauty = beleza, bel, belo, mulher bela
beaver = castor
be aware of = ser consciente de, ter consciência de
be bankrupt = falir, fazer bancarrota, quebrar
be beaten = tornar-se vencido
be bold = ousar, ter coragem de
be bored = aborrecer-se, enfadar-se, enfastiar-se
be born = nascer, vir à luz
be burnt down = <ser inteiramente consumido pelo fogo>
because = por isso que, pois, pois que, porque, visto que
because of = em troca de, pro causa de
Bechuanaland = Botsuana
be closed = fechar-se
become = fazer-se, tornar-se, vir a ser, acontecer
become accustomed = acostumar-se, habituar-se, tomar a costume
become disillusioned = desiludir-se
becoming = adequado, apropriado, conveniente
be conscious of = ser consciente de, ter consciência de
bed = canteira, leira, quadra, cama, leito
bedbug = percevejo
be defeated = tornar-se vencido
be delirious = delirar, divagar, tresvariar
be dependent on = depender de
be different = diferir, ser diferente
Bedouin = beduíno
bedroom = dormitório, quarto da dormir
bed-wetting = enuresia, enurese
bee = abelha, colméia
beech = fago, faia
beef = carne de boi
be effective = actuar, agir, produzir efeito, ser eficaz
beefsteak = bifsteque
beehive = colméia, cortiço
bee-keeper = apicultor
bee-keeping = apicultura
bee-master = apicultor
be encamped = acampar
beer = cerveja
beet = beterraba
beetle = escaravelho
beetroot sugar = açúcar de beterraba
beet sugar = açúcar de beterraba
befit = convir, ser decente, ser próprio
be fitting = convir, ser decente, ser próprio
before = diante de, em frente de, em presença de, perante, antes de, antes que
be found = sencontrar-se, achar-se, encontrar-se, estar
beg = pedir esmolas, pedir
beget = gerar, procriar
beggar = mendigo, pedinte
begin = iniciar, começar
beginning = princípio
be glad = alegrar-se, regozijar-se
begonia = begônia
begrudge = ter medo de gastar
beguinage = beguinaria
beguine = beguina
behave = agir, comportar-se, proceder
behavior = comportamento, conduta, procedimento
behaviour = comportamento, conduta, procedimento
behind = detrás de, atrás, após, atrás de, depois de, por trás de
behind the scenes = atrás dos bastidores
behold = eis, eis aí, eis ali, eis aqui
be horrified = sentir horror
be hungry = ter fome
be in = estar em voga
be inclined = estar inclinado a
be indignant = indignar-se, sentir indignação
be in labour = dar à luz, parir, ter
be in opposition = estar em oposição, fazer oposição
be interested = interessar-se
be in the habit of = costumar, estar habitado a, ter o costume de
be jealous = ter ciúmes
bel = belo, bel
be lacking = falhar, faltar, escassear
be late = estar atrasado
belch = arrotar
be lenient with = poupar, ser indulgente para
Belgian = belga
Belgium = Bélgica
Belgrade = Belgrado
belief = convicção, crença
believe = acreditar, crer
Belize = Belisa
bell = campainha, sino, guizo
belladonna = beladona
belles-lettres = belas-artes, literatura
bellflower = campânula
Bellona = Belona
bellow = balar, berrar, bramir, gritar, grunhir, mugir, ornear, uivar
bellows = fole
belly = abdome, abdômen, barriga, pança, ventre
be located = sencontrar-se, achar-se, encontrar-se, estar
belong to = caber a, ser de, tocar a, pertencer
be lost = perder-se
beloved = amada, namorada, amado
below = para baixo, abaixo de, debaixo de, por baixo de, sob, abaixo
belt = cinto, cós, zona, cinta, cintura
be married = casar-se, casarem-se
be master over = dirigir, dominar, possuir, reger
be missing = estar ausente, falhar, faltar, escassear
Ben = Benedito
bench = banco, bastidor, cavalete, mesa
bend = dobrar, torcer, arquar, curvar, arco, curva, volta
be near death = agonizar
beneath = abaixo de, debaixo de, por baixo de, sob
Benedict = Benedito
Benedictine = beneditino
Benedictine monk = beneditino
benefit = benefício, utilidade, vantagem
benefit performance = benefício
Benelux = Benelux
Bengal = Bengala
benign = benigno
Benjamin = Benjamim
bent = curvo, sinuoso, tortuoso
benzene = benzeno
be obstinate = obstinar-se, teimar
be on duty = estar de plantão, estar de serviço, montar guarda, estar de sentinela
Beotia = Beócia
be painful = causar dor, doer
be patient = ter paciência
be present = estar pressente, assistir, estar presente
be proud = ter ogulho
be proud of = ter orgulho de
bequeath = legar, testar
be quiet = calar-se
Berber = bérbere
beret = barrete, borla
bergamot = bergamota
Bering Sea = Mar de Bering
Bering Strait = Estreito de Bering
berkelium = berquélio
Berlin = Berlim
Bermudas = Bermudas
Berne = Berna
berry = baga
beryl = água-marinha, berilo
beryllium = berílio
beseech = implorar, suplicar
beside = junto de, perto de, próximo a, ao lado de, a, ao pé de, em, entre, junto a
besides = aliás, além de, com exclusão de, exceto de, fora, além disso, demais, em continuação, mais, mais adiante
besiege = assediar, cercar, sitiar
be situated = estar situado
be sorry about = deplorar, lamentar, sentir, ter pena
Bessarabia = Bessarábia
bestial = animal
best-seller = bestseller
be stubborn = obstinar-se, teimar
be succesful = prosperar
be suitable = ser apropriado, ser conveniente, convir, prestar-se, servir, valer
bet = apostar, aposta
beta = beta
be thirsty = estar sequioso, ter sede
Bethlehem = Belém
be tired of something = aborrecer-se, enfadar-se, enfastiar-se
betony = betônica
betray = atraiçoar, trair
betrayal = traição
between = entre, no meio de
be vacant = estar vago, vacar, vagar
be valid = estar em vigor, ser válido, ter valor, valer
beverage = bebida
bevy = are, colecção, grupo, reunião, bando, cáfila, facção, malta, quadrilha, súcia
be well = <estar bem de saúde>, estar bom, estar com saúde
be willing to = querer, ter vontade de
bewitch = enfeitiçar
be worth = ter valor de, valer
be worthy of = merecer, valer
beyond = depois, em seguida, logo, além, ao lado de, por diante de, além de, através de, do outro lado de, para lá de
Beyrouth = Beirute
Bhutan = Butã, Butão
biased = parcial, tendencioso
bible = bíblia
bibliography = bibliografia
bicuit = torrada
bicycle = bicicleta, biciclo, ciclo
bid = oferecer, pedir
big = grande, magno, maiúsculo
bike = bicicleta, biciclo, ciclo
bikini = biquíni
bile = bile, bílis
bilk = charlatanear, fazer charlatanismo
bill = bico, bilhete, cupom, ficha, passagem, factura, nota
bill-board = quadro de avisos
billiards = bilhar
bill of exchange = letra de câmbio
billow = vagalhão
binary = binário
bind = encadernar, amarrar, atar, ligar
binding = coirela, faixa, fita, listrão, encadernação
binocular = luneta
binoculars = binóculo, luneta
biographer = biografista, biógrafo
biologist = biólogo
biosphere = biosfera
biped = bípede
birch = bétel, vidoeiro
bird = ave, pássaro
birth = nascimento
birthday = aniversário, aniversário natalício
Biscay = Biscaia
biscuit = biscoito
bishop = bispo
bismuth = bismuto
bison = bisão, bisonte
Bissau = Bissau
bit = abita, bocado, pedaço, naco
bitchy = cruel, megera, perversa
bite = bocado, atacar metais, dar dentadas, morder, rilhar
bit-player = comparsa, figurante
bitter = amargoso, amaro, amargo
bitterness = amargor, amargura
bittersweet = agridoce
bizarre = barroco, bizarro, excêntrico, esquisito
black = negro, preto
blackbird = melro, toutinegra
black radish = rábano
Black Sea = Mar Negro
bladder = bexiga, bolha, empola
blade = pá, haste, talo
blame = acusar, culpar, culpa, delito, falta, censurar, incriminar, repreender
blameworthy = reprovável
blanch = alvejar, branquear, corar, embranquecer
blank = branco, formulário
blank cheque = assinatura em branco, carta branca
blanket = coberta, cobertor, colcha
blaspheme = blasfemar, maldizer, praguejar
blasphemer = blasfemo
blasphemy = blasfêmia
bleak = desagradável, enjoado, sombrio, triste, macambúzio, frio, melancólico, escalvado
bleat = balar, berrar, bramir, gritar, grunhir, mugir, ornear, uivar
bleed = sangrar
blend = baralhar, mesclar, mexer, misturar
bless = abençoar, bendizer, benzer
blessing = benção
blind = cego
blindness = cegueira
blindworm = ânguis, cobra-de-vidro
blink = pestanejar, piscar
blister = bolha, vesícula
block = bloquear, cercar com blocos, bloco, massa, peça, cepo, talho, arrolhar, tampar, tapar
blockade = bloqueio, bloquear, cercar com blocos
blond = flavo, loiro, louro
blood = sangue
blood-relationship = parentesco
bloody = sanguíneo, sangüíneo
bloom = flor
blot = mácula, mancha, nódoa
blotter = mata-borrão, papel mata-borrão
blotting paper = mata-borrão, papel mata-borrão
blouse = blusa
blow = golpe, pancada, excitar soprando, soprar
blow up = causar explosão
blue = azul
Bluebeard = Barba Azul
Blue Nile = Nilo Azul
blunt = cego, embotado, obtuso, adoçar, aliviar, amortecer, embotar, mitigar, desafiado
blush = corar
blushing = rubro, vermelho
boa = boa, jibóia, boá
board = placa, prancha, tábua
boarding house = pensão
boarding school = pensão
board of directors = directoria
boast = fanfarrear
boat = barco, batel, bote, canoa, escaler
bobbin = bobina, carretel, carrinho
body = corpo
Boer = bôer
Bohemia = Boêmia
Bohemian = boêmio
boil = estar em embulição, aferventar, ferver, fazer decocção de
boiler = caldeira, caldeirão
bold = audaz, arriscado, ousado, encorpado, espesso, grosso, volumoso, intrépido
boldness = audácia
Bolivia = Bolívia
Bolshevik = bolchevista
bolt = aferrolhar, ferrolho, tranca
bomb = bomba
bombard = bombardear
Bombay = Bombaim
bonbon = bombom
bon-bon = bombom
bond = laço, liga, ligamento, vínculo
bone = osso
bonnet = capô, capote
bonus = bonificação
book = livro, encomendar, pedir, reservar
bookcase = estante para livros
book collection = conjuto de livros
book-keeper = guarda-livros
book-keeping = escrituração, contabilidade
booklet = opúsculo
bookseller = livreiro
bookshop = livraria
bookstore = livraria
boon = benção
boor = indivíduo impertinente
boot = bota
booty = pilhagem, presa, rapina
booze = bebida alcoólica
boozer = bêbado
borax = bórax
Bordeaux = Bordéus
border = margem, fronteira, limite, beira, margem, borda
bore = abrir buraco, brocar, furar, perfurar, broca, causar aborrecimento, aborrecer, enfadar, entediar, cansar, maçar, cacetear
boring = aborrecedor, aborrecido, enfadonho, fastidioso
Borneo = Bornéu
boron = boro
borrow = tomar por empréstimo, emprestar
borscht = sopa russa de beterraba
borstch = sopa russa de beterraba
Bosnia = Bósnia
Bosnia-Hercegovina = Bósnia-Erzegóvina
bosom = colo, peito, tórax, seio
Bosporus = Bósforo
boss = director, amo, dono, patrão, senhor, chefe, principal
bossa nova = bossa nova
Boston = Bóston
botany = botânica
botch = borrar, fazer às pressas, trabalhar mal
both = ambos, as duas, os dois, um e outro, uma e outra
both ... and = tanto ... como
bother = importunar, incomodar, molestar
Botswana = Botsuana
bottle = botelha, garrafa, engarrafar
bottom = fundo
bough = galho, ramo
bouillon = caldo, olha
boulder = rocha, rochedo
boulevard = bulevar
boundary = confins, fronteira, limite, raia
bouquet = ramalhete, ramo
Bourdeaux = Bordéus
bourgeois = burguês
boutique = armazém, loja
bovine = animal bovino, boi
bovine animal = animal bovino, boi
bow = arco, proa, reverenciar, mesura, reverência
bowl = alguidar, bacia, tijela
box = bater-se a socos, jogar boxe, boxear, arca, baú, mala, caixa, continente, jarro, vasilha, vaso
boxer = boxeador, pugilista
boxing = boxe
box-tree = buxo
boy = menino, rapaz, criado, servente, servidor
boyscout = escoteiro
boy scout = escoteiro
bra = porta-seios, sutiã
Brabant = Brabante
brace = armação, armadura, grampo, parêntese
bracelet = pulseira, bracelete, abraço
braces = alças, suspensórios
bracket = grampo, parêntese
brag = fanfarrear
braid = trançar, entrançar
braille = sistema Braille
brain = cérebro
brake = frear, travar, freio, travão
brakedown = pane
Bramaputra = Bramaputra
branch = galho, ramo, desgalhar, compartimento, especialidade, secção, filial, sucursal
brandish = agitar, bater, mexer, vibrar
brandy = cachaça, parati, pinga, aguardente, conhaque
brass = latão, quím
brat = galopim, gaiato
brave = animoso, bravo, honesto, leal, valente, valoroso, afoito, arrojado, corajoso
bray = zurrar
Brazil = Brasil
Brazilian = brasileiro
breach = fazer mossas, brecha, fenda
bread = pão
break = pausa, suspensão, partir, quebrar, rasgar, romper, partir-se
breakable = frágil, quebradiço
break-down = enguiçar
break down = alterar-se, danificar-se, deteriorar-se, estragar-se
break down upon = dirigir-se a, encaminhar-se para
breakfast = café-da-manhã, pequeno almoço, primeiro almoço
break up = apartar-se, separar-se
bream = brema, brema-do-mar, goraz, sargo
breast = colo, peito, seio, tórax, mama, teta
breath = sopro, suspiro
breathe = espirar, respirar
breed = cultivar, melhorar, criar, educar, casta, estirpe, raça
breeze = vento brando, aragem, brisa, zéfiro
Bretagne = Bretanha
Breton = bretão
bribe = corromper, subornar
brick = tejolo, tijolo
bride = noiva, recém-casada
bridegroom = recém-casado
bridge = ponte
bridle = entravar, frear, moderar, pôr freio em, serenar, entrave, freio
brief = breve, curto
briefcase = pasta para papéis, teca
brief case = dossiê
brigade = brigada
bright = brilhante, claro, luminoso, luzente
bright blue = azul claro
brilliant = brilhante, luzente
brim = beira, margem, borda
brimstone = enxôfre
bring = trazer
bring about = resultar em, ter como resultado
bring along = levar consigo
bring into agreement = concordar, pôr de acordo
bring up = criar, educar
brinjal = berinjela
brink = beira, margem, borda
Brisbane = Brisbânia
brisk = ágil, alerta, animado, bem disposto, vivo, vigoroso, expedito
bristly = eriçado, hirto
Bristol = Brístol
Britain = Grã-Bretanha
British = britânico
Briton = britânico
Brittany = Bretanha
brittle = frágil, quebradiço
broad = amplo, largo
broccoli = brócolo
broker = corretor
brokerage = comissão do corretor
bronze = de bronze, bronzeado, bronze
brooch = alfinete de fralda, broche, colchete
broom = vassoura
brothel = alcoice, bordel, casa de prostituição, lupanar
brother = irmão
brow = sobrancelha, sobrolho, supercílio
brown = bruno, moreno, pardo, trigueiro, castanho
browneyed = de olhos castanhos
Bruges = Bruges
bruise = contundir, machudar
Brunei = Brunei
brunette = de cabelo castanho
Brunswick = Brunsvique
brush = escovar, escova
Brussels = Bruxelas
Brussels-sprouts = couve-de-bruxelas, couve-de-grelo
brutal = arisco, brusco, rabugento
brute = animal selvagem, fera, brutal, pecuário
bubble = borbulhar, formar bolhas, bolha de ar, bexiga, bolha, empola
Bucharest = Bucareste
bucket = balde, caçamba
buckle = afivelar, fivela
bud = gomar, rebentar, renovar, soltar botões, botão, broto, gomo, olho, rebento, renovo
Budapest = Budapeste
Buddha = Buda
Buddhism = budismo
Buddhist = budista
buddy = camarada, companheiro
budget = orçamento
buffalo = bisão, bisonte, búfalo
buffer = pára-choque
buffet = aparador, bufete
buffoon = arlequim
bug = percevejo, insecto
bugger = praticar sodomia
build = construir, edificar, erigir, fazer obra de alvenaria, trabalhar de pedreiro, carpintejar, construir de madeira, desbastar
builder = lavrador
build from wood = carpintejar, construir de madeira, desbastar
building = construção, edifício
bulb = ampola, lampâda eléctrica, bolbo, bulbo, cebola
Bulgar = búlgaro
Bulgaria = Bulgária
Bulgarian = búlgaro
bulk = amplitude, amplidão, dimensão, extensão, grandeza
bulky = amplo, extenso
bull = touro
bulldozer = buldôzer
bullet = bala, projéctil
bulletin = boletim
bumblebee = mamangaba
bump = acidente, corcova, corcunda, giba
bumper = pára-choque
bumpy = acidentado, anguloso
bunch = feixe, molho, penca
bundle = feixe, molho, penca
bungalow = bangalô
bungle = borrar, fazer às pressas, trabalhar mal
bunker = abrigo
buoy = bóia
burden = carregar, estivar, pôr carga em, carga, carregamento
burdensome = oneroso, pesado
bureau = escritório, repartição
bureaucracy = burocracia
burgomaster = administrador de aldeia
Burgundian = borgonhês
burial = enterramento, funeral, sepultamento, enterro
Burma = Birmânia
burn = arder, queimar-se, incendiar, incinerar, queimar, começar a queimar
burp = arrotar
burst = arrebentar, estourar, fender-se, pipocar, rachar-se
Burundi = Burundi
bury = enterrar, sepultar
bus = ônibus, auto-ônibus
bush = arvoreta, arbusto
Bushman = bosquímano, boximane
business = assunto, caso, causa, coisa, negócio, questão, comércio, tráfico, transação, transação comercial
business deal = assunto, caso, causa, coisa, negócio, questão
businessman = homem de negócios, comerciante, negociante
busk = barbatana
busstop = ponto de ônibus
bus stop = parada de ônibus, ponto de ônibus
busy = ocupado
but = excepcionalmente, mas, contudo, embora, entretanto, todavia, porém
butcher = abater, jugar, massacrar, matar, trucidar, açougueiro, carniceiro, magarefe
butcher's shop = açougue, matadouro
butter = manteiga
buttercup = botão-de-ouro, ranúnculo
butterfly = borboleta, mariposa
buttock = nádega
button = castão, maçaneta, botão, butão, abotoar
buy = comprar, compra
buyer = comprador, freguês
buzz = soar, zumbir, zunir
by = ao pé de, junto a, junto de, perto de, próximo a, de, desde, a, ao, com, em, ao longo de, conforme, de acordo de, relativamente a, através de, por, por intermédio de, por meio de, além, ao lado de, por diante de
by accident = à toa, ao acaso, por acaso
by chance = à toa, ao acaso, por acaso
by day = de dia, durante o dia
bye = adeus, até a vista, até logo, até mais ver
by fours = aos quatro, em grupos de quatro
by heart = de cor, de memória
by-laws = estatuo, regimento, regulamento
by means of = através de, por, por intermédio de, por meio de
by no means = de forma nenhuma, de modo nenhum, de nenhuma maneira
by now = já
byre = curral
by sight = de vista
byte = byte
by tens = em grupo de dez
by the way = a propósito
by twos = aos pares
Byzantine = bizantino
Byzantine Empire = Império Bizantino
Byzantium = Bisâncio