#setName = words_en_pt_cc
#sideOneTitle = ENG
#sideTwoTitle = POR
cabaret = boate
cabbage = couve
cabin = cabana, choça, choupana, camarote
cabinet = gabinete, escritório, ministério, armário, estante
cable = cabo
cablegram = cabograma
cactus = cacto
cadaver = cadáver, defunto, morto
cadger = parasita
cadre = caixilho, moldura, quadro
Caesar = César
caesium = césio
café = café
caftan = cafetã
cake = bolo
calabash = abóbora, cabaça
calamity = calamidade, flagelo, praga
calamus = ácoro
calculate = calcular, computar, orçar
calendar = calendário
calf = bezerro, novilho, vitelo, barriga
call = denominar, nomear, chamar
call box = cabine telefônica, orelhão
caller = visitante
call on = fazer visita, fazer visitas, ir ver, visitar
calm = quieto, sossegado, calma, quietude, sossego, calmo, sereno, tranqüilo, quedo, tranqüilizar, acalmar, sossegar
calm down = tranqüilizar-se, aquietar-se, sossegar
calmness = tranqüilidade, serenidade, calma, alívio, sossego
Calvary = Calvário, Gólgota
cambric = batista, cambraia
camel = camelo
camp = acampar, <morar por algum tempo em uma tenda>
camp of tents = acampamento, arraial
camp out = acampar
can = <enlatar alimentos já preparados>, lata, caixa de lata
Canada = Canadá
Canadian = canadense, canadense
canal = canal
cancel = anular, declarar sem efeito, revogar
cancer = câncer
candidate = candidato
candlestick = castiçal
candy = doce, coisa doce
cane = bastão, bengala, bordão, cacete, pau, cana, caniço
canine = canino
canker = câncer
cannibal = canibal
cannon = canhão
canoe = canoa
cañon = canhão
canopy = baldaquim, dossel, pálio
Canterbury bell = campânula
cap = barrete, boina, boné, gorro
capability = aptidão, conveniência, capacidade
capable = apto, hábil, capaz
Cape of Good Hope = Cabo da Boa Esperança
caper = dar cabriolas
Cape Town = Cidade do Cabo
capital = fundos, capital
capital city = capital
capitalist = capitalista
capital letter = maiúscula
capitulate = capitulação, rendição
caprice = capricho, caprichoso, fantasia, impertinência
Capricorn = Capricórnio
capsule = cápsula
captain = capitão, capitão de navio
capture = apanhar, aprisionar, capturar
car = auto, automóvel, carro
carafe = garrafa, jarra
carapace = carapaça
caravan = caravana
carbon paper = papel-carbono
card = cartão
cardboard = cartão, papelão
cardiac = cordial, do coração, cardíaco
care = acurar, cuidar, preocupar-se, tutelar, zelar, cuidado, intraqüilidade, preocupação, zelo
career = carreira, profissão
care for = curar, medicar
careful = cauto, prudente, cuidadoso, zeloso
careless = distraído
caress = acariciar, afagar, mimosear
carnal = carnal
carnation = cravo
carnival = carnaval
carnivorous = carnívoro
carousel = carrossel
carp at = aperrear, atazanar, chicanear, falar chicanas, fuxicar
carpenter = carpinteiro
carpenter's square = esquadro
carpet = tapete, alfombra
carriage = carruagem, vagão, carreta, carrinho
carrot = cenoura
carrousel = carrossel
carry = carregar, levar
carry out = aguentar, agüentar, suportar, tolerar
cart = caminhão, carro, carroça
carte blanche = assinatura em branco, carta branca
cartridge = cartucho
carve = cinzelar, entalhar, lavrar
case = assunto, causa, coisa, negócio, questão, caso
cash = dinheiro
cashier = caixa, tesoureiro
cashier's stand = caixa, cofre
casino = casino, cassino
casserole = caçarola
cassette = cassete
cast = moldar
cast a shadow = sombrear
castle = fazer roque, rocar, castelo, roque, torre
castrate = castrar
cat = gato
catalogue = catalogar, catálogo
catastrophe = catástrofe
catastrophic = catastrófico
catch = começar a queimar, apanhar, aprisionar, capturar, acertar, atingir, dar no alvo
category = categoria
caterpillar = lagarta
cathedral = catedral
catholic = católico
Catholisism = catolicismo
cauldron = caldeirão
cauliflower = couve-flor
cause = produzir, ser causa de, causa, móvel, causar, ocasionar, provocar
cause to take place = causar, ocasionar, provocar
caution = advertir, avisar, lembrar, prevenir
cautious = cauto, prudente
cavalier = cavaleiro
cavalry = cavalaria
cave = gruta, caverna, furna, cava, cavidade
cavern = caverna, furna
cavity = cava, cavidade
caw = crocitar, grasnar
cease = cessar, parar de
ceaselessly = continuamente, sem cessar
cedar = cedro
cede = abdicar, alhear, ceder, submeter-se, transigir
ceiling = tecto, teto
Celebes = Célebes
celebrate = comemorar, celebrar, festejar, solenizar
celebration = celebração, festa
celebrity = celebridade
celery = ápio, aipo silvestre, aipo, aipo hortense, celeri
celestial = celeste, celestial
cell = calabouço, cárcere, enxovia, cabina, cela, célula
cellar = adega, despensa
cello = violoncelo
cellulite = celulite
cement = cimento
cemetery = cemitério
censor = censurar, censura
censorious = chicaneiro, trapaceiro
censurable = reprovável
censure = apreciar, criticar, reprovação
cent = ceitil, centavo
centaur = centauro
centavo = centavo
centennial = século
centimetre = centímetro
central = central
Central African Republic = República Centro Africana
Central America = América Central
Central Asia = Ásia Central
centre = centro, meio, sede
century = século
cerastes = cerasta, ceraste, víbora cornuda
Cerberus = Cérbero
ceremonious = solene
ceremony = cerimônia
Ceres = Ceres
cerium = cério
certain = certo, indubitável, seguro
certainly = certamente, com efeito, de facto, de fato, na verdade, sem dúvida
certainty = certeza
certificate = acto, auto, escritura, instrumento, atestado, certificado, depoimento, testemunho
certificated = diplomado
Ceylon = Ceilão
chain = cadeia, corrente
chair = assento, cadeira
chairman = presidente
chalice = cálice, taça
chalk = greda, griz
challenge = arrostar, desafiar, provocar, desafio, provocação
chamber = aposento, câmara, quarto, sala
chamber pot = bacia de cama, penico, urinol
chamois = camurça
chamois leather = camurça
champagne = champanha
champion = campeão
chance = acidental, fortuito, acaso, azar, casualidade, acontecimento, ocorrência, chance, ensejo
chandelier = lustre
change = alterar, modificar, modificar-se, mudar, troco, mudança
channel = canal, cano, canudo, tubo
chanson = canção, modinha
chaos = caos
chaotic = caótico
chapel = capela, ermida
chapter = capítulo
character = carácter, índole, temperamento, natureza, actor, marca, ponto, sinal
characteristic = característico
characterize = caracterizar
charcoal = brasa
charge = acusação, gastos, acumular eletricidade em, carregar, carga, carregamento
chariot = caminhão, carro, carroça
charitable = caridoso
charity = esmola, caridade
charlatan = capadócio, charlatão, curandeiro, impostor
charm = amuleto, figa, talismã, patuá, atrair, deliciar, encantar, fascinar, atrativo, delícia, encanto, fascinação, graça
charming = atraente, cativante, delicioso, encantador, fascinante
charter = carta
chase = tanger, tocar, acossar, perseguir, andar à caça de, caçar, montear
chase away = afugentar, rechaçar
chasm = abismo, boqueirão, fundão, pélago, precipício, sorvedouro
chaste = casto, continente, pudico, puro
chaste behaviour = pudor
chastity = castidade, pudicícia, pureza
chat = parolagem, parolice, tagarelice, grulhar, palrar, parolar, tagarelar
chatter = grulhar, palrar, parolar, tagarelar
chatterbox = paroleiro, palrador, tagarela
chauffeur = chofer
chauvinism = chauvinismo
chauvinist = chauvinista
cheap = barato
cheat = agir como patife, bilontra, gaio, maroto, patife, enganador, enganar, iludir, lograr, burlar, embair, fraudar, ludibriar, charlatanear, fazer charlatanismo
check = entravar, frear, moderar, pôr freio em, serenar, entrave, freio, conferir, fiscalizar, inspecionar, supervisionar, cheque, jogar xadrez
checker = revisor
checkers = jogo de damas
check up on = conferir, fiscalizar, inspecionar, supervisionar
cheek = bochecha, face
cheerful = alegre, festivo, jovial
cheers = à sua saúde
cheese = queijo
chef = chefe
chemist = boticário, farmacêutico, químico
chemistry = química
chemist's shop = botica, farmácia
cheque = cheque
cherry = cereja
cherry-tree = cerejeira
chess = xadrez
chessboard = tabuleiro de xadrez
chess-board = tabuleiro de xadrez
chest = colo, peito, seio, arca, baú, caixa, mala, cômoda, cómoda, tórax
chestnut = castanha
chestnut-tree = castanheiro
Cheviot Hills = Montes Cheviot
chew = mascar, mastigar
chewing-gum = goma de mascar
chic = chique
Chicagan = cidadão de Chicago
Chicagoan = cidadão de Chicago
chicken = frango, galinha
chicory = chicória
chief = director, superior, básico, capital, chefe, principal
chiefly = em especial, sobretudo, principalmente
chief of police = chefe de polícia
child = criança
childish = infantil, pueril
Chile = Chile
Chilean = chileno
chilly = frio
chimera = quimera
chimerical = quimérico
chimney = chaminé, cano da chaminé
chimpanzee = chimpanzé, jocó, pongo
chin = mento, queixo
China = China
Chinaman = chim, china, chinês
Chinese = chim, china, chinês
chirp = gorjear, piar, pipilar
chisel = cinzelar, entalhar, lavrar, cinzel, entalhador
chive = cebolinho
chocolate = chocolate
choice = designação, eleição, escolha
choke = abafar, estrangular, sufocar
cholera = cólera
choose = designar, eleger, escolher, nomear, optar
chop = cortar em pedaços pequenos, cortar com machado, picar, rachar
chord = acorde
chorus = coral, coro
chrestomathy = coletânea, crestomatia
Christ = Cristo
christen = batizar
christening = batismo
Christian = cristão
Christianity = cristianismo
Christian name = nome de baptismo, nome de batisto
Christmas = Natal
chronicle = crónica, crônica
chronicler = cronista
chuck = acariciar, afagar, mimosear
chunk = bola, torrão
chunk of wood = cepo, talho
church = casa de oração, igreja, templo
church-building = casa de oração, igreja, templo
churn = bater a nata
Cicero = Cícero
cider = cidra
cigar = charuto
cigarette = cigarro
cigarillo = charuto fino
cinder = cinza
Cinderella = Gata Borralheira
cinema = cinema
cinnamon = canela
cipher = algarismo, cifra, número
Circassia = Circássia
Circe = Circe
circle = círculo, circunferência, roda
circuit = circuito
circular = circular
circulate = circular
circulation = circulação
circumcise = circuncidar
circumference = círculo, perímetro
circumflex = acento circunflexo
circumstance = circunstância
circumstances = circunstância, condição, posição, situação
circumvent = circular, rodear
circus = circo
cistern = cisterna, tanque
citadel = cidadela
citation = citação
cite = citar, mencionar
citizen = cidadão
city = metrópole, cidade, município
city hall = prefeitura, municipalidade
city state = cidade, cidade livre
civic = civil
civil = civil
civilian = civil
civilization = civilização
civilize = civilizar, dar civilização, domesticar, policiar
claim = alegar, pretender, pretensão
clamp = grampo, parêntese
clan = gênero, raça, tribo
clap = aplaudir, aprovar, bater palmas, louvar, blenorréia
clarify = explicar
clasp = abotoar com colchetes, abrochar, acolchetar, cochete, colchete macho
class = curso, cotação, percurso
clatter = bater repetidamente
claw = garra
clay = argiloso, argila, barro, greda
clean = castiço, limpo, puro, assear, limpar, purificar
cleanliness = asseio, limpeza, pureza
cleanly cut = bem acabado, distinto, limpo, líquido, polido
cleanse = assear, limpar, purificar
clear = luminoso, luzente, claro, distinto
clergyman = clérigo, padre, sacerdote
clerk = balconista, caixeiro
clever = ágil, hábil, jeitoso, ardiloso, astuto, ladino
client = comprador, freguês
climate = clima
climb = descer, trepar, ascender, subir
climber = alpinista
cling to = aferrar, enganchar, fixar
clip = cortar, podar, tosar, tosquiar, desbastar, espoliar, depenar
cloak = capa
cloakroom = guarda-roupa, vestiário
clock = pêndulo, relógio
clod = bola, torrão
clod of earth = torrão
clog = arrolhar, tampar, tapar
close = fechar, fechar-se, familiar, íntimo, particular, privado, acanhado, apertado, estreito, junto, próximo
closed = fechado
closet = armário, estante
cloth = tecido de lã, estofo, fazenda, pano, tecido
clothe = cobrir, vestir, revestir
clothes = roupas
clothing = roupas
cloud = nuvem
cloudy = nublado
clover = trevo
club member = sócio de clube
clubs = paus, trevo
cluster = feixe, molho, penca
coach = instruir, adestrar, exercitar, treinar, educar, carruagem, vagão
coal = carvão
coarse = agreste, grosseiro, ríspido, rude, tosco, deselegante, falto de elegância, indecoroso
coast = costeiro, litorâneo, costa, litoral
coast- = costeiro, litorâneo
coastal = costeiro, litorâneo
coat = paletó, casacão, sobretudo
cock = pênis, galo
cockfight = briga de galo
cockroach = barata, blata
cod = bacalhau
coddle = acariciar, afagar, amimar, favorecer, mimosear
code = cifra, código secreto, escrita secreta
codfish = bacalhau
codfish-oil = óleo de bacalhau
coffee = café
coffee-house = café
coffee-pot = cafeteira
coffin = ataúde, caixão, esquife, féretro
cognac = aguardente, conhaque
coil = bobina, carretel, carrinho
coin = moeda
coir = coral, coro
coir loft = coro
cold = frio, constipação, constipação, resfriado
collapse = ruir
collar = colarinho
collect = colher
collection = are, colecção, grupo, reunião
collide = <ir a um lugar>
colour = cor
coltsfoot = tussilagem, unha-de-cavalo
columbine = aquilégia
column = coluna, rubrica
comb = pente
combat = lutar contra, opor
combine = combinar
come = derivar, provir, vir de, chegar, ir, vir
come about = fazer-se, tornar-se, vir a ser, acontecer, suceder, ter lugar
come across = achar, encontrar
come back = regressar, voltar
come close = acercar-se, aproximar-se
come closer = acercar-se, aproximar-se
comedy = comédia
come into = entrar em
come into bloom = começar a florir
come on = dirigir-se, acercar-se, começar, aproximar-se
come out = provir, sair
come to a halt = demorar-se, deter-se, parar
come to an agreement = entrar em acordo
come to an end = acabar, terminar
come together = unir-se, reunir-se, associar-se
come true = realizar-se
comfort = conforto, aliviar, consolar
comfortable = cómodo, cômodo
comfortably = agradavelmente, de maneira agradável
comic = cómico, cômico
comical = cómico, cômico
command = mando, dar ordem, mandar, ordenar, prescrever, comando, ordem, prescrição
commence = iniciar, começar
commencement = princípio
commend = glorificar, santificar, elogiar, gabar, louvar, registrar, recomendar
commerce = comércio
commissar = comissário
commission = comissão, comissão do corretor
commissioner = mandatário
commit adultery = adulterar, cometer adultério
commit aggression = agredir
committee = comissão, comitê, comité, junta
commodity = artigo, objecto posto à venda, fazenda, mercadoria
commodore = comodoro
common = usual, comum, ordinário, vulgar, batido, grosseiro
commonplace = banal, comun, vulgar, trivial
commotion = agitação, alvoroço, excitação doentia, escândalo
communicate = comunicar, participar
communication = comunicação
communion = comunhão
communist = comunista
community = comunidade, município
compact = cerrado, compacto, denso
companian = acompanhante, acólito, companheiro
companion = camarada, associado, companheiro
company = firma, loja, companhia
comparatively = comparativamente
compare = comparar
comparison = comparação
compartment = especialidade, secção, compartimento, compartimento de vagão
compass = bússola, compasso
compassion = compaixão, piedade
compatible = congruente, proporcionado
compatriot = compatriota, conterrâneo
compel = constranger, forçar, obrigar
compensate = premiar, recompensar, remunerar
compensation = recompensa, remuneração
compete = competir, concorrer, rivalizar
competent = autorizado, competente, habilitado
competition = concorrência, rivalidade, certame, concurso
compilation = compilação
compile = compilar
complain = lamentar-se, lastimar-se, queixar-se
complaint = acusação, lamento, queixa
complete = arredondar, completar, cheio, completo, pleno
completely = completamente
complex = complexo, complicado
complexion = tez
complicate = complicar
complicated = complexo, complicado
compliment = cumprimentar, cumprimento, vénia, vênia
compose = compor, escrever
composer = compositor
composition = composição
composure = tranqüilidade, serenidade, calma, alívio, sossego
comprehensive = extenso
comprise = abranger, estender-se, conter, incluir
compulsory = compulsório, forçoso, obrigatório
compute = computar
computer = computador
comrade = camarada, companheiro
concave = côncavo, oco, vazio
conceal = acobertar, esconder, ocultar
conceited = emproado, fofo, frívolo, fútil, inane, vaidoso
conceive = conceber, gerar
concentrated = basto, cerrado, compacto, denso, espesso
concept = conceito, idéia
concern = competir, concernir, dizer respeito a, referir-se, ter relação com, cuidado, intraqüilidade, preocupação, zelo
concerned = concernente, respectivo
concerning = acerca de, a respeito de, quanto a
concert = concerto
concise = conciso, lacónico, lacônico, sucinto
conclusion = conclusão, resultado
concord = acorde, acordo, ajuste, concordância, conformidade, convenção
concrete = betão, formigão, concreto
concubine = concubina
concurrence = acorde, acordo, ajuste, concordância, conformidade, convenção
condemn = amaldiçoar, desaprovar, reprovar
condemnable = reprovável
condemnation = reprovação
condition = cláusula, circunstância, condição, posição, estado, situação
condolences = condolências, pêsames
conduct = dirigir, conduzir, guiar, levar, comportamento, conduta, procedimento
conduct oneself = agir, comportar-se, proceder
conductor = condutor, motorista
conference = conferência
confess = professar, reconhecer, confessar
confession = confissão
confide = confiar, contar com, crer, ter confiança em
confidence = fé, confidência, confiança
confident = auto-confiante
confidential = confidencial
confine = demarcar, limitar, restringir
confirm = confirmar, homologar, ratificar
confirmation = confirmação
confiscate = confiscar
conflagration = incêndio
conflict = conflito
conform = estar conforme a, amoldar-se, adaptar-se, conformar-se
conforming = adequado, apropriado, conforme
confront = atacar de frente, enfrentar, afrontar, arrostar, resistir
confuse = atrapalhar, confundir, perturbar
confusion = confusão, perturbação, desordem
congratulate = dar parabéns, felicitar
congratulation = congratulação, parabéns
congregate = reunir-se
congress = congresso
congruent = congruente, proporcionado
conjecture = conjeturar, supor, conjetura
connect = amarrar, atar, ligar
connection = ligação, aliança, liga
connect up = ligar
conquer = conquistar
conscience = consciência, foro íntimo
conscientious = consciensiosamente
consciousness = conhecimento, consciência, sentimento de si
consecutively = sucessivamente
consent = anuir, concordar, estar de acordo, consenso, consentimento
consequence = consequência, conseqüência, seguida
consequently = logo, por conseguinte, sendo assim
conservative = preservativo, conservador, preservativo
conserve = conservar, guardar
consider = considerar, refletir, observar, mirar, olhar
considerable = apreciável, considerável
consignee = destinatário
consist = consistir
consistency = consequência, conseqüência, composição, constituição, natureza
consistent = consequente, conseqüente
consolation = alívio, consolação, consolo
console = aliviar, consolar
conspiracy = complô, conjuração, trama, conspiração
conspire = conjurar, conspirar
constant = permanente, contínuo, constante, ininterrupto
constantly = continuamente
consternation = consternação, estupefação
constipate = constipar
constipated = constipado
constipation = constipação, prisão de ventre
constitute = compor, constituir, estabelecer
constitution = constituição
constitutional = constitucional
constringent = adstringente
construct = construir, edificar, erigir
consul = cônsul
consulate = consulado
consult = consultar
consultation = consulta
consume = consumir, esgotar, gastar
consumer = consumidor
contact = estar em contacto com, estar em contato com, ter contacto com, contacto, contato
contain = conter, incluir
container = caixa, continente, jarro, vasilha, vaso
contempt = desprezo
contend with = lutar contra, opor
contented = contente, satisfeito
contention = afirmacão, asserção, garantia
contents = conteúdo
contest = certame, concurso
continent = continente
contingency = eventualidade
contingent = contingente, eventual
continual = constante, contínuo, permanente
continually = continuamente
continuation = continuação, prosseguimento
continue = durar, permanecer, prolongar-se, avançar, continuar, prosseguir
continuously = continuamente
contort = torcer, retorcer, contorcer
contour = contorno
contraband = contrabando
contract = acordo, contrato, pacto
contradict = contestar, contradizer
contradistinction = antagonismo
contralto = coltralto, violeta, contralto
contralto voice = coltralto, violeta
contrast = antagonismo, contrastar, contraste
contribute = colaborar, contribuir
contribution = contribuição
contrived = artificial
control = dominar, governar, reger
controller = revisor
controversy = controvérsia, polêmica
convenient = cómodo, cômodo, propício
convention = congresso
conversation = conversação
converse = conversar
conversion = mudança
convey = alienar, transmitir
conviction = convicção
convince = convencer, persuadir
convoke = convocar
cook = cozinhar, cozinheira
cooked = cozinhado
cookie = biscoito
cool = fresco
cooperate = colaborar
co-operate = colaborar
coordinate = coordenar
co-ordinate = coordenar
copious = abundante, basto, copioso, farto, lauto
copper = cúprico, de cobre, cobre
copy = exemplar, copiar, transcrever, cópia
copyright = direito de editor
cord = corda
cordial = cordial, do coração, cardíaco
core = âmago, caroço, cerne, núcleo
cork = cortiça
corkscrew = saca-rolhas
corn = calo, milho
corner = abarcar, açambarcar, fazer truste, ângulo, canto, esquina
cornflower = aciano
coronation = coroação
corporal = cabo, caporal
corporation = corporação
corpse = cadáver, defunto, morto
corpulent = encorpado, espesso, grosso, volumoso
corpuscle = glóbulo
corral = cavalariça
correct = corrigir, retificar, afinado, correcto, correto, exacto, exato, preciso
correspond = corresponder-se
corridor = corredor, galeria, passagem
corroborate = confirmar, homologar, ratificar
corrosive sublimate = sublimado
cosmetic powder = pó, pó-de-arroz
cosmos = natureza, universo
cost = custar, custo, preço, gastos
costly = precioso, valioso, caro
costume = costume, traje, veste
cottage = casinha, casinhola
cotton = algodão
cotton-wool = <algodão carvado e comprido em camadas moles>
couch = divã, canapé, sofá
couch-grass = grama
cough = tossir, tosse
counsel = advogado, anunciar, avisar, comunicar, aconselhar, persuadir, conselho
counsellor = conselheiro
count = conde, calcular, computar, orçar, numerar
counter = balção
counterfeit = coisa falsificada, falsidade, falsificação
count in = adicionar, somar
country = campanha, campo, roça, país, terra
countryman = camponês
countryside = campanha, campo, roça
coupé = compartimento, compartimento de vagão
couple = esposo e esposa, acoplar
coupon = bilhete, bónus, bônus, cupom
courage = ânimo, coragem, denodo
courageous = afoito, arrojado, corajoso, intrépido
course = curso, cotação, percurso, prato, travessa, trivial
court = galantear, namorar, instância, pátio, quintal, terreiro, corte, tribunal
courteous = cavalheiro, cortês, gentil, polido
courtroom = tribunal
courtyard = pátio, quintal, terreiro
cousin = prima, primo
cover = encadernação, acobertar, revestir, cobertura, tampa, cobrir, encapar, enfronhar, chapear, capear, capa, fronha, tegumento, atravessar, percorrer
covered = coberto
covet = ser ávido por
covetousness = avidez, cobiça
cow = vaca
cowardice = cobardia
cowboy = boiadeiro, vaqueiro
cower = estar agachado, estar de cócoras, contrair-se
cowhouse = curral
cowl = capuz, pano de chaminé
cowshed = curral
crack = fenda, greta, racha, estalar, estalido, estrondo
crackle = crepitar
cradle = berço
cramped = acanhado, apertado, estreito
cramp-iron = armação, armadura
crane = guindaste, grou, grua
crawl = arrojar-se, rastejar, serpear
crayfish = caranguejo
craze = furor, moda, voga
crazy = insano, louco
creak = ranger
cream = creme, nata
crease = amarfanhar, amarrotar, amassar
create = criar, fazer, instituir, compor, escrever
creature = ente, entidade, ser
credit = crédito
credulous = crédulo
creep = arrojar-se, rastejar, serpear
cremate = cremar
cremation = cremação
crevice = fenda, greta, racha
crew = equipagem, tripulação
cricket = grilo
crime = crime
criminal = criminal, criminoso
crimson = carmesim
crippled = aleijado, estropiado
crisis = crise
critical = crítico
criticism = crítica, discernimento
criticize = apreciar, criticar
croak = crocitar, grasnar
crockery = <objecto feito de argila>, faiança, faiença
crocodile = <falar na língua materna entre esperantistas>, crocodilo
crook = bilontra, gaio, maroto, patife
cross = atravessar, cruzar, cruz, transpor, ultrapassar
cross out = anular
cross roads = encruzilhada
crossways = transversalmente
crosswise = transversalmente
crossword puzzle = palavras cruzadas
crouch = estar agachado, estar de cócoras
crow = gralha, corvo
crowbar = alavanca
crowd = acervo, acúmulo, chusma, cúmulo, montão, pilha, ruma, multidão
crown = arrematar, coroar, coroa
crucifix = crucifixo
crucify = crucificar
crude = bronco, cru, agreste, grosseiro, ríspido, rude, tosco, deselegante, falto de elegância, indecoroso
crude oil = petróleo bruto, nafta
cruel = brutal, cruel, desalmado
cruise = cruzar
crumb = migalha, migalha de pão
crumble = amarfanhar, amarrotar, amassar
crush = esmagar, quebrar, britar, calcar, pisar, socar
crust of the earth = crosta terrestre
crutch = muleta
cruzeiro = cruzeiro
cry = grito, chorar
cry out = berrar, bradar, gritar
crystal = cristalino, de cristal, cristal
Cuba = Cuba
cube = cubo
cuckoo = cuco
cucumber = pepino
culprit = culpado, réu
cultivate = amanhar, cultivar
culture = cultura
cunning = ardiloso, astuto, ladino
cunt = vulva
cup = chávena, xícara
cupboard = armário, estante
Cupid = Amor, Cupido
cupola = cúpula, zimbório
cure = medicar, curar, sarar
curious = curisoso, notável, singular, curioso
curl = anelar, ondular, anel, caracol, frisar, bater, fazer molinete, mexer
currency = cotação
currency unit = unidade monetária, moeda
current = vigente, corrente, fluxo, hodierno, contemporâneo, presente, actual
currently = actualmente, atualmente, presentemente
curse = blasfemar, maldizer, amaldiçoar, desbocar-se, praguejar, xingar
curtain = cortina, reposteiro
curtsy = reverenciar, mesura, reverência
curve = arco, curva, volta
curved = curvo, sinuoso, tortuoso
cushion = almofada, coxim
cuss = blasfemar, maldizer, desbocar-se, praguejar, xingar
custom = hábito, costume, uso
customary = usual
customer = freguês
custom-house = alfândega
customs = alfândega, aduana
cut = ceifar, foiçar, roçar, segar, cortar com machado, picar, rachar, recortar, podar, tosar, tosquiar, desbastar, espoliar, depenar, cortar, partir, talhar, talho
cutlet = costeleta
cut off = trinchar, truncar, decepar, recortar, cortar fora
Cybele = Cibele
cybernetics = cibernética
Cyclades = Ciclades
cyclamen = ciclame
cycle = bicicleta, biciclo, ciclo
cyclone = ciclone
cylinder = cilindro
cylinder phonograph = fonógrafo, gramofone
cymbal = címbalo
cynical = cínico
cypres = cipreste
Cyprus = Chipre
czar = tsar
czarina = tsarina
Czech = checo, tcheco
Czechoslovak = checoslovaco, tchecoslovaco
Czechoslovakia = Checoslováquia, Checoslovaquia, Tcheco-Eslováquia
Czechoslovakian = checoslovaco, tchecoslovaco
Czech Republic = República Tcheca