#setName = words_en_pt_jL
#sideOneTitle = ENG
#sideTwoTitle = POR
jack = galopim, gaiato, macaco
jackal = chacal
jacket = casaco, jaqueta, paletó
jade = jade
jaguaro = jaguar, onça
jail = prisão, cadeia, prisão
jam = compota
Jamaica = Jamaica
January = Janeiro
Japan = Japão
Japanese = japonês
jargon = calão, gíria, jargão
Java = Java
jaw = maxila, queixada
jawbone = maxila, queixada
jaws = fauce, abertura, boca, goela
jazz = jazz
jealous = invejoso, cioso, ciumento
jealousy = ciúme
jeer at = caçoar, escarnecer, zombar
Jehovah = Jeová
jest = brincar, caçoar, gracejar
jester = arlequim
Jesus = Jesus
jet plane = avião a jato
Jew = judeu
jewel = jóia
jeweller = joalheiro
Jewish = judaico, judeu
jingle = tilintar, tinir, retinir, tinido
job = labor, trabalho, cargo, emprego, lugar, ofício, carga, empreitada, tarefa, gravame, encargo, incumbência
jocular = brincalhão, gracejador
join = aderir, filiar-se, incorporar-se, reunir, reunir-se, associar-se, amarrar, atar, ligar, unificar, unir, unir-se
joint = articulação, comum
joke = brincar, caçoar, gracejar, brincadeira, caçoada, chiste, piada, gracejo
journal = jornal
journalist = jornalista, jornalista
journey = viagem
joy = alegria, gozo
joystick = guidão, volante
jubilant = jubiloso
jubilation = júbilo
jubilee = jubileu
Judaism = judaísmo
judge = julgar, juiz
judgment = juízo, julgamento, sentença
jug = bilha, cântaro, jarra, panela, pote, caixa, continente, jarro, vasilha, vaso
juggle = escamotear, prestidigitar
juggler = prestidigitador
juice = seiva, suco, sumo
July = Julho
jumbled up = confuso, vago
jump = pular, saltar, pulo, salto
June = Junho
june bug = besouro
jungle = floresta, mata, selva
jurist = jurista
just = eqüitativo, justo, reto, apenas, não ... mais que, só, somente, directamente, imediatamente, sem demora, logo, depressa, com precisão, exactamente, exatamente, justamente, agora mesmo, neste instante
justice = justiça
just now = agora mesmo, neste instante
kangaroo = canguru
keel = quilha
keen = ágil, alerta, animado, bem disposto, vivo, vigoroso, expedito
keep = criar, cultivar, melhorar, velar, vigiar, conservar, guardar, observar, cumprir, desempenhar, salvar, poupar
keep an eye on = espiar, espionar
keeper of the records = arquivista
keep house = administrar casa
keep on = continuar, durar, permanecer, prolongar-se
kerchief = lenço
kernel = âmago, caroço, cerne, núcleo
kerosene = querosene
kettle = chaleira, caldeirão
key = gama, escala, chave
kibbutz = kibboutz
kick = dar pontapé
kid = fazer blague, mistificar por pilhéria, cabrito
kidney = rim
kill = matar
kiln = fogão, forno
kilometre = quilômetro
kind = afável, amável, gentil, lhano, bondoso, atencioso, obsequioso, espécie, género, jaez, laia, qualidade
kindle = acender
kindness = afabilidade, amabilidade, fineza, gentileza
king = mulher, senhora, sota, dama, rei
kingdom = reino
kingfisher = alcedo, alcíone
kiss = beijar, beijo
kitchen = cozinha
kite = busardo
kitten = bichano, gatinho
klaxon = buzina, chifre, corno
knapsack = alforje, mochila, sacola
knapwood = centáurea
knee = joelho
knife = faca
knight = cavaleiro, cavalo
knit = fazer meias, fazer renda
knitting needle = agulha de meia
knob = asa, cabo, tenaz
knock = bater, golpear, percutir
knock off = debater, discutir
knot = encruzilhada, laço, nó, vínculo
know = conhecer, saber
know how = conhecer, saber
knowledge = conhecimento
Koran = Alcorão
Korea = Coreia, Coréia
Korean = coreano
label = dístico, etiqueta, marca, rótulo
labor agreement = contrato de trabalho
laboratory = laboratório
laborer = obreiro, operário, trabalhador
labour = dar à luz, parir, ter
labour agreement = contrato de trabalho
labour contract = contrato de trabalho
labourer = obreiro, operário, trabalhador
labour-union = sindicato
lace = renda
lack = não ter, ter falta de, carência, falha, falta
lacquer = envernizar, verniz
lad = menino, rapaz
ladder = escada, escada de mão, escala
laddie = menino, rapaz
lady = mulher, sota, mulher, dama, dama, senhora
ladybug = coccinela
Lady Day = Anunciação
lady help = assistente
lady's mantle = pé-de-leão, alquemila, pé-del-leão
lagoon = laguna
lake = lago
Lake Aral = Aral
Lake Erie = Erié
Lake Eyre = Erié
Lake Malawi = Lago Niassa
lamb = cordeiro
lame = capenga, manco
lament = lamentar-se, queixar-se
lamp = lâmpada, candeia
land = alcançar a margem, aterrar, país, aterrissar, abordar-se, acostar-se, chão, solo, terra
landing = aterrissagem
landing-stage = ancoradouro, cais de atracação
landscape = paisagem
lane = beco
language = idioma, língua, linguagem
lantern = lanterna
Laos = Laus
lap = bater, estalar, marulhar, patinhar
Lapland = Lapônia
Laplander = lapão, lapônio
Lapp = lapônia, lapão, lapônio
Lappish = lapão, lapônia
lapse = recair
lapsed = caduco, decrépito, frágil
larch = lárix
larder = aparador
large = grande, magno, maiúsculo
lark = calhandra, cotovia, laverca
larkspur = delfínio, esporeira, espora-dos-jardins
larva = larva
laryngitis = laringite
larynx = laringe
lass = garota, menina, moça, rapariga
last = antecedente, anterior, precedente, continuar, durar, permanecer, prolongar-se, derradeiro, último, passado
lasting = duradouro, contínuo, constante, ininterrupto
last night = a noite passada
late = tardio
lately = recentemente, ultimamente
lath = ripa, sarrafo
lathe = torno
Latin = latino
Latin America = América Latina
latrine = latrina, privada
Latvia = Letônia
Latvian = letão
laud = glorificar, santificar, elogiar, gabar, louvar
laugh = rir, rir-se, riso
laughter = riso
laundry = lavanderia
laurel = louro, loureiro
lava = lava
law = direito, jurisprudência, lei
lawless = árdego, desenfreado, imoderado, impetuoso
lawn = batista, cambraia, gramado, relva
lawsuit = ação, pleito, processo
lawyer = advogado, jurista
laxative = laxativo
lay = deitar, estender
lay down = colocar, meter, pôr
layer = camada, estrato, filão, lençol
lay hold of = pegar, tirar, tomar
layman = laico, leigo
lay out = deitar, desenvolver, estender, expor, fazer cair
laziness = indolência
lazy = indolente, negligente, preguiçoso, mandrião
lead = dirigir, conduzir, guiar, levar, plúmbeo, chumbo
leader = chefe, director
leading article = artigo de fundo
leaf = folha
leaflet = brochura, opúsculo
leaf through = folhear
league = aliança, liga
lean = apoiar, arrimar, encostar, reclinar, apoiar-se, magro, delgado, fino, delicado
leap = pular, saltar, pulo, salto
leap-year = ano bissexto
learn = aprender
learn of = informar-se
lease = arrendar
leather = de couro, couro
leave = pôr-se a caminho, afastar-se, ausentar-se, partir, retirar-se, abandonar, licença, legar, testar, deixar, largar, permitir
leave behind = deixar, transmitir
leave out = deixar passar, escapar, omitir, preterir
leave out of account = fingir ignorar, não tomar conhecimento
Lebanese = libanês
Lebanon = Líbano
lectern = carteira, estante
lector = professor, professor universitário
lecture = fazer uma preleção, fazer preleção, aula, conferência letiva, preleção
lecturer = professor, professor universitário
leek = alho
left = canhoto, esquerdo, para a esquerda
leg = perna
legal = legal, lícito
legend = legenda, lenda
legendary = legendário, lendário
legible = legível
legion = legião
legitimize = legalizar, legitimar
lemon = limão
lemonade = limonada
lemon-tree = limoeiro
lend = dar por empréstimo, emprestar
length = comprimento, extensão, longitude
lengthwise = ao comprido, ao longo
lens = lente, lupa
lentil = lentilha
leopard = leopardo
leper = leproso
leprosy = lepra
less = menos
less and less = menos e menos
Lesser Antilles = Pequenas Antilhas
lesson = aula, ensinamento, lição
let = deixar, largar, permitir, alugar, dar de aluguel
lethargy = letargia
let know = informar, noticiar, notificar
let's start = comecemos, vamos
Lett = letão
letter = epístola, carta, missiva, letra
letterbox = caixa de correiro, caixa postal
letter of credit = carta de crédito
Lettish = letão
lettuce = alface
level = chão, chato, plano, raso, aplanar, alisar, nivelar, igual, parelho, acertar, ajustar, igualar, horizontal, nível
level crossing = passagem de nível
lever = elevar, erguer, suspender
lewd = devasso, impudico, lascivo
liberal = liberal
librarian = bibliotecário
library = biblioteca
licence = licença
license = licença
licentious = árdego, desenfreado, imoderado, impetuoso
lick = lamber
lid = capa, cobertura, tampa
lie = estar deitado, estar situado, ficar, jazer, faltar à verdade, mentir, mentira
lie down = deitar-se, estender-se
lie encamped = acampar
lieutenant = tenente
life = vida, viver
lifebelt = salva-vidas
life-belt = salva-vidas
life-boat = barco salva-vidas
lift = desenterrar, exumar, elevar, erguer, suspender, levantar-se, ascensor, elevador
light = acender, claro, luminoso, luzente, leve, leviano, sem profundeza, superficial, luz, débil, fraco, ligeiro
lighter = fuzil
lighthouse = farol
lightning = corisco, raio, relâmpago
light-switch = comutador
likable = estimável
like = como, de que modo, qual, na qualidade de, quanto, semelhante, similar, parecido, estimar, gostar de, prezar
likely = verossímil
like this = de tal modo
likewise = ainda, idem, outrossim, também, ídem, igualmente
lilac = lilás
lily = lírio
limb = membro
lime = cal
lime-tree = tília
limit = demarcar, limitar, restringir, confins, fronteira, limite, raia
limp = capengar, coxear
linden-tree = tília
line = fio, ramo, cauda, fila, fileira, linha, turno, vez, ala, fiada, forma
lineage = origem
linen = pano, tela
lineseed oil = óleo de linhaça
line up = enfileirar-se, incluir-se
linguist = linguista, lingüista
lining = forro
link = montar, argola, elo
linoleum = linóleo
lion = leão
lip = lábio
liqueur = licor
liquid = fluido, líquido, líquido
liquidate = ajustar pagando, liquidar, matar
liquor = bebida alcoólica
Lisbon = Lisboa
lisp = cecear
list = lista
listen = dar atenção a, escutar, ouvir
listener = aluno, auditor, ouvinte
litany = ladainha
liter = litro
literal = textual, literal
literary = literário
literature = literatura
Lithuania = Lituânia
Lithuanian = lituânio
litigate = acionar, processar
litre = litro
little = pequeno
little bird = passarinho
little brother = maninho
little by little = pouco a pouco
Little Red Ridinghood = Chapeuzinho Vermelho
Little Snow White = Branca-de-Neve
little stick = bastonete
liturgy = liturgia
live = estar hospedado, habitar, morar, viver
lively = engraçado, espirituoso
liver = fígado
livestock = gado, rebanho
live through = atravessar, viver
live to see = <viver até o momento>
living-room = sala
living room = sala
load = acumular eletricidade em, carregar, estivar, pôr carga em, carga, carregamento
loaf = pão
loan = emprestar
loathe = abominar, detestar, ter nojo de
lobster = lagosta
local = local, locativo
locate = acomodar, colocar
location = local, lugar, paragem, sítio
loch = fiorde, lago
lock = fechadura, fechar
locksmith = chaveiro
locust = gafanhoto
lofty = alto, elevado, eminente
logic = lógica
logical = lógico
logical reasoning = razão
London = Londres
lonely = solitário
long = comprido, longo
long for = dar ais, suspirar, ter saudades de
longitude = longitude
look = representar, ter aparência de, ter aspecto de, aparência, aspecto, semblante, eis, eis aí, eis ali, eis aqui, observar, mirar, olhar, olhadela
look after = guardar, velar, vigiar, providenciar, cuidar de criança
look askance = ser vesgo, vesguear
look at = observar, mirar, olhar
look for = buscar, investigar, procurar
looking-glass = espelho
loom = tear
loop = laçada, laço, malha
loose = laxante, laxativo
lord = amo, patrão, senhor
lorry = caminhão
lose = perder, tornar-se vencido
loss = perda
lot = lote, parcela
lottery = loteria, rifa
lotus = lótus
loud = alto, forte
loudly = em voz alta
lounge = sala de visitas, salão
louse = piolho
lovable = amável, amorável
love = amar, benquerer, gostar de, amor, amor sexual
loved = amado
loved one = amada, namorada, amado
lovely = agradável, ameno, aprazível, belo, bonito, formoso, pulcro, esplêndido, soberbo, sublime, querido, maravilhoso, atraente, cativante, delicioso, encantador, fascinante
lover = amante, amada, namorada, amado
loving = que ama
low = baixo
lower = abaixar
lower-arm = antebraço
lower case letter = minúscula
lower part of the body = abdome, barriga, ventre
low relief = baixo-relevo
low tide = baixamar
loyal = fiel, leal
Lucifer = Satã, Satanás
luck = destino, sina, sorte, chance, ensejo
luggage = bagagem, embrulho
luggage-van = furgão
lukewarm = morno, tépido
lull = embalar, ninar
lullaby = acalento, cantiga de ninar
lump = bola, torrão, fragmento, conjunto, massa, bocado, pedaço, naco
lump of earth = torrão
lunar = lunar
lunatic = louco
lunch = merenda, lanche
lung = pulmão
lungwort = pulmonária
lure = atrair, engodar, seduzir
lurid = acre, afiado, agudo, cortante, penetrante, picante, ríspido, sensacional
lust = ardor, paixão, sensualidade, volúpia
lute = alaúde
luxurious = luxuoso, luxuriante
luxury = objecto de luxo, objeto de luxo, luxo
lying-in woman = parturiente
lyric = letra, teor, texto