#setName = words_en_pt_op.txt
#sideOneTitle = ENG
#sideTwoTitle = POR
oak = carvalhal, carvalho
oaken = carvalhal
oar = remo
oasis = oásis
oath = jura, juramento
oats = aveia
obedient = obediente
obeisance = mesura, reverência
obey = obedecer, observar
obituary = necrológio
object = assunto, coisa, complemento, objecto, objeto, artigo
objectionable = reprovável
obligation = dever, obrigação
obliging = atencioso, obsequioso
oblique = enviesado, esguelhado, oblíqua
oboe = oboé
obscene = obsceno
obscure = desconhecido, obscuro
observation = nota, observação, reparo
observe = observar, cumprir, desempenhar
obsess = obsedar, obsediar, perseguir
obsession = idéia fixa, obsessão
obstacle = obstáculo
obstinate = birrento, obstinado, teimoso
obstruct = barrar, interceptar, tapar, trancar
obtain = adquirir, arranjar, obter
obtainable = adquirível
obtuse = obtuso
obvious = evidente, inequívoco, manifesto, óbvio, patente
obviously = evidentemente
occasion = feita, vez, acontecimento, ocorrência
occult = oculto
occupation = arte, indústria, ofício, profissão, ocupação
occupy = encher, ocupar, preencher
occur = acontecer, suceder, ter lugar
occurence = acontecimento, ocorrência
occur intermittently = produzir-se por intermitências
ocean = oceano
oceanic = do oceano, oceânico
o'clock = hora
octagon = octágono
October = Outubro
octopus = polvo
oculist = oculista, oftalmologista
odd = barroco, bizarro, <que não tem o segundo elemento do par>, estranho, esquisito, excêntrico
ode = ode
odor = cheiro, hálito, odor
odour = cheiro, hálito, odor
of = desde, por, de
of a horse = cavalar, hípico
of an ass = asenino
of an elephant = elefântico, elefantino
of a tree = arbóreo
of course = compreensivelmente, de certo
of fantasy = fantástico, imaginário
offend = insultar, injuriar, ofender, ultrajar
offensive = ofensivo
offer = imolar, ofertar, sacrificar, oferecer, apresentar, propor, oferta, proposta
offer a toast = beber à saúde de, brindar, saudar
offer up = imolar, ofertar, sacrificar
office = escritório, repartição, cargo, emprego, lugar, ofício
officer = empregado, funcionário, oficial
official = empregado, funcionário, oficial
officialdom = burocracia
offset = distância
offset printing = offset
offspring = descendência, descendente, sucessor
of good repute = de boa reputação
of ill repute = de má reputação
of noble birth = de nobre
often = amiúde, frequentemente, freqüentemente, muitas vezes
of the coast = costeiro, litorâneo
of the same age = da mesma idade
of the winter = invernal, invernoso, hibernal
of use = apto, capaz, conveniente, usável, praticável
of water = aquático, aquoso
of which = cujo, de que, de quem, do qual
of yesterday = de ontem, hesterno
oh = ah, oh
ohm = Ohm
oil = óleo
oilcloth = oleado, encerado
oil of olives = azeite
ointment = lubrificante, reboco
okay = bom, bem, de acordo, com precisão, exactamente, exatamente, justamente
old = velho
old-fashioned = antiquado, fora de moda, obsoleto
olive = azeitona, olivo
olive-oil = azeite
olive-tree = oliveira
omen = adivinhação, agouro, augúrio, presságio, profecia
omit = deixar passar, escapar, omitir, preterir
omnibus = ônibus, auto-ônibus
omnipotent = onipotente
omnipresent = ubíquo
on = adiante, avante, para frente, de, desde, dentro de, a, ao, com, em, através de, por, por intermédio de, por meio de, mais, acerca de, a respeito de, quanto a, sobre
on account of = em troca de, pro causa de
once = outrora, uma vez
once more = uma vez mais, de novo, novamente, outra vez
one = alguém, algum, uma pessoa, a gente, um, uma
one at a time = um a um
one hundred = cem
one more time = bis, mais, outra vez
onerous = oneroso, pesado
one thousand = mil
one time = uma vez
one-way traffic = direção obrigatória, direcção obrigatória, mão-única
onion = cebola
only = apenas, isolado, sozinho, único, não ... mais que, só, somente
only just = apenas, logo que, mal, quase não
on occasion = outrora, uma vez
on purpose = de propósito, intencionalmente, deliberadamente
on that account = em vista disso, por este motivo, por isso, portanto
on the contrary = em frente, ao contrário, pelo contrário
on the left = à esquerda
on the other hand = por outro lado
on the other side of = além de, através de, do outro lado de, para lá de
on the right = à direita
on the whole = em suma, na sua generalidade, numa palavra
on time = exato, pontual
on top = acima, para cima
opal = opala
open = abrir, aberto
opening = abertura, boca, bocal, fenda, fresta, orificio, vão
openly = abertamente, sem rodeios
open up = abrir
open-work = rendado à jour
opera = ópera
operate = estar em exercício, exercer funções, funcionar, operar
operation = operação
operative = obreiro, operário, trabalhador
ophtalmologist = oculista, oftalmologista
opine = julgar, opinar, ser de opinião
opinion = opinião
opium = ópio
Oporto = Porto
opossum = didelfo, gambá, saragüéia, seringüê, timbu
opponent = advesário, antagonista, competidor, contrário, inimigo
opportune = cómodo, cômodo, propício
opportunist = oportunista
opportunity = acontecimento, ocorrência
oppose = contrariar, impedir, opor-se
opposed to = contra, defronte de, em frente de, em troca de
opposite = contra, defronte de, em frente de, em troca de, além, do outra lado
opposition = antagonismo, oposição
oppress = apertar, comprimir, espremer
oppressing = angustioso, ansioso
optician = oculista
optimism = otimismo
optimist = otimista
option = alternativa, intercorrência
or = ou
or = -ista
orache = atríplex
oracle = oráculo
oral = bucal, oral, verbal
orally = de viva voz, oralmente
orange = composto de laranja, que tem a cor da laranja, laranja
orange-tree = laranjeira
orator = orador
oratorical = oratório
oratory = retórica
orbit = órbita
orchard = pomar
orchestra = orquestra
orchid = orquídea
ordain = aprazar, destinar, reservar
ordeal = aflição, agonia, pesar
order = encomendar, pedir, reservar, encomenda, pedido, comenda, condecoração, arranjo, disposição, ordo, dar ordem, mandar, ordenar, prescrever, comando, ordem, prescrição
ordinarily = habitualmente, usualmente, normalmente
ordinary = comum, ordinário, usual
ore = minério
organ = órgão
organic = orgânico
organism = organismo
organization = organização
organize = organizar
orgiastic = orgíaco
orgy = bacanal, orgia
orient = orientar
Oriental = oriental
origin = origem, procedência
original = original
originate = derivar, vir de, originar-se, provir
ornament = fazer decoração, adornar, decorar, ornamentar, adorno, ornamento
ornamental = ornamental
orphan = órfão
orthodox = ortodoxo
oscillator = oscilação
oscilloscope = oscilógrafo
ostrich = avestruz
other = diferente, diverso, outro
other than = excepcionalmente
otherwise = ao contrário, em frente, pelo contrário
ouch = ai
ought to = dever, ter a obrigação, ter de, ter que
ounce = onça
our = nossa, nosso
out = fora, de fora
outer = adventício, exterior, externo
outfit = fato, jogo, terno, costume, traje, veste
outing = excursão
outline = contorno, recorte, silhueta, esboço
out of = de, dentre
out of date = antiquado, fora de moda, obsoleto
outrage = malefício
outside = afora, fora de, adventício, exterior, externo, fora, de fora
outside of = afora, fora de
outskirts = periferia
oval = oval
ovation = ovação
oven = fogão, forno
over = acima de, sobre
overall = totalitário, inteiro, todo, total
overbearingness = arrogância, impertinência
overcoat = paletó, casacão, sobretudo
overestimate = superestimar
overflowing = supérfluo
overground = aéreo
overhaul = avaçar, <viajar passando por diante de>
overhead = aéreo, acima, para cima
overlay = cobrir, encapar, enfronhar, chapear, capear
overlook = deixar passar, escapar, omitir, preterir
overpower = sujeitar, superar pela força, prevalecer, defraudar, esbulhar, usurpar
overshoe = galocha
overtake = avaçar, exceder, passar de largo, ultrapassar, <viajar passando por diante de>
over there = acolá, aí, além, ali, nesse, nesses, lugar, lugares, naquele
overthrow = derrubar, deitar por terra, derribar, entornar, revirar
overture = ouverture
overwhelm = cobrir com abundáncia, sobrecarregar
ow = ai, ah
owe = dever
owing to = em troca de, pro causa de
owl = bufo, coruja, corujão, mocho
own = fruir, possuir, ter, peculiar, pessoal, próprio
owner = proprietário, dono
ox = boi
oxygen = oxigénio, oxigênio
oyster = ostra
ozone = ozônio
pace = andar, caminhar, dar um passo, passo
Pacific = Oceano Pacífico
Pacific Ocean = Oceano Pacífico
pack = embalar, empacotar, enfardar, embrulho, pacote
packet = pacote
pad = bloco, massa, peça, estofar
paddle = chapinhar, patejar, pá
pagan = pagão
page = escudeiro, pagem, lauda, página
paid-up = desobrigado, quite
paid up = desobrigado, quite
pail = balde, caçamba
pain = aflição, dor
painful = doloroso
paint = colorir, tinta, pincelar, pintar
paintbrush = pincel
painter = pintor
painting = pintura
pair = casal, par, parelha
pair of pincers = tenazes, pinça
Pakistan = Paquistão
pal = camarada, companheiro
palace = palácio
pale = descorado, pálido
Palestine = Palestina
palet = paleta, palheta
palisade = estacada, paliçada
palm = palma, palmeira
Palm Sunday = Domingo de Ramos
palmtree = palma, palmeira
pamper = acariciar, afagar, amimar, favorecer, mimosear
pamphlet = brochura, opúsculo, libelo, panfleto
pane = <objeto de vidro>
panel = painel
panic = pânico, terror infundado
pansy = amor-perfeito, violeta-tricolor
panties = cuecas, calças, ceroulas
pantomime = pantomima
pantry = aparador, despensa
pants = calças
papaw = mamoeiro, papaia
papaya = mamoeiro, papaia
paper = documento, papel, forrar, revestir parede
paperback = brochura, opúsculo
paperbacked = brochado, não encadernado
paperer = forrador
paper-hanger = forrador
paprika = páprica
parachute = pára-quedas
parade = convocação, alardear, desfilar, formar em parada, parada, ostentação
paradise = paraíso
paradox = paradoxo
paradoxical = paradoxal
paraffin-oil = petróleo
paragraph = alínea, parágrafo
parallel = paralelo
paralyse = entorpecer, paralisar
paralysis = paralisia
parameter = parâmetro
paranoia = paranóia
parasite = parasita, parasita
parcel = pacote, lote, parcela
pardon = anistiar, desculpar, escusar, perdoar, perdão
parenthesis = grampo, parêntese
parents = pais, pai e mãe
Paris = Paris
parish = freguesia, paróquia
parishioner = paroquiano
Parisian = parisiense
park = estacionar, estacionamento, parque
parliament = parlamento
parliamentary = parlamentar
parlour = sala de visitas, salão
parochial = paroquial
parrot = papagaio, papaguear
parsley = salsa
part = parte, papel
parterre = andar térreo, platéia
Parthian = parcial, partitivo, parcela, parte, quinhão
partial = partitivo, parcial
partially = em parte
participate = participar, tomar parte
participle = particípio
particle = elemento, partícula
particular = avulso, isolado, peculiar, reservado, especial, extraordinário, particular, próprio
partly = em parte
partner = associado, sócio
partridge = perdiz
party = <grupo não organizado>, celebração, festa, bandeira, facção, partida, partido
pass = avaçar, licença, passar, fazer passar, <viajar passando por diante de>, alienar, transmitir
passage = corredor, galeria, passagem, viela
passageway = passagem, viela
pass away = falecer, morrer
pass by = passar, exceder, passar de largo, ultrapassar
passenger = passageiro
passenger train = trem de passageiros, mixto
passion = brasa incêndio, ardor, paixão
passionate = apaixonado, passional
passport = passaporte
pass the night = <passar a noite em algum lugar>
pass through = atravessar, percorrer
past = passado, além, ao lado de, por diante de
paste = massa, pasta
pastor = cura, pároco, vigário, pastor, clérigo, padre, sacerdote
pat = bater de leve
patch = remendo, consertar, remendar
patch up = consertar, remendar
pate = cabeça, empada, pastel
path = atalho, senda, vereda, beco, trilho
patience = paciência
patient = doente, paciente
patriarch = patriarca
patriot = patriota
patriotic = patriótico
patriotism = patriotismo
patrol = patrulhar, patrulha, ronda
patrolman = gendarme
patron = patrono, protector, protetor
patronage = auspício, bom augúrio
pattern = esquema, chapa, clichê, molde, padrão
pause = fazer uma pausa, pausa, suspensão
pave = calçar, pavimentar
pavement = pavimento, calçada, passeio
pavilion = pavilhão
paw = perna, pé
pawn = peão, praça, soldado
pay = custear, pagar
pay attention = atender, fixar a atenção em, prestar a atenção
pay attention to = atender, fixar a atenção em, prestar a atenção
pay homage to = homenagear
payment = pagamento
pay out = gastar
pay tribute = tributar
pea = ervilha, ervilheira
peace = paz
peaceful = pacífico
peaceloving = pacífico
peach = pêssego
peacock = pavão
peak = ápice, extremidade, pico, ponta
peal = soar, vibrar
peanut = amendoim, aráquida
pear = pêra
pearl = pérola
pear-tree = pereira
peasant = camponês
peat = turfa
peculiar = estranho, esquisito, excêntrico
pedal = pedalar, pedal
peddle = chatinar, mercadejar, traficar
pedestrian = pedestre
peel = descascar, casca, crosta
peep = gorjear, piar, pipilar
peg = aperitivo
Peiping = Pequim
Peking = Pequim
pelvis = alguidar, bacia, tijela
pen = aprisco, chiqueiro, curral, pluma, pena
pencil = lápis
Penelope = Penélope
penetrate = introduzir-se, penetrar
peninsula = península
penis = pênis
pen-knife = canivete
pension = pensão
pensioner = pensionista
Pentateuch = Torá
Pentecost = Pentecostes
people = gente, povo, nação
pepper = apimentar, pimenta, pimenta-do-reino
per = dentro de, em, a por, à razão de
perceive = avistar, divisar
percent = juros, percentagem, taxa
percentage = juros, percentagem, taxa
perchance = acaso, por ventura, possivelmente, talvez
perfect = aprimorado, perfeito, aperfeiçoar
perfection = perfeição
perform = aparecer, publicar-se, sair à luz, vir a lume, entrar, fazer, formar, executar, cometer, confeccionar, cumprir, desempenhar, apresentar, oferecer
perfume = defumar, perfumar, fragrância, perfume
perhaps = acaso, por ventura, possivelmente, talvez
peril = perigo, risco
perimeter = perímetro
period = período, ponto
periodical = gazeta, folha, revista
periphery = periferia
periscope = periscópio
perish = destruir-se, perecer
periwinkle = pervinca
permanent = constante, contínuo, permanente
permission = consenso, consentimento, permissão
permit = aquiescer, consentir, permitir, licença
perplexed = hesitante, perplexo
perplexity = aperto, embaraço, estorvo, óbice, perplexidade
persecute = acossar, perseguir
perseverance = perseverança
persevere = insistir, perseverar, persistir
Persia = Irã
Persian = iraniano
persist = obstinar-se, teimar, insistir, perseverar, persistir
persistent = persistente
person = personagem, pessoa
personal = peculiar, pessoal, próprio
personality = carácter, índole, temperamento, personalidade
personnel = pessoal
perspective = perspectiva
perspiration = suor, transpiração
persuade = convencer, persuadir
persuasion = persuasão
perturb = causar perturbação, perturbar
perverse = malvado, perverso
pessimism = pessimismo
pessimist = pessimista
pessimistic = pessimista
pestilence = peste
pestle = mão de almofariz
pet = acariciar, afagar, amimar, favorecer, mimosear
petal = pétala
petition = petição, requerimento
petrol = benzina, gasolina
petroleum = petróleo
petrol tank = tanque de gasolina
petticoat = anágua, saiote
petulant = traquinas
Phaeton = Fáeton
phallus = falo
phantom = aparição, fantasma, abantesma
pharmaceutical = remédio
pharmaceutical chemist = farmacêutico
pharmacist = farmacêutico
pharmacy = farmácia
phase = fase
pheasant's eye = adônis
phenomenal = fenomenal
phenomenon = fenômeno
philately = filatelia
philosopher = filósofo
philosophize = filosofar
philosophy = filosofia
phiz = cara ridícula
phlebitis = flebite
phlegm = calma, fleuma, impassibilidade, muco
phoenix = fénix
phone booth = cabine telefônica, orelhão
phonetic = fonético
phonetics = fonética
phonograph = gramofone
phosphorescent = fosforescente
phosphorus = fósforo
photograph = foto, fotografar
photographer = fotógrafo
physical = físico
physician = facultativo, médico
physics = física
physiognomy = fisionomia
pianist = pianista
piano = piano
pick = arrancar, colher, tirar, aferroar, picar
pick-axe = alvião, picareta
pickle = rapazola de má conduta, salgar
pick out = designar, eleger, escolher, nomear, optar
pick up = colher, pegar, tirar, tomar
picnic = fazer um piquenique, piquenique
picture = estampa, gravura, quadro, vista, figura, imagem, vulto configuração, pintura
picturesque = pitoresco
picture writing = ideografia
pie = empada, pastel, torta
piece = fragmento, parte, bocado, pedaço, naco
piece of furniture = alfaia, móvel, traste
piece of mail = correspondência
pier = ancoradouro, cais de atracação
pig = porco
pigeon = pombo
pigeonhole = compartimento, especialidade, secção
pike = lúcio
pile = acervo, acúmulo, chusma, cúmulo, montão, multidão, pilha, ruma
pile up = juntar em excesso, acumular, amontoar, empilhar
pilgrim = peregrino
pilgrimage = peregrinação
pill = pílula
pillow = almofada, travesseiro
pilot = pilotar, piloto
pimple = acne, borbulha
pin = alfinete
pincers = tenaz, tenazes, pinça
pinch = beliscar, pegar com pinça, tomar entre dois dedos
pine = pinheiro
pineapple = abacaxi, ananás
pine-tree = pinheiro
pink = cravo, cor-de-rosa
pioneer = bandeirante, pioneiro, precursor
pious = piedoso, pio, religioso
pip = grão, semente
pipe = cachimbo, cano, canudo, tubo
pirate = pirata
pistol = pistola
piston = êmbolo, pistão
pit = cava, fossa, âmago, caroço, cerne, núcleo
pitcher = bilha, cântaro, jarra
pitiful = coitado, lastimável
pity = coisa lamentável, apiedar-se de, compadecer-se, lastimar, compaixão, piedade
pivot = pivô
placard = afixar, pregar cartazes, cartaz, edital, papeleta
place = adaptar, adaptar, ajeitar, ajustar, local, recinto, sede, acomodar, local, lugar, paragem, sítio, colocar, meter, pôr
place of refuge = refúgio
place of worship = casa de oração, igreja, templo
place to sit = lugar
plague = peste
plain = planície, terra plana, claro, distinto
plait = trançar, entrançar
plan = intenção, planta, posição, planejar, projectar, projetar, plano, projeto, projecto, traçado, bosquejar, esboçar, rascunhar
plane = aeroplano, avião, planar, plano, planta, posição, projeto, plaina
planet = planeta
planetary = planetário
plank = placa, prancha, tábua
plant = fincar, plantar, planta, vegetal
plantation = plantio, viveiro de plantas
plash = bater, estalar, marulhar, patinhar
plasma = plasma
plaster = emplastro
plaster of Paris = gesso
plastic = plástico
plate = travessa, travessa, chapa, prato
plateau = planalto, superfície plana
platform = tablado, cais, plataforma, estrado, pódio, programa
platitude = coisa banal, trivialidade, vulgaridade, banalidade
platter = prato, travessa
play = brincar, representar, jogar, tocar, peça para teatro
play a small part = atuar como figurante
playful = arteiro, travesso, brincalhão, gracejador
plaza = adro, largo, praça
plea = argumentação, advogar, pleitear, solicitar
plead = advogar, pleitear, solicitar
plead for = interceder
pleasant = ameno, aprazível, agradável, prazeroso
pleasantly = agradavelmente, de maneira agradável
pleasantness = agradabilidade
please = faça favor, por favor, agradar, aprazer
pleased = contente, satisfeito
pleasing = agradável, aprazível
pleasurable = agradável, prazeroso
pleasure = deleite, delícia, prazer
plentiful = basto, farto, abundante, basto, copioso, farto, lauto
plenty = abundância, fartura
plenty of = um grande número de
plot = intriga, complô, conjuração, trama
plough = arar, lavrar, arado
pluck = arrancar, colher, tirar
plug = vela, absorvente, tampão, bucha, rolha, tampa
plug in = ligar
plug up = arrolhar, tampar, tapar
plum = ameixa
plume = pena, pluma
plunder = pilhar, roubar, saltear
plunge = mergulhar
plus = mais
pneumonia = pneumonia
pocket = algibeira, bolsa, bolso
podium = estrado, pódio
poem = poema
poet = poeta
poetic = poético
poetry = poesia
point = ápice, extremidade, pico, ponta, ponto
pointed = aguçado, pontudo
point out = apontar, assinalar, mostrar
point out to be = aparercer, mostrar-se
poise = balançar-se, ondular, oscilar
poison = envenenar, intoxicar, peçonha, tóxico, veneno
poisonous = tóxico, venenoso
poker = pôquer
Poland = Polónia, Polônia
polar = polar
pole = mourão, poste, pólo, estaca, pau, vara
police = polícia
policeman = polícia
police-station = delegacia de polícia, esquadra de polícia
policy = apólice, política
polish = graxa, polir, talhar, recortar
Polish provincial governor = voivoda, voivode
polite = cavalheiro, cortês, gentil, polido
politeness = cortesia
political = político
political meeting = <grande reunião popular>
politics = política
polka = polca
pomp = gala, ostentação, pompa
pond = lago
pooh = ai, bah
pool = reunir-se, associar-se, piscina, unir-se
poop = popa
poopdeck = popa
poor = coitado, lastimável, mau, ruim, pobre
pope = papa
poplar = álamo, choupo
poppy = dormideira, papoula
popular = popular
population = população
porch = alpendre, pórtico, varanda
pork = carne de porco
pornographic = pornográfico
pornography = pornografia
port = abrigo, porto
portal = entrada, portão
portent = adivinhação, agouro, augúrio, presságio, profecia
porter = carregador, porteiro
portfolio = dossiê
porthole = clarabóia
portrait = retrato
port side = bombordo
Portugal = Portugal
Portuguese = português
pose = afectação, fingimento, afectar, fingir, posar, pose
position = posição
positive = positivo, real
positively = definitivamente
possess = fruir, possuir, ter
possession = possessão, propriedade
possibility = possibilidade
possible = possível
possibly = acaso, por ventura, possivelmente, talvez
post = afixar, pregar cartazes, estaca, mourão, poste, cargo, emprego, lugar, ofício, posto, correio
postage = franquia, porte
postage stamp = selo, selo do correio
postcard = bilhete postal, cartão postal
poster = cartaz, edital, papeleta
postman = carteiro
post office = agência postal, correio
post-paid = com porte pago, franqueado
postpone = adiar, procrastinar
postulate = exigir, postular, reclamar
post up = afixar, pregar cartazes
pot = bacia de cama, penico, panela, pote, vaso
potato = batata, batatinha
potter = oleiro
pottery = <objecto feito de argila>, faiança, faiença, prato, vaso
poultry = carne de ave
pound = britar, calcar, pisar, socar, libra
pound sign = diese, sustenido
pound sterling = libra
pour = despejar, verter, derramar, entornar
pour in = <derramar em alguma coisa>
pour off = decantar
pour out = esvaziar, derramar, entornar
poverty = pobreza
powder = empoar, passar pó-de-arroz, pó-de-arroz, pó
powdery = pulvéreo
power = potência
powerful = poderoso, potente
power station = central
practical = prático, real, verdadeiro
practice = aplicar, por em prática, exercitar-se, practicar, exercício, exercer, praticar, prática, tirocínio
practice of medicine = medicina
practise = ensaiar, exercer, exercitar, treinar, exercitar-se, practicar, praticar
Prague = Praga
prairie = <uma das vastas planícies da América do Norte>
praise = glorificar, santificar, elogiar, gabar, louvar, elogio, louvor
prawn = camarão
pray = fazer prece, orar, rezar
prayer = oração, prece
preach = fazer sermão, pregar
preacher = pregador sagrado
precede = anteceder, preceder
precious = de pouca densidade, pouco frequente, pouco freqüente, precioso
precipice = abismo, boqueirão, fundão, pélago, precipício, sorvedouro
precise = bem acabado, distinto, limpo, líquido, polido, certo, exacto, exato, preciso
precision = exactidão, precisão
precize = bem acabado, distinto, limpo, líquido, polido
predisposition = disposição
prefer = gostar mais de, preferir
preferably = mais
prefix = prefixo
pregnant = grávida
prejudice = preconceito, prejuízo
preliminary = preparativo, preparatório
premier = primeiro ministro
premium = ágio, prémio, prêmio, recompensa
preparation = preparação, preparo
preparatory = preparativo, preparatório
prepare = aparelhar, aprontar, preparar
prepay = franquear, selar
preposition = preposição
presage = adivinhação, agouro, augúrio, presságio, profecia
prescription = fórmula, prescrição, receita
present = vigente, brinde, dádiva, mimo, hodierno, contemporâneo, presente, actual, apresentar, oferecer
presentation = apresentação, oferta, proposta
present-day = actual, vigente, hodierno
present with = apresentar, oferecer
preserve = conservar, guardar
preside = presidir
president = presidente
press = imprensa, jornalismo, apertar, comprimir, espremer, impressora, prelo, apressar, instar, atropelar
pressing = urgente
prestige = importância social, prestígio
prestigious = prestigioso
presume = alegar, pretender, conjeturar, fazer de conta, supor
presumption = arrogância, impertinência, pretensão
pretence = pretensão
pretend = pretextar, aparentar, fingir, simular
pretentious = de parada
pretext = pretexto
Pretoria = Pretória
pretty = bonito, lindo
prevail over = sujeitar, superar pela força, prevalecer
prevent = atrapalhar, prejudicar
previous = antecedente, anterior, precedente
previously = anteriormente, antes, em lugar anterior
previous to = antes de, antes que
price = preço
priceless = inestimável, inapreciável
price-list = lista de preços
pricey = caro
prick = pênis, espadas
pride = orgulho
priest = clérigo, padre, sacerdote
prime minister = primeiro ministro
primeval forest = mata virgem, selva
primitive = primitivo
primrose = primavera, prímula
prince = príncipe
princess = princesa
prince's son = filho de príncipe
principal = básico, capital, principal
principally = em especial, principalmente, sobretudo
principle = princípio
print = estampar, imprimir
printed matter = impresso
printer = impressor, tipógrafo
prior = antecedente, anterior, precedente, preparativo, preparatório
prism = prisma
prison = prisão, cadeia, prisão
prisoner = preso, prisioneiro
private = particular, privado
privilege = privilégio
privileged = privilegiado
prize = prémio, prêmio, recompensa
probable = provável, verossímil
probably = talvez, provavelmente
problem = problema
proboscis = focinho, rosto, tromba
procedure = proceder, procedimento, processo
proceed = proceder
proceed with = avançar, continuar, prosseguir
process = proceder, procedimento, processo
procession = cortejo, procissão
proclaim = proclamar
proclamation = declaração, declaracão, depoimento, proclamação
procure = arranjar, obter
produce = realizar
product = produção, produto
production = produção
profane = desonrar, profanar, violar
profess = confessar, professar, reconhecer
profession = profissão
professional = profissional
professor = professor
profile = perfil
profit = aproveitar, lucrar, tirar proveito de, lucro, proveito, vantagem
profound = entranhado, fundo, profundo
profuse = abundante, basto, copioso, farto, lauto
prognosis = prognose, prognóstico
programme = programa
programme item = ítem de programa
progress = melhoramento, ganhar terreno, progredir, progresso
project = plano, projeto, projecto, traçado
projector = projector, projetor
proletarian = proletário
proletariat = proletariado
prologue = prólogo
promenade = logradoura, passeio
promise = prometer, promessa
promote = promover
promotion = acesso, promoção
prompt = exato, pontual, dizer em voz baixa, sugerir, soprar
prompter = ponto
pronounce = articular, proferir, pronunciar
proof = prova gráfica, prova
prop = apoio
propaganda = divulgação, propaganda
propeller = espira, hélice, rosca
proper = conveniente, decoroso, próprio, afinado, correcto, correto, exacto, exato, preciso
properly = como é justo, como se deve, decentemente
property = bens de raiz, domínio, fazenda, granja, roça, terras, predicado, qualidade, possessão, propriedade
prophecy = profecia
prophesy = predizer, adivinhar, agourar, augurar, pressagiar, profetizar
prophet = profeta, vidente
proportion = proporção
proportional = proporcional
proposal = oferta, proposta
propose = oferecer, propor
prose = prosa
prosecute = acossar, perseguir
prospectus = prospecto
prosper = prosperar
prosperity = prosperidade, sucesso
prostitute = prostituir, prostituta
protect = abrigar, proteger, resguardar
protection = auspício, bom augúrio, égide, amparo, defesa, protecção
protectionist = protecionista
protective cover = capa, fronha
protégé = protegido
protein = proteína
protest = protestar, protesto
Protestant = protestante
protocol = acto, protocolo
proton = próton
prototype = protótipo
proud = orgulhoso
prove = demonstrar, fazer prova de, demostrar, provar
proverb = provérbio, adágio, conceito, sentença
provide = abastecer, prover, suprir
provided that = ão de, na suposição de, no caso de, se
province = governo, província
provisional = provisório, temporário
provoke = concitar, incitar, desafiar, provocar, reptar
provost = administrador de aldeia
prow = proa
prudent = judicioso, prudente, sensato
prudish = afetadamente pudico, recatado em excesso
Prussia = Prússia
psalm = salmo
pseudonym = pseudônimo
psychiatrist = psiquiatra
psychiatry = psiquiatria
psychic = psíquico
psychologist = psicólogo
psychology = psicologia
pub = bar
public = público
publicity = divulgação, propaganda
publicity material = material publicitário
publicize = fazer propaganda de
public prosecutor = procurador, procurador público
public square = adro, largo, praça
publish = editar, emitir, proferir, publicar
publisher = editora, casa editora, editor
publishing house = editora, casa editora
pudding = pudim
puff = fofo
puff out = afofar, inchar
puff up = tornar-se tumefacto
pull = tiragem, atrair, sacar, puxar, tirar
pulley = polia
pullover sweater = pulôver, suéter
pull someone's leg = fazer blague, mistificar por pilhéria
pull up = desenterrar, exumar
pulmonaria = pulmonária
pulpit = cátedra
pulsate = palpitar, pulsar
pulse = pulso
pulverize = moer, pulverizar
pump = aspirar, calcar, bomba
pumpkin = abóbora
pun = calembur, trocadilho
punch = dar bofetadas, esmurrar, ponche
punctual = exato, pontual
punctuate = pontuar, pontilhar
punctuation = pontuação
punish = castigar, punir
punishment = castigo, punição
punk = isca
pupil = pupilo, tutelado
puppet = fantoche, marionete, boneca, boneco
purchase = compra, coisa comprada, comprar
purchaser = comprador, freguês
pure = limpo, castiço, puro
purgatory = purgatório
purge = assear, limpar, purificar
puritan = puritano
purity = asseio, limpeza, castidade, pudicícia, pureza
purple = purpúreo, roxo
purpose = alvo, fim, ponto de mira
purse = bolsa, carteira
pursue = acossar, perseguir
pus = pus
push = empurrar, impelir, empurrão, impulso
push along = empurrar
push-button = botão de pressão
pussy = vulva
put = colocar, meter, pôr
put away = recolher à garagem
put down = colocar, meter, pôr
put in = inserir, introduzir
put in finished form = passar a limpo
put in order = arranjar, arrumar, ordenar
put off = depor, tirar
put on = activar, aplicar, apor, vestir
put on airs = afectar, fingir
put on stamps = franquear, selar
put on the stage = apresentar, oferecer
put onto = acrescentar, aplicar, apor
put out = apagar, extinguir
put out to tender = adjudicar
putrefy = apodrecer, gorar
put right = ajustar, adaptar, dispor
put together = compor
put to shame = causar vergonha, envergonhar
put to sleep = fazer dormir
put up = acomodar, adaptar, ajeitar, ajustar, hospedar
put up with = aguentar, padecer, sofrer, agüentar, tolerar, suportar, aturar
puzzle = adivinhação, enigma, atrapalhar, confundir, perturbar, atordoar, bestificar, desconcertar
puzzle over = esforçar-se mentalmente
pyjamas = pijama
pyramid = pirâmide
Pyrenees = Pirinéus