#setName = words_en_pt_Ss
#sideOneTitle = ENG
#sideTwoTitle = POR
Sabbath = sábado
sack = demitir, destituir, exonerar, despedir, saco
sacrament = sacramento
sacred = sacro, sagrado, santo
sacrifice = imolar, ofertar, sacrificar
sad = acabrunhado, aflito, sombrio, macambúzio, triste, macambúzio
saddle = arreio, sela
sadism = sadismo
sadist = pessoa sádica
sadistic = sádico
sadness = tristeza
safety = segurança
safety-belt = salva-vidas
safety-pin = fíbula
safety pin = fíbula
sagacious = inteligente, ajuizado, prudente, sábio, sensato
sage = salva, ajuizado, prudente, sábio, sensato
Sagittarius = Sagitário
Sahara = Saará
sail = partir, velejar, pano, vela
sailor = marinheiro
sailplane = planador
saint = santo
salad = salada
salary = salário, ordenado
sale = boa aceitação, saída fácil, venda, vendagem
sales activity = mercado
salesman = vendedor
saliva = saliva
salivate = salivar
sallow = descorado, pálido
salmon = salmão
Salomon = Salomão
salon = sala de visitas, salão
salt = salgar, sal
saltshaker = saleiro
salute = cumprimentar, saudar
Salvation Army = Exército da Salvação
Samaria = Samaria
same = mesmo, tal
samovar = samovar
sample = amostra, espécime
sanctify = santificar
sanction = homologar, sancionar, homologação, sanção
sand = areia
sandal = alpercata, sandália
sandbank = banco de areia
sap = seiva, suco, sumo
sap-wood = alburno
sarcasm = sarcasmo
sarcastic = sarcástico
sardine = sardinha
Sardinia = Sardenha
sarong = sarongue
Sassenach = inglês
Satan = Satã, Satanás
Satanic = satânico
satellite = satélite
satisfied = contente, farto, saciado, satisfeito
satisfy = satisfazer
Saturday = sábado
sauce = molho, tempero
saucepan = caçarola
saucer = pires, prato de sobremesa, prato pequeno
Saudi Arabia = Arábia Saudita
sausage = salsicha
savage = bravio, gentio, selvagem
save = salvar, economizar, poupar
saw = serrar, serra, serrote
saxophone = saxofone
say = dizer, proferir, hei, psiu, <estar formulado ou redigido com certas palavras>
say goodbye = dar adeus, despedir-se, dizer adeus
say goodbye to = dar adeus, despedir-se, dizer adeus
say yes = dizer sim, responder que sim
scabbard = bainha da espada
scaffold = cadafalso, patíbulo
scald = escaldar, escalfar
scale = gama, desenho, escala, escama
scales = balança
scandal = escândalo
Scandinavia = Escandinávia
scanty = escasso, insuficiente, raro
scar = cicatriz
scarce = escasso, insuficiente, raro
scarcely = apenas, logo que, mal, quase não
scare = afugentar, enxotar
scatter = despejar, verter, derramar, entornar
scene = cena, quadro
scenery = paisagem
scent = cheiro, hálito, odor
schedule = horário
Scheldt = Escalda
scheme = plano, projeto, projecto, traçado, esquema
schism = cisão, cisma, dissidência
school = escola
school desk = carteira, estante
science = ciência
scientist = cientista
scissors = tesoura, tosquiadeira, podadeira
scold = admoestar, advertir, exortar, induzir, censurar, incriminar, repreender
scooter = patinete
scorpion = escorpião
Scot = escocês
Scotland = Escócia
Scotsman = escocês
Scottish = escocês
scoundrel = biltre, canalha, traste
scourge = calamidade, flagelo, praga
scout = escoteiro
scrap = andrajo, farrapo, molambo, trapo
scrape = arranhar, rapar, raspar
scratch = coçar, arranhar, rapar, raspar
scream = berrar, bradar, gritar
screen = biombo, tela
screw = coitar, copular, transar, atarraxar, parafusar, parafuso, tarraxa
screwdriver = chave de parafusos, chave de fenda
screw up = borrar, fazer às pressas, trabalhar mal
scuffle = batalha, combate, luta, peleja, pugna
scythe = foice, fouce, segadeira
sea = mar
sea-anemone = actínio, actínia, anêmona-do-mar, urtiga-do-mar
sea-dog = foca
seagull = gaivota
seal = foca, lacrar, selar, chancela, selo
seam = costura, sutura, suturar, suturação
Sea of Azov = Mar de Azove
sea pink = arméria
seasickness = enjôo
seaside = costa, litoral
season = dar gosto a, estação, temporada
seat = lugar
seaweed = alga
seclude = ilhar, insular, isolar
secluded = isolado
second = segundo
secondary = acessório, secundário
secondhand dealer = adelo, belchior
secret = confidência, oculto, secreto, segredo, sigilo
secretary = secretário
secret code = cifra, código secreto, escrita secreta
secrete = excretar
sect = seita
section = compartimento, especialidade, secção, seção
secure = aprazar, cravar, determinar, fixar
security = segurança
seduce = desencaminhar, seduzir
see = achar, encontrar, mirar, presenciar, pôr em vista, ver, enxergar, fazer visita, fazer visitas, ir ver, visitar, acurar, cuidar, preocupar-se, tutelar, zelar
see again = rever
seed = semente
seek = buscar, investigar, procurar
seem = mostrar-se, parecer, ter aparência de
seemingly = aparentemente
seemly = adequado, apropriado, conveniente
see on television = ver pela televisão
seize = requisitar
seizure = apoplexia
seldom = raramente
self = mesmo, próprio
self-assurance = altivez, aprumo, desembaraço, pose
self-assured = auto-confiante
self-conscious = acanhado, vergonhoso
selfinterest = egoísmo
selfishness = egoísmo
selfless = dedicado
self-sufficiency = autarquia
self-taught man = autodidata
sell = ceder, colocar, vender
send = enviar, mandar, remeter
sender = remetente
send for = fazer vir, ir buscar, mandar buscar
send in Morse code = enviar em código Morse
send off = aviar, despachar, expedir
sensation = sensação, sentimento
sensational = sensacional
sense = sentido, significado, experimentar, sentir
sense of taste = prova
sensible = judicioso, prudente, sensato
sensitive = impressionável, sensível
sentence = frase, proposição, amaldiçoar
sentiment = sentimento
sentimental = sentimental
separate = avulso, especial, isolado, particular, peculiar, reservado, apartar, separar, separar, apartar-se, separar-se, desmembrar, dividir, repartir
separately = à parte, em separado
sepia = lula, sépia
September = Setembro
septic = séptico
serenade = serenata
serene = calmo, sereno
serf = escravo, servo
serfdom = servidão
sergeant = sargento
serial = serial
series = série, sequência, seqüência, sucessão
serious = categorizado, importante, inquietante, alarmante, grave, sério, sisudo
sermon = prédica, pregação, sermão
serpent = cobra, serpente
serum = sero, soro
servant = criada, criado, servente, servidor
serve = estar de plantão, estar de serviço, montar guarda, ajudar, prestar serviço, servir
service = culto, ofício divino, serviço
servitude = servidão
session = sessão
set = aparelho, máquina, are, colecção, grupo, reunião, fato, jogo, terno, série, sequência, seqüência, sucessão, descer, esconder-se, pôr-se
set a trap = insidiar
set a trap for = insidiar
set conditions = convencionar, estipular
set in = começar
set out = partir, pôr-se a caminho
set straight = desiludir
seven = sete
seventeen = dezessete
seventh = sétimo, um sétimo
seventy = setenta
several = bastante, mais de um, vários
several times = às vezes, por vezes
severe = austero, rígido, rigoroso, severo
sew = coser, costurar
sex = sexo
sexual desire = cio
sexual love = amor sexual
sexual pleasure = sensualidade, volúpia
shack = barraca, cabana, choça, choupana
shackle = acorrentar, algemar, cadeia, corrente, grilhão
shade = matiz, nuança, sombra
shadow = sombra
shaft = poço
shaggy = peludo, piloso, viloso
shah = xá
shake = abalar, estremecer, sacudir
shake one's head = negar com a cabeça
shallow = baixo
shame = credo, cruzes, fora, vergonha
shameful = torpe, vergonhoso
shamrock = trevo
shanty = barraca
shape = formar, feitio, forma, jeito
share = acção, apólice, desmembrar, dividir, repartir, participar, tomar parte, parte, dose, porção, quantidade
shareholder = acionista
shark = tubarão
sharp = afiado, cortante, picante, acre, afiado, agudo, cortante, penetrante, picante, ríspido, exatamente, pontualmente, diese, sustenido, justamente, precisamente
sharpen = acerar, afiar, aguçar
sharpness = acrimônia, acuidade, agrura, agudeza
shatter = britar, esmagar, quebrar
shave = barbear, raspar
shawl = xale
she = dela
sheaf = feixe, molho, penca
shear = cortar, podar, tosar, tosquiar, desbastar, espoliar, depenar
she-bear = ursa
shed = barraca, celeiro, guarita, tenda, derramar, despejar, verter
shed tears = derramar lágrimas, lacrimejar
sheen = brilho, luzeiro
sheep = carneiro, ovelha
sheet = folha, lençol, chapa
sheet metal = folha, lata, folha de lata, lámina de metal, lâmina de metal
sheikh = xeique, xeque
shelf = prateleira
shell = carapaça, concha, descascar, casca, crosta
shelling = bombardeio
shelter = refúgio, abrigo, abrigar, proteger, resguardar, <utensílio para proteger contra>
shepherd = pastor
sheriff = xerife
shield = égide, amparo, defesa, protecção, escudo, tabuleta
shilling = xelim
shin-bone = tíbia
shine = brilhar, fulgir, fulgurar, luzir
shingle = tabuinha, telha de madeira
ship = aviar, despachar, expedir, embarcação, navio
ship = -dade
shipwreck = naufrágio
shirt = camisa
shiver = tiritar, tremer
shock = abalar, estremecer, sacudir, chocar, melindrar, choque
shock absorber = amortecedor
shoe = sapato
shoe-lace = cadarço, cordão, cordel, atacador
shoemaker = sapateiro
shoo = tanger, tocar
shoot = atirar, disparar, broto
shop = armazém, loja, venda
shopkeeper = lojista
shopping-centre = shopping center
shore = borda, margem, costa, litoral
short = breve, curto
shortage = carência, falha, falta
short circuit = curto-circuito
shortcoming = carência, falha, falta
shorthand = estenografia
shortness of breath = asma
short-sighted = míope
short story = conto, novela
should = dever, ter a obrigação, ter de, ter que
shoulder = berma, ombro
shout = berrar, bradar, gritar, grito
shove = empurrar
shovel = apanhar, remover, pá
show = declarar, manifestar, apontar, assinalar, mostrar, espectáculo, espetáculo
showcase = mostrador, vitrina
shower = ducha
showerhead = chuveiro
showerstall = ducha
show off = empavonar-se, pavonear-se
show window = vitrina
shrapnel = schrapnell
shrew = megera
shrewd = sagaz, astuto
shrewish = cruel, megera, perversa
shrimp = camarão
shrink = contrair-se, encarquilhar-se, engelhar, enrugar-se
shrivel up = encarquilhar-se, engelhar, enrugar-se
shrub = arvoreta, arbusto
shuffle = baralhar, mesclar, mexer, misturar
shut = fechar, fechado
shy = vergonhoso, tímido, acanhado
Siam = Tailândia
Siberia = Sibéria
Sicily = Sicília
sick = doente, enfermo
sickle = foice
side = acessório, apenso, lateral, banda, costado, flanco, lado, bandeira, facção, partida, partido
sideboard = armário, estante
side-issue = acessório, anexo
sidewalk = calçada, passeio
side-whiskers = barba, suíças
siege = cerco, sítio
sieve = peneira
sift = joeirar, peneirar
sigh = gemer, suspirar
sight = aparência, semblante, alça, aspecto
sightless person = cego
sightseeing trip = excursão
sign = adivinhação, agouro, augúrio, presságio, profecia, prova, aceno, signo, marca, ponto, sinal, assinar, subscrever
signal = anunciar por sinal, aceno, signo, marca, ponto, sinal
signalman = guarda-barreira
signature = assinatura
sign-board = escudo, tabuleta
signify = denotar, querer dizer, significar
sign language = mímica
silence = calma, quietude, sossego, silêncio
silent = calado, silencioso
silhouette = recorte, silhueta
silk = seda
silkworm = bômbice, bômbix
sill = limiar, soleira
silliness = coisa fútil, coisa sem sentido, coisa vã
silver = argênteo, argentino, prateado, prata
similar = semelhante, similar, parecido
similarity = similaridade
simple = simples, singelo
simplify = simplificar
simultaneous = simultâneo
sin = cometer pecado, pecar, pecado
since = de, por, atrás de, depois de, desde quando, a partir de, desde, pois que, porque, visto que
sincere = franco, sincero
sincerity = franqueza, sinceridade
sinew = tendão
sing = cantar
singer = cantora, cantador
single file = um após o outro, fila única
singly = um a um
sink = afogar-se
sip = absorver, sorver
sir = amo, patrão, senhor
sister = irmã
sit = chocar, incubar, estar sentado, ter assento
sit down = sentar-se, assentar-se
site = situação
sitting-room = sala, sala de visitas, salão
situation = circunstância, condição, posição, situação
six = seis
sixteen = dezesseis
sixth = sexto, um sexto
sixtieth = sexagésimo
sixty = sessenta
sizable = apreciável, considerável
size = amplitude, amplidão, dimensão, extensão, grandeza, grandeza, tamanho
skate = patins, patinar, raia, arraia
skeleton = esqueleto
skeptic = céptico
skeptical = céptico
sketch = bosquejar, esboçar, rascunhar, esboço
ski = esquiar, esqui
skillful = ágil, hábil, jeitoso
skimpy = magro
skin = <pele de animal com pélos>, cútis, pele, pelar, tirar a pele
skinflint = avarento
skinny = magro
skip rope = pular corda
skirt = saia
skull = caveira, crânio
sky = alturas, céu, olimpo
skylight = clarabóia
slab = chapa
slander = caluniar, difamar, injuriar
slanting = enviesado, esguelhado, oblíqua
slap = bofetada, tabefe, tapona
slat = ripa, sarrafo
slaughter = abater, jugar, massacrar, matar, trucidar
Slav = eslavo
slave = cativo, escravo
Slavic = eslávico, eslavo
slay = matar
sledge = trenó
sleep = dormir, sono
sleep heavily = dormir profundamente
sleeping-accomodation = dormitório
sleeping-car = vagão-cama, vagão-dormitório, vagão-leito
sleeping-place = dormitório
sleepy = dorminhoco, sonolento
sleeve = manga
sleigh = trenó
slender = delgado, fino, delicado, esbelto, esguio, gracioso
slice = fatia, talhada, cortar, partir, talhar
slim = esbelto, esguio, gracioso
slime = limo, lodo
slip = deslizar, escorregar, ficha
slipper = chinela, chinelo, pantufa
slippery = escorregadio
slogan = cambial, divisa, lema
slope = declive, encosta, ladeira, rampa, vertente
slope down = formar declive
sloping = inclinado, em rampa
sloth = preguiça
slothful = preguiçoso, vadio
slow = lento, vagaroso
slow-worm = ânguis, cobra-de-vidro
slug = límax, lesma
slumber = cochilar, dormitar
sly = ardiloso, astuto, ladino
sly joke = blague, mentira por gracejo, pilhéria
smack = beijocar, beijar ruidosamente, fazer ruído de sucção
small = pequeno
small bench = banqueta, banquinho, mocho
small letter = minúscula
small plate = prato de sobremesa, prato pequeno
smallpox = bexigas, varíola
small room = câmera escura, quarto sem janela
smart = ardiloso, astuto, ladino
smash = britar, esmagar, quebrar
smear = lambuzar, rebocar, ungir, untar
smell = cheirar, exalar cheiro, cheiro, hálito, odor
smile = sorrir, sorriso
smoke = fumar, fumaça, fumo
smokers = fumadores, fumantes
smokestack = chaminé, cano da chaminé
smooth = chão, chato, raso, liso, plano, polido, alisar, polir
smuggle = contrabandear
smuggler = contrabandista
snack = merenda, lanche
snail = caracol, àzinho, arroba
snake = cobra, serpente
snare = insídia, alçapão, armadilha
sneer = <dar um ar de riso alvar ou mordaz>
sneeze = espirrar, espirro
snifter = aperitivo
snob = esnobe
snobbish = esnobe
snore = ressonar, roncar
snorter = aperitivo
snow = nevar, neve
snowball = viburno, vime, vimeiro, sabugueiro-de-água, novelos
snowdrop = fura-neve
snowflake = floco de neve
so = então, portanto, logo, por conseguinte, sendo assim, daquela maneira, deste modo, assim, daquela maneira, desta maneira, deste modo
soak = imergir
soap = sabão, ensaboar
so ... as = qual ... tal
sober = comedido, parco, sério, sóbrio
soccer = futebol
soccer ball = futebol
social = social
socialism = socialismo
society = comunidade, corpo social, sociedade
sock = meia, peúga
socket = bainha, estojo
sodomize = praticar sodomia
sofa = canapé, sofá
soft = ameno, doce, meigo, brando, fofo, macio, mole, suave
soil = macular, manchar, chão, solo, terra
soiled = sujo
solder = luto, solda, fechar com luto, soldar
soldier = praça, soldado
sole = mero, simples, planta, sola, isolado, só, sozinho, único, linguado
solely = não ... mais que, só, somente
solemn = solene
solicitor = advogado
solid = sólido
solidarity = solidariedade
solitary = mero, simples, isolado, só, sozinho, único, solitário
solo = solo
so long = até a vista, até logo, até mais ver
solution = solução
solve = solver, dissolver, resolver
somber = sombrio, triste, macambúzio
some = um pouco, um tanto, alguém, uma pessoa, algum, alguns, certo número de, vários
somebody = alguém, algum, uma pessoa
somehow = de qualquer jeito
some kind of = um, algum, qualquer
someone = alguém, algum, uma pessoa
some one = alguém, algum, uma pessoa
someone's = de alguém
something = algo, alguma coisa
something new = coisa nova, inovação, notícia
sometime = um dia, uma vez, outrora
sometimes = outrora, uma vez, às vezes, por vezes
somewhat = um pouco, um tanto
somewhere = algures
son = filho
sonata = sonata
song = canção, cantiga, canto
songbook = cancioneiro
son-in-law = genro
soon = brevemente, cedo, depressa, logo
soot = fuligem, picumã
soothe = tranqüilizar, acalmar, sossegar
sophisticated = astuto, sagaz
soprano = soprano
sorcery = encanto, feitiço
sore = úlcera
sorrel = baio
sorrow = tristeza
sort = espécie, género, jaez, laia, qualidade
so so = assim
so to speak = por assim dizer
soul = alma, ânimo, espírito
sound = bater, soar, som, sonido
sound the alarm = alarmar, dar alarma
soup = sopa
sour = acerbo, ácido, azedo, azedar-se, adstringente, arisco, brusco, rabugento
source = fonte, manancial, nascente
south = austral, meridional, sul
South Africa = África Meridional, África do Sul
South America = América do Sul
southern = austral, meridional
sovereign = soberano
Soviet = soviético
Soviet Union = União Soviética
sow = plantar, semear
spa = balneário
space = âmbito, espaço, extensão
spaceman = astronauta
spacious = amplo, espaçoso, extenso, grande, lato
spade = cavar, revolver, cavadeira, enxada, pá
spades = espadas
Spain = Espanha
Spaniard = espanhol
Spanish = espanhol
spanner = chave
spare = ser indulgente para, economizar, poupar
spare time = férias
spark = fagulha, faísca, centelha
spark plug = vela
sparrow = pardal, pássaro
spasm = espasmo
speak = falar
speaker's platform = pódio, tribuna
special = avulso, isolado, peculiar, reservado, especial, extraordinário, particular, próprio
specialist = experto, louvado, perito, especialista, expert
speciality = compartimento, especialidade, secção
specific = específico
specify = especializar, especificar
specimen = amostra, espécime
spectacle = espectáculo, espetáculo
spectacles = óculos
spectator = espectador
speech = conferência, discurso, fala
speechless = calado, mudo
speed = rapidez, velocidade
speed-limit = limite de velocidade
speed limit = limite de velocidade
speed up = acelerar, adiantar, apressar, atirar, aumentar a velocidade de
speedwell = verônica
speedy = breve, iminente, próximo, rápido, veloz
spell = soletrar
spend = gastar, fazer passar
spend the night = <passar a noite em algum lugar>
sperm = esperma
sphere = esfera
spice = condimentar, temperar, espechiaria
spider = aranha
spiderweb = teia de aranha
spiked = aguçado, pontudo
spill = derramar, entornar, espargir
spin = fiar, reduzir a fio, tecer
spinach = espinafre
spindle = fuso
spine = espinha, coluna vertebral, espinha dorsal
spinning-wheel = roda de fiar
spinster = senhorita, celibatária, solteira
spirit = alma, gênio, espírito, vivacidade, animação
spirits = bebida alcoólica
spiritual = espiritual
spiritualism = espiritismo
spit = cuspir, salivar
splash = bater, estalar, marulhar, patinhar
splender = gala, ostentação, pompa
splinter = lascar, rachar, romper, farpa, lasca
split = fender, partir, lascar, rachar, romper
spoil = arruinar, avariar, danificar, deteriorar, borrar, fazer às pressas, trabalhar mal, adulterar, estragar, viciar
sponge = esponja
sponger = parasita
spongy = esponjoso
spontaneous = espontâneo
spool = bobina, carretel, carrinho
spoon = colher
sporadic = casual, esporádico, raro
sport = esporte, desporte
sportsman = esportista, desportista
spot = local, lugar, paragem, sítio, macular, manchar, mácula, mancha, nódoa, ponto
spray gun = pistola
spread = divulgar, espalhar, deitar, desenvolver, estender, expor, fazer cair, lambuzar, rebocar, ungir, untar
spread out = desdobrar, desfraldar, deitar, desenvolver, estender, expor, fazer cair
spring = jorrar de uma fonte, fonte, manancial, nascente, primavera, corda, mola, pular, saltar
springtime = primavera
sprinkle = aspergir, borrifar, jogar água benta, orvalhar, regar
spur = esporar, esporear, aguilhão, espora
spurge = eufórbio
spur on = impelir, incitar, instigar
spurt = borbotar, esguichar, jorrar, minar
spurt out = borbotar, esguichar, jorrar, minar
spy = espionar, espião
spy on = espiar, espionar
squabble = beijar-se, bicar reciprocamente
squad = bando, companhia, turma
square = quadrado, quadro, recto, reto, adro, largo, praça
square decametre = are
squash = abóbora
squat = estar agachado, estar de cócoras
squeeze = apertar, comprimir, espremer
squint = ser vesgo, vesguear
squirrel = esquilo, serelepe
squirt = fazer jorrar
stab = aferroar, picar
stable = consistente, constante, durável, estável, firme, curral, estábulo, estrebaria, redil, cavalariça
stableman = palafreneiro
stack = juntar em excesso, acumular, amontoar, empilhar
stadium = fase, etapa, estádio
staff = estado-maior
stage = estrado, pódio, tablado, cenário, palco, estação, paragem, fase, estádio, etapa
stage-manager = contra-regra, diretor de cena, ensaiador
stagnate = estagnar, ficar parado
staid = grave, sisudo, comedido, parco, sério, sóbrio
stain = macular, manchar
stair = escalão, degrau
staircase = escada
stairs = escada
stake = mourão, poste, estaca, vara
stale = passado, seco
stalk = andar, caminhar, dar um passo, caule, haste, talo
stall = curral, estábulo, estrebaria, redil
stallion = garanhão
stammer = balbuciar, gaguejar, tartamudear
stamp = selo, selo do correio, estampar
stamp-collecting = filatelia
stamped = com porte pago, franqueado
stanchion = estaca, mourão, poste
stand = barraca, celeiro, guarita, tenda, de súbito pôr-se de pé, estar de pé, permanecer
standard = norma, padrão, bandeira, estandarte, pendão
stand guard = estar de sentinela
standing on end = eriçado, hirto
standing together = solidário
stand up = de súbito pôr-se de pé
stand up to = afrontar, arrostar
staple = grampo, parêntese
star = astro, estrela, estrelho
starboard = estibordo
starch = apresto
start = activar, dar um pulo, saltar de repente, partir, tomar a iniciativa, iniciar, começar, princípio
starter = arranque, partida
start off = pôr-se em marcha
start out = pôr-se a caminho, pôr-se em marcha
start running = arrancar, partir
state = afiançar, assegurar, asseverar, certificar, garantir, sustenar, declarar, declinar, depor, nação, reino, país, situação, estado
statement = declaracão, depoimento
statement of policy = programa
station = estação, paragem
stationer's shop = papelaria
station-master = chefe da estação
statistics = estatística
statue = estátua
stature = altura
statute = estatuo, regimento, regulamento
stay = ficar, permanecer, restar
stay over = ficar, permanecer, restar
stay with = hospedar-se
steak = bifsteque
steal = furtar, roubar
stealthily = pelo roubo
steam = fumo, vapor
steam-boiler = caldeira
steamship = navio a vapor
steel = barbatana, aço
steep = escarpado, íngreme
steer = encaminhar, gerir, governar, conduzir, dirigir, guiar
steering = direcção, directriz, gerência, gestão, governo
steering-wheel = guidão, volante
stem = haste, talo, tronco, caule
stencil = chapa, clichê, molde, padrão
stenography = estenografia
stenotypist = dactilógrafa, datilógrafa
step = andar, caminhar, dar um passo, passo, escalão, degrau
step-father = padastro
step on = calcar os pés
steppe = estepe, páramo
sterile = estéril, improdutivo
sterilize = esterilizar
stern = popa
stevedore = estivador
stew = goulache, guisado, ragu
steward = intendente, aeromoço, tafeiro
stewardess = aeromoça
stichwort = alsina
stick = bastonete, bastão, bengala, bordão, cacete, pau, colar, grudar, solvar
sticky = pegajoso
stiff = ceremonioso, pomposo, solene, hirto, rígido, teso
still = ainda, até agora, mais, também, tranqüilizar, acalmar, sossegar
stimulate = concitar, provocar, impelir, incitar, instigar, <dar mais animação a alguém>, esporar, esporear, aguaçar, encorajar, estimular, reavivar, despertar, animar
sting = aferroar, picar, espadas
stingray = raia, arraia
stingy = avarento, avaro
stipulate = convencionar, estipular
stipulation = cláusula, condição
stir = abalar, comover, emocionar, sensibilizar, bater, fazer molinete, mexer, vivacidade, animação
stir up = agitar, amotinar, sacolejar, sacudir, acirrar, aguçar, atiçar, excitar, inflamar, concitar, incitar, provocar, <dar mais animação a alguém>, esporar, esporear, aguaçar, encorajar, estimular, reavivar
stitch = ponto, pespontar
stock = estocar, formar estoque, estoque, provisão, sortimento
stocked = em estoque
stock exchange = bolsa, bolsa de valores, praça
stocking = meia
stodgy = aborrecedor, aborrecido, enfadonho, fastidioso
stoic = estóico, homem estóico
stoical = estóico
stoke = aquecer
stomach = estômago
stomach ache = dor de barriga
stone = argiloso, pedra
stool = banqueta, banquinho, tamborete, mocho
stop = demorar-se, deter-se, parar, fazer parar, reprimir, estação, paragem, cessar, parar de, fazer cessar, interromper
stopper = bucha, rolha, tampa
stop up = arrolhar, tampar, tapar
storage battery = acumulador
store = armazém, loja, venda
store-cupboard = aparador
storey = andar, pavimento
stork = cegonha
stork's-bill = eródio
storm = <correr no alcance de alguém para atacar>, temporal, furação, tufão, tempestade, tormenta
story = andar, pavimento, crônica, história, conto, narrativa
stove = fogão, forno
stow = estivar
straight = direito, direto, reto
straightedge = régua
straightforward = simples, singelo
straight past = além, ao lado de, por diante de
strait = estreito
straitened = embaraçoso, estorvador
strange = alienígena, estrangeiro, estranho, esquisito, excêntrico
stranger = estrangeiro
strangle = estrangular
strap = correia, tira de couro
Strasbourg = Estrasburgo
stratagem = astúcia
strategic = estratégico
strategy = estratégia
straw = colmo, palha
strawberry = morango
strawberry tree = medronheiro
stray off = ir à garra, perder o rumo
streak = risca, risco, traço
stream = corrente, fluxo, riacho, ribeiro
streamlined = aerodinâmica
strech = armar, dar corda, esticar, retesar
strech out = desdobrar, estender, espraiar, estirar
street = rua
streetcar = bonde, carro eléctrico, trilho cavado
street-corner = esquina
strength = força, intensidade, vigor
stress = acentuar, acento
stretcher = maca, padiola
strict = austero, rígido, rigoroso, severo
stride = andar, caminhar, dar um passo, passo
strike = dar pancada, maçar, malhar, começar a queimar, bater, golpear, percutir, impor, fazer greve, greve, acertar, atingir, dar no alvo
strike a balance = saldar
strike off = debater, discutir
strike out = anular
striking = acertado, decisivo, justo, categórico
string = tendão, corda
stringent = exato, pesado, rigoroso
strip = coirela, fita, listrão, despir-se, barra, estria, faixa, tira
stripe = galão, barra, estria, faixa, tira
strive for = buscar, empenhar-se, esforçar-se
stroke = apoplexia, acariciar, afagar, mimosear, risca, risco, traço
stroke of apoplexy = apoplexia
stroll = passeio, passear
stroller = passeador
strong = forte
strong-box = cofre
strong drink = bebida alcoólica
structure = contextura, estrutura, teia
struggle = debater-se, espernear, estrebuchar, batalhar, brigar, combater, guerrear, lidar, pelejar, batalha, combate, luta, peleja, pugna, lutar, pugnar
strut around = empavonar-se, pavonear-se
stubborn = birrento, obstinado, teimoso
student = acadêmico, estudante
studio = atelier, estúdio
study = estudar, preparar, estudo
stuff = rechear, estofar, substância
stuffing = recheio
stumble = tropeçar, tropicar
stupid = estúpido, imbecil, tolo
sturdy = forte, rijo, sólido
stutter = balbuciar, gaguejar, tartamudear
sty = aprisco, chiqueiro, curral, estábulo, estrebaria, redil
style = estilo
subject = sujeito, assunto, motivo, tema, matéria
subjective = subjetivo
subject to tax = tributável
subjunctive = subjuntivo, volitivo
subjunctive mood = volitivo
submit = submeter-se
subordinate = inferior, subalterno, súdito
subscribe = tomar uma assinatura, contribuir, cotizar-se, pagar a sua cota
subscriber = assinante
subscribe to = tomar uma assinatura
subscription = assinatura, cota
subsequently = depois, atrás, em seguida, logo, por conseguinte, sendo assim
subsidize = subvencionar
subsidy = subsídio, subvenção
substance = substância
substantive = nome, substantivo
substitute = fazer substituir, pôr no lugar de, substituir
substitution = substituição
subterfuge = artifício, artimanha, estratagema, subterfúgio, tramóia
subtle = arguto, fino, quase impalpável, sutil, tênue
subtract = subtrair
subtraction = subtração
suburb = arrabalde, subúrbio
subvert = minar
subway = metrô
succeed = conseguir, lograr, ser bem sucedido, ter bom êxito
success = prosperidade, bom êxito, sucesso
successor = descendente, sucessor
succumb = curvar-se ao peso de
such = tal, de tal espécie, de tal qualidade, assim, daquela maneira, desta maneira, deste modo
such a = como, na qualidade de, tal, de tal espécie, de tal qualidade
such as = como, de que modo, qual, na qualidade de, quanto
suck = chupar, mamar, sugar
suckle = amamentar
sudden = brusco, repentino, súbito
suddenly = de repente, subitamente
sue = acionar, processar
suet = sebo
suffer = aguentar, agüentar, tolerar, padecer, sofrer, suportar
suffice = bastar, satisfazer, ser suficiente
sufficient = bastante, suficiente
sufficiently = assaz, bastante, em quantidade suficiente
suffix = sufixo
suffocate = abafar, estrangular, sufocar
sugar = açúcar
sugarbowl = açucareiro
sugar-bowl = açucareiro
suggest = indicar, oferecer, propor, incutir, lembrar, sugerir, sugestionar
suggestion = sugestão
suit = fato, jogo, terno, ser apropriado, ser conveniente, costume, traje, veste, convir, prestar-se, servir, valer
suitability = aptidão, conveniência, capacidade
suitable = decoroso, próprio, adequado, apropriado, apto, capaz, conveniente, usável, praticável
suitcase = mala de mão, maleta, valisa
suite = comitiva, cortejo, séquito
sulfuric = sulfuroso
sulphur = enxôfre
sulphureous = sulfuroso
sulphuric = sulfuroso
sultan = sultão
sum = importância, quantia, soma
summarize = resumir, tornar a somar
summer = verão
summer-house = casa de campo
summery = resumo, sumário
summit = ápice, extremidade, pico, ponta, superfície, cimo, cume, vértice
summon = chamar
summons = intimação
sum up = adicionar, somar, totalizar
sun = sol, expor ao sol
sunbeam = raio de sol
Sunday = Domingo
sundew = drósera
sunflower = girassol
sun oneself = expor ao sol
sunrise = nascer do sol
sunset = pôr do sol
superficial = baixo
superfluous = supérfluo
superintendant = intendente
superior = superior
superman = super-homem
supersign = acento
superstition = crendice, superstição
superstitious = supersticioso
supervise = conferir, fiscalizar, inspecionar, supervisionar
supper = ceia
supply = dar, entregar, fornecer, ministrar, abastecer, prover, suprir, abastecimento, provisão
support = apoiar, arrimar, encostar, reclinar, apoio, auspício, bom augúrio, amparar, sustenar, suportar, escorar, subsistir
supporter = cidadão, membro, sócio
supporters = <grupo não organizado>
supporting actor = comparsa, figurante
supporting base = peanha, soco
supporting wall = pegão
suppose = conjeturar, fazer de conta, supor
supposition = hipótese, suposição
suppress = abafar, estrangular, sufocar
sure = certo, indubitável, seguro
surely = com efeito, de facto, de fato, na verdade, sem dúvida
surface = cimo, cume, vértice, superfície
surgeon = cirurgião
surgery = cirurgia
surgical = cirúrgico
surgical operation = operação
surly = arisco, brusco, rabugento
surmise = conjeturar, fazer de conta, supor
surpass = exceder, ser superior, superar, suplantar
surplus = excedente
surprise = sobressaltar, surpreender, sobressalto, surpresa
surrender = capitulação, rendição
surround = cercar, circundar, rodear
surroundings = ambiente, arrabalde, arredores, cercanias
survive = atravessar, viver
suspect = andar desconfiado, suspeitar
suspenders = alças, suspensórios
suspicion = suspeita
suspicious = desconfiado, suspeito
sustain = apoiar, arrimar, encostar, reclinar, amparar, sustenar, suportar, escorar
sustained = permanente, contínuo, constante, ininterrupto
suture = suturar, suturação
swaddling cloth = cueiro
swallow = engolir, tragar, andorinha
swallow up = sorver
swamp = brejo, lodaçal, pântano
swan = cisne
swap = permutar, trocar
swarm = enxamear, formigar, pulular, enxame, formigueiro
swarm of bees = abelheira
swathe = atadura, bandagem
swear = blasfemar, maldizer, desbocar-se, praguejar, xingar, jurar, prestar juramento
sweat = suar, transpirar, suor, transpiração
Swede = sueco
Sweden = Suécia
Swedish = sueco
sweep = varrer, vasculhar, vassourar
sweet = ameno, doce, meigo, suave, acepipe, guloseima
sweetheart = amada, namorada, amado, meiga
sweet potato = batata doce
swell = engrossar, inchar
swelling = fofo
swift = gaivão, guincho, rápido, veloz
swiftly = depressa
swim = boiar, flutuar, nadar
swimming-bath = piscina
swimming-pool = piscina
swimming trunks = calção de banho
swindle = defraudar, logro, ludíbrio, fraude, engano
swine = porco
swing = balançar, menear, sacudir, agitar, bater, mexer, vibrar
swirl = redemoinhar
swish = farfalhar, sussurrar, cicio, sussurro
Swiss = suíço
switch = vara, verga, vergasta, ligar, interruptor
Switzerland = Suíça
swoon = desfalecer, desmaiar, esvanecer, chilique, desfalecimento, desmaio
sword = espada, gládio
swotch on = activar
sycamore = ácer, bordo, roble
syllable = sílaba
symbol = símbolo
symbolize = simbolizar
symmetric = simétrico
symmetry = simetria
sympathetic = simpático
sympathy = simpatia
symphonic = sinfônico
symphony = sinfonia
symptom = sintoma
synagogue = sinagoga
syndicate = sindicato
syringe = injetor, seringa
syrup = calda, xarope
system = sistema
systematic = sistemático