#setName = words_en_pt_ii
#sideOneTitle = ENG
#sideTwoTitle = POR
ice = sorvete, gelo
iceberg = iceberg
icecream = sorvete
Iceland = Islândia
Icelandic = islândes
icy = gelado, glacial
ID = carteira de identidade
I.D. = carteira de identidade
idea = conceito, idéia
ideal = ideal
idealist = idealista
identical = idêntico
identify = identificar
ideology = ideologia
idiocy = idiotia
idiom = idioma, língua, idiotismo
idiot = imbecil, parvo
idiotic = idiota
idol = ídolo
idolator = idólatra
if = ão de, na suposição de, no caso de, se
ignition = ignição
ignore = fingir ignorar, não tomar conhecimento
il- = in-
ill = doente, enfermo
ill fate = fatalidade
ill-fated = fatal
ill humor = baço
ill humour = baço
illiterate = analfabeto
illness = doença
illuminate = iluminar
illusion = ilusão
illustrate = ilustrar
illustration = ilustração
im- = in-
image = estampa, gravura, quadro, vista, figura, imagem, vulto configuração
imagination = imaginação
imagine = imaginar
imitate = copiar, imitar
imitation = imitação
immaterial = indiferente
immediate = imediato
immediately = sem delonga, diretamente, directamente, imediatamente, sem demora, logo, depressa
immense = enorme, imenso
immerse = imergir
immigrate = imigrar
immune = imune
impale = empalar
impartial = neutro, imparcial
impel = impulsionar, impelir, incitar, instigar, tanger, tocar
impenetrable = impermeável
imperialism = imperialismo
imperialist = imperialista
impertinence = impertinência
impertinent = atrevido, impertinente, insolente
impetus = arrancada, ímpeto, arranco, impulso
implicate = enredar, envolver, implicar
imply = abranger, compreender, implicar, denotar, querer dizer, significar
important = categorizado, grave, importante, sério
impose = ditar, impor, obrigar, forçar
imposing = imponente
impossible = impossível
imposter = enganador, capadócio, charlatão, curandeiro, impostor
impress = impor, causar impressão, impressionar
impressible = impressionável, sensível
impression = efeito, impressão, sensação
improve = melhorar
impulse = arranco, impulso
impulsive = frívolo, leviano
in = dentro de, em
in- = in-
in action = activo, agencioso, diligente
in addition = além disso, demais, em continuação, mais, mais adiante
in a hurry = precipitadamente
in Arabic = em árabe
inaugural = inaugural
inaugurate = inaugurar
inauguration = inauguração
in a way = como que, como se
incandescent = incandescente
in cash = dinheiro
incendiary = incendiário
incendiary bomb = bomba incendiária
incense = incenso
incest = incesto
inch = polegada
incidental = acessório, apenso, lateral
incinerate = calcinar, reduzir a cinzas
incite = agitar, amotinar, sacolejar, sacudir, concitar, incitar, desafiar, provocar, reptar, esporar, esporear
inclination = afeição, inclinação
incline = estar inclinado a
inclined to travel = <que tem gosto por viagens>
include = conter, abarcar, abranger, incluir
including = inclusivamente, inclusive
inclusive = inclusivo
inclusively = inclusivamente, inclusive
income = receito, juro, provento, renda
inconsistent = inconsequente, inconseqüente
inconvenient = afanoso, difícil, dificultoso
incorrect = impreciso, incorrecto, incorreto, inexacto, inexato
increase = elevar, altear, elevar-se, subir, aumentar
increasingly = mais e mais
incredible = incrível
incubate = chocar, incubar
incubus = íncubo, pesadelo
incus = bigorna
indeed = efectivamente, com efeito, de facto, de fato, sem dúvida, deveras, na realidade, na verdade, verdadeiramente
indent = começar nova linha com alínea
independant = autônomo, independente
index = munir de índice, índex, lista, tabela, tábua, tabuada, quadro
India = Índia
Indian = da Índia, hindu, indiano, índio, pelevermelha
Indian corn = milho
Indian ink = tinta da China, tinta nanquim
indicate = indicar, apontar, assinalar, mostrar
indication = adivinhação, agouro, augúrio, presságio, profecia, indicação
indictment = acusação
indifference = calma, fleuma, impassibilidade
indifferent = indiferente
indigestion = dispepsia, indigestão
individual = individual, indivíduo, pessoa, sujeito
Indo-China = Indochina
Indonesia = Indonésia
induce = concluir, depreender, tirar conclusão de
indulge = poupar, ser indulgente para
industrial = industrial
industrialist = industrial
industrious = aplicado, assíduo, diligente, esforçado
industry = aplicação, assiduidade, diligência, indústria
inebriety = bebedeira, ebriedade, embriaguez
in English = em inglês
inert = inerte
in every way = de todo o modo, de qualquer maneira, por todas as formas
in exchange for = contra, defronte de, em frente de, em troca de
inexpensive = barato
in fact = com efeito, de facto, efectivamente
infant = criança
infantry = infantaria
infect = infectar
infected = séptico
infection = infecção
infer = concluir, depreender, tirar conclusão de
inference = conclusão
inferior = inferior
infernal = infernal
infest = infestar
infirm = aleijado, estropiado
inflate = tornar inchado
inflation = inflação
influence = influenciar, influência
influenza = gripe
inform = participar, informar, noticiar, notificar
information = informação
in front of = antes de, diante de, em frente de, em presença de, perante
ingenious = genial
in good condition = abastado, próspero
inhabitant = habitante, morador
inhale = aspirar, inalar
inherit = herdar
inheritance = herança
inhibit = atrapalhar, prejudicar
initiate = iniciar, tomar a iniciativa
inject = injectar, injetar
injure = arruinar, avariar, danificar, deteriorar, estragar
injury = ferida, ferimento, lesão, chaga
ink = tinta
inkpot = tinteiro
ink-well = tinteiro
inlet = fiorde
inn = hospedaria, taberna
inner = interior, interno
inner tube = câmara de ar
in no way = de forma nenhuma, de modo nenhum, de nenhuma maneira
inordinate = demasiado, excessivo
in principle = em princípio
in question = concernente, respectivo
inquiry = inquérito, investigação, sindicância
inquiry-office = escritório de informações
inquisitive = curioso
in rows = em fila
insane = insano, louco
insane asylum = hospital psiquiátrico
insect = insecto
insert = inserir, introduzir
in short supply = escasso, insuficiente, raro
inside = dentro de, em, interno, interior
insidious = insidioso
insignia = insígnia
insignificant = insignificante
insist = insistir, instar
inspect = fiscalizar, inspecionar, vistoriar
inspection = inspeção
inspector = inspector, inspetor
inspiration = inspiração
inspire = incutir, infundir, inspirar, <dar mais animação a alguém>
inspiring = sugestivo
in spite of = a despeito de, apesar de, não obstante, por acinte, por desafio
instalment = anuidade
instant = instante, momento
instantly = directamente, imediatamente, sem delonga, diretamente
instead = ao invés de
instead of = em lugar de, em vez de, por
instigate = impelir, incitar, instigar
instinct = instinto
institute = instituto
institution = instituição
instruction = instrução
instructor = mestre, professor
instrument = instrumento
insubordinate = rebelde
insulate = ilhar, insular, isolar
insulator = isolador
insult = insultar, injúria, insulto, injuriar, ofender, ultrajar
insurance = seguro, contrato de seguro
insurance policy = apólice
insure = garantir, segurar, assegurar
insurer = segurador
integral = integral
intellect = intelecto, inteligência
intellectual = inteligente, intelectual
intelligence = inteligência
intelligent = inteligente
intend = apontar, mirar, tender, ter em vista, ter por fim, visar a, intentar, pretender, tencionar
intense = forte, intensivo, intenso
intensive = forte, intensivo, intenso
intention = intenção
intentional = intencional
inter = enterrar, sepultar
intercede = interceder
intercessor = advogado
interchange = permutar, trocar
interest = interessar, interesse, juros, renda, renda de capital
interesting = interessante, curisoso, notável, singular
interference = perturbação
interfere with = causar perturbação, perturbar
interior = interior
interment = enterramento, funeral, sepultamento, enterro
intermission = pausa, suspensão
intermittent = intermitente
internal = interior, interno
internal combustion engine = motor de explosão
international = internacional
interpret = entender, interpretar, traduzir
interpretation = interpretação
interpreter = intéprete
interpunction = pontuação
interrogate = interrogar
interrupt = interromper
interval = intervalo
intervene = intervir
interview = entrevistar, entrevista
intestine = intestino
in that way = de tal modo
in the abstract = teoricamente
in the daytime = de dia, durante o dia
in the evening = à tarde, de tarde
in the morning = de manhã, pela manhã
intimate = familiar, íntimo, particular, privado
in time = a propósito, a tempo, oportunamente
into = dentro de, em
intolerant = intolerante
intoxicated = bêbado, embriagado, ébrio
intrepid = audaz, arriscado, ousado
intrigue = enredar, intrigar
introduce = apresentar, oferecer
intrude = <meter o nariz em assunto alheio>
in turn = segundo a fila, um após outro
invade = invadir
in vain = debalde, em vão, inutilmente
invasion = invasão
invent = descobrir, atinar, achar, inventar
invention = desboberta, achado, invento, invenção
inventor = inventor
inventory = arrolamente, inventário
inverted comma = aspas
investigate = buscar, escavar, explorar, investigar, pesquisar
investigation = exame, prova, teste, inquérito, sindicância, exploração, investigação, pesquisa
invincible = invencível
invitation = convite
invite = convidar, invitar
invite tenders for = adjudicar
invoice = facturar, factura, nota
invoke = apelar, chamar, invocar
in what way = como, de que modo, qual, na qualidade de, quanto
iodine = iodo
Iran = Irã
Iranian = iraniano
Ireland = Irlanda
Irish = irlandês
Irishman = irlandês
iron = férreo, ferro, engomar, passar a ferro, ferro de engomar, ferro de passar roupa
iron clothes = engomar, passar a ferro
ironic = irônico
ironing board = tábua de passar roupa
irony = ironia
irresistible = irresistível
irrigate = irrigar, molhar
Islam = islã, islamismo, maometismo
Islamic = islâmico
island = ilha
ism = -ismo
isolate = ilhar, insular, isolar
isolated = isolado
Israel = Israel
Israelite = israelita
issue = editar, emitir, proferir, publicar, proclamar
ist = -ista
it = ela, ele
Italian = italiano
Italy = Itália
itch = dar coceira, formigar, prurir, coceira, comichão
it doesn't matter = não importa, pouco importa
item = elemento, partícula
its = seu, sua
itself = mesmo, próprio
ity = -dade
ivory = ebúrneo, marfim
Ivory Coast = Costa do Marfim
ivy = hera, trepadeira