#setName = words_en_pt_mm
#sideOneTitle = ENG
#sideTwoTitle = POR
macaw = arara
mach = Mach
machine = máquina
machinery = maquinaria
mackerel = cavala
mad = insano, louco, hidrofóbico, raivoso
madam = dama, senhora
maestro = mestre
magazine = gazeta, folha, revista
magic = mágica
magical = <que tem efeito extraordinário>
magician = ilusionista, mágico
magnanimous = brioso, magnânimo
magnet = ímã, magnete
magnetic = magnético
magnetism = magnetismo
magnifying glass = lupa
maid = criada, arrumadeira, camareira, criada de quarto
maidenhair = avenca
mail = correio
mailbox = caixa de correiro, caixa postal
mailman = carteiro
main = básico, capital, principal
mainland = continente
mainly = em especial, principalmente, sobretudo
maintain = argumentar, conservar, guardar
maize = milho
majestic = majestoso, soberbo
majesty = majestade, <título geral de cortesia>
major = major, básico, capital, principal
majority = maioridade, maioria
major road = via principal
make = fazer, formar, executar, cometer, confeccionar
make a contract = ajustar, fretar, contratar
make a draft = sacar
make a mistake = cair em erro, enganar-se, equivocar-se, errar
make an offer of = oferecer
make a noise = farfalhar, fazer barulho
make a note = escrever nota sobre, tomar nota de
make a project of = planejar, projectar, projetar
make a stroke = riscar, traçar
make available = disponibilizar
make a will = testar
make clean = assear, limpar, purificar
make fast = aprazar, cravar, determinar, fixar
make for = dirigir-se a, encaminhar-se para
make fun of = caçoar, escarnecer, zombar
make glad = alegrar, contentar, dar prazer
make love = amar sexualmente
make music = musicar
make smooth = alisar, polir
make-up = maquilagem
make up = compor, constituir, estabelecer, maquilar, maquilagem
make up one's mind = decidir-se, tomar uma resolução
make use of = utilizar, empregar, servir-se de, usar, despender
make war = combatar, fazer campanha, guerrear
making = fabricação, fabrico, farádio, feitura, confeccão, execução
malaria = malária
Malaysia = Malásia
male = viril, varonil, masculino, viril, macho
male cat = gato macho
malfunction = enguiçar
malicious = malicioso, malvado, perverso
mam = mamãe, mãezinha
mammal = mamífero
mammy = mamãe, mãezinha
man = homem, varão, macho
manage = administrar, reger, dirigir, encaminhar, gerir, governar, guiar, administrar casa
management = administração, administração
manager = administrador, gerente, gerente, director, regente
mandate = mandato
maneuver = manobra
manger = cocho, gamela, tina
mangosteen = mangostão
manifacture = fabricação, fabrico, feitura, confeccão, execução
manifest = declarar, manifestar, manifesto
manipulate = manejar, manipular
mankind = humanidade
manner = forma, maneira, modo
manoeuvre = manobra
man of genius = gênio
mansion = mansão
mantle = capa
manufacture = fabricar, feitura, confeccão, execução, farádio
manure = esterco, estrume
manuscript = manuscrito
many = muitos
map = cartão, mapa
maple = ácer, bordo, roble
marble = glóbulo, marmóreo, mármore
march = andar, caminhar, marchar
march off = andar, decorrer, passar-se
Marcus = Marco
margin = margem
marguerite = margarida
marionette = fantoche, marionete
mark = assinalar, marcar, marco, aceno, signo, marca, ponto, sinal, estampar
market = bazar, feira, mercado, mercado
marketplace = mercado
marmelade = compota
marriage = casamento, matrimónio, matrimônio
married = casada, casado
married people = esposo e esposa
marry = casar, casar-se, casarem-se
Mars = Marte
marsh = brejo, lodaçal, pântano
martial = belicoso
martyr = mártir
marvel = admirar-se, estranhar
marvel at = admirar-se, estranhar
masculine = masculino, varonil, viril, macho
mask = mascarar, máscara
masonic = maçônico
mass = acervo, acúmulo, chusma, cúmulo, montão, pilha, ruma, multidão, conjunto, massa, missa
massacre = massacrar, carnificina, massacre
Massacre of Saint Bartholomew = Noite de São Bartolomeu
massage = massagear, fricção, massagem
massive = compacto, maciço
mass produce = produzir em grande quantidade
mast = mastro, pau
master = aprender a fundo, licenciado, magíster, mestre, amo, dono, patrão, senhor
match = fósforo, palito de fósforo, <encontro esportivo de dois atletas ou times>, pedir em casamento
match-make = pedir em casamento
material = material, estofo, fazenda, pano, tecido
mathematical = matemático
mathematician = matemático
mathematics = matemática
matrimony = casamento, matrimônio
matter = assunto, causa, coisa, negócio, questão, caso, matéria, substância
mattress = colchão
mature = maduro, sazonado
matzo = hóstia, pão ázimo
maw = abertura, boca, goela
maxim = adágio, conceito, sentença
maximum = máximo
may = ter o direito de
maybe = acaso, por ventura, possivelmente, talvez
mayhap = acaso, por ventura, possivelmente, talvez
mayor = prefeito, administrador de aldeia
mead = hidromel
meadow = prado
meager = magro, miserável
meal = farinha, comida, refeição
mealies = milho
mean = intentar, pretender, tencionar, central, mediano, médio, centro, meio, metade, denotar, querer dizer, significar
meaning = intenção, sentido, significado
means = ferramenta, instrumento, expediente, meio, recurso
measles = sarampo
measurable = previsível
measure = balizar, medir, medição, medida
measured = ceremonioso, pomposo, solene
measurement = dimensão, medição, medida
measure out = dosar
meat = carne, vianda
mechanic = mecânico
mechanics = mecânica
medal = medalha
medicine = remédio, medicina
meditate = pensar maduramente, refletir muito
Mediterranean = Mediterrâneo
meercat = cercopiteco
meet = reunir-se, achar, encontrar
meeting = sessão, assembléia, reunião, <grande reunião popular>
meet with = satisfazer
melancholy = melancólico, melancolia
melodrama = melodrama
melodramatic = melodramático
melody = melodia, toada
melon = melão, meloeiro
melt = degelar, derreter, fundir, fundir-se, derreter-se
melting = degelo
member = cidadão, sócio, membro
member of parliament = parlamentar
memorable = digna de recordação, memorável
memorize = memorizar
memory = memória
menace = ameaçar, intimidar, ameaça
mend = consertar, remendar
mental = mental
mention = citar, mencionar, relatar, referência, relato, menção
menu = cartão, cardápio, lista, menu
merchandise = fazenda, mercadoria
merchant = comerciante, negociante
mere = mero, simples, só
merit = merecer, valer, merecimento, mérito
merry = alegre, festivo, jovial
merry-go-round = carrossel
mesh = laçada, laço, malha
mess = mingau, papas, purê
message = comunicação, mensagem
metal = metal
metaphor = metáfora
meteoric stone = aerólito
meteorite = aerólito
method = método
methodical = metódico
Methodist = metodista
methylated spirit = álcool desnaturado
metre = metro
metric = métrico
metropolis = metrópole, capital
Meuse = Mosa
microbe = micróbio
microphone = microfone
microscope = microscópio
midday = meio-dia
midday meal = jantar, almoço
middle = central, mediano, médio, centro, meio, metade
Middle Ages = Idade-Média
middleclass = burguês
middleclass citizen = burguês
Middle East = Médio-Oriente
midget = nanico, anão
midnight = meia-noite
midwife = obstetriz, parteira
migrant = nômade
migrate = correr terras, transmigrar
mild = ameno, brando, doce, suave
mile = milha
military = bélico, militar
military division = divisão
milk = leite, ordenhar
mill = moenda, moinho, casa de moinho, usina
millenium = milénio, milênio
millennium = milénio, milênio
miller = moedor
millimetre = milímetro
milliner = modista
million = milhão
mince = cortar em pedaços pequenos
mind = intelecto, inteligência, mente, observar
mine = mina, mina
miner = mineiro
mineral = mineral
mingle = baralhar, mesclar, mexer, misturar
minister = ministro
ministry = ministério
minority = menoridade
mint = hortelã, menta
minute = minuto
minutes = acto, protocolo
miracle = milagre, prodígio
miraculous = miraculoso
mirage = miragem
mirror = espelho
miscarriage = abortamento
miscarry = abortar, malograr-se, ter mau êxito
mischievous = malicioso, malvado, perverso, arteiro, brincalhão, travesso
miser = avarento
miserable = catastrófico, coitado, lastimável, mau, ruim, sombrio, pobre, triste, macambúzio, miserável
miserly = avarento, avaro
misery = miséria
misleading = enganoso, ilusório
miss = errar o golpe, falhar
mission = missão
missionary = missionário
mist = bruma, neblina, névoa
mistake = defeito, erro
mistaken = errôneo
Mister = amo, patrão, senhor
mistletoe = visco
mistress = chefa, directoria
misunderstand = compreender mal
mite = ácaro
miter = mitra
mitre = mitra
mitten = luva
mix = baralhar, mesclar, mexer, misturar
mixture = mistura
moan = carpir, gemir
mobile = móbil, móvel
mobilize = mobilizar, preparar
mock = caçoar, escarnecer, zombar
mode = forma, maneira, modo, costume, moda, mode
model = tirar molde de, modelo, modelar, moldar, plasmar, esquema
moderate = brando, comedido, moderado, abrandar, moderar, temperar
moderation = moderação, temperança
modern = hodierno, moderno
modernize = modernizar
modest = modesto, módico, recatado
modesty = modéstia, simplicidade, pudor
modify = alterar, modificar
moist = úmido, húmido
mold = modelar, plasmar, moldar, forma, molde, mofo
mole = toupeira
mom = mamãe, mãezinha
moment = instante, momento
momentary = efêmero, momentâneo
mommy = mamãe, mãezinha
monastery = convento, mosteiro
Monday = segunda-feira
monetary unit = unidade monetária, moeda
money = dinheiro
money-box = caixa, cofre
money box = caixa, cofre
money order = ordem de pagamento
monk = frei, monge
monkey = macaco, símio
monkey puzzle = araucária, pinheiro brasileiro
monkshood = acônito
monocle = monóculo
monopolize = abarcar, açambarcar, fazer truste
monopoly = monopólio
monotonous = monótono
monster = monstro
monstrous = monstruoso
month = mês
monthly = mensal, mensalmente
monument = monumento
monumental = monumental
mood = ambiência, humor
moon = lua
moor = estepe, páramo
moorage = ancoradouro
mooring = ancoradouro
moose = alce, grã-besta
moped = motocicleta
moral = moral
morality = moralidade, virtude
morals = moral
more = mais
more and more = mais e mais
moreover = aliás, além disso, demais, em continuação, mais, mais adiante
mores = costume, uso
Mormon = mórmon
morning = manhã
Morocco = Marrocos
morsel = bocado
mortal = mortal
morter = argamassa
Moscow = Moscou, Moscovo
Moses = Moisés
mosque = mesquita
mosquito = mosquito
mosquito net = mosquiteiro
moss = musgo
most = mais
mostly = em maior número das ocasiões
motel = motel
moth = traça
mother = mãe
motion = resolução
motion picture = filme, película
motive = causa, motivo, razão
motor = motor
motor-boat = barco de motor
motor car = auto, automóvel, carro
motorcycle = motocicleta
motoring = automobilismo
motorist = chofer, motorista, automobilista
motor-launch = barco de motor
motor road = auto-estrada
motorway = auto-estrada
motto = cambial, divisa, lema, mote
mould = modelar, plasmar, moldar, forma, molde, mofo
mouldy = bolorento
mount = acomodar, adaptar, ajeitar, ajustar, montar
mountain = montanha, monte
mountain chain = cadeia de montanhasl, serra
mountain climber = alpinista
mountaineer = alpinista
mountaineering = alpinismo
mountain pasture = alpe
mountain ridge = aresta
Mount Elbrus = Elbrus
mourn = estar de luto
mournful = fúnebre, lutuoso, entristecedor, melancólico, nebuloso
mourning = luto, nojo
mouse = camundongo, rato
moustache = bigodes
mouth = fauce, goela, boca, boca, foz
mouthful = bocado
move = emocionar, sensibilizar, comover, abalar, tocar, mexer, mover, mexer-se, mover-se, mudar-se, transferir-se
movement = movimento
movie = filme, película
movie theatre = cinema
moving = comovente, enternecedor, tocante
mow = ceifar, foiçar, roçar, segar
Mozambique = Moçambique
Mr. = amo, patrão, senhor
Mrs. = dama, senhora
much = muito, um grande número de
mucous = mucoso
mucus = muco
mud = lama, limo, lodo
mug = cara ridícula
mulberry-tree = amoreira
mule = babucha, pantufo, mula
mullein = verbasco
multicoloured = multicolor, multicor
multiple = múltiplo
multiply = multiplicar
multitude = acervo, acúmulo, chusma, cúmulo, montão, pilha, ruma, multidão
munition = munição, munição de guerra
murder = assassinar, assassínio
murmur = murmurar, resmungar, murmúrio
muscle = músculo
muscular = muscular
museum = museu
mush = mingau, papas, purê
mushroom = agárico, cogumelo, fungo, champinhom
music = música
musical = musical
musical time = andamento, compasso, tacto, tino
musician = músico
musket = mosquete
musk-ox = búfalo
mussel = mexilhão
must = dever, ter a obrigação, ter de, ter que
mustard = mostarda
musty = bolorento
mute = calado, mudo
mutiny = rebelião, revolta
mutter = murmurar, resmungar
mutton = carne de carneiro
mutual = mútuo, recíproco
mutual understanding = entendimento mútuo
muzzle = fauce, goela, açaimo, açamo, mordaça
my = meu, minha
myriad = miríade
mystery = mistério
mystic = místico
mystical = místico
mystify = burlar, ludibriar, mistificar
myth = myto
mythical = mítico