#setName = words_en_pt_gh.txt
#sideOneTitle = ENG
#sideTwoTitle = POR
gaberdine = gabardina
gadfly = mutuca, tavão
gag = brincadeira, caçoada, chiste, piada, gracejo
gain = aquisição, presa, auferir, ganhar, lucrar, lucro, proveito, vantagem
Galicia = Galiza
gall = bile, bílis
gallant = animoso, bravo, corajoso, honesto, leal, valente, valoroso
gallery = galeria
galloon = galão
gallop = andar a galope, galopar, galope
galosh = galocha
game = jogo, <encontro esportivo de dois atletas ou times>
gamut = gama, escala
gang = cáfila, facção, malta, quadrilha, súcia, bando, companhia, turma
gangster = bandido, gângster
gangway = passagem, viela
gaol = prisão, cadeia, prisão
gap = brecha, fenda
gape = escancarar-se, embasbacar-se, ficar boquiaberto
garage = garagem
garbage can = ferro-velho
garbage dump = monturo
garden = horto, jardim
gardener = jardineiro
gargle = bochechar, enxaguar, gargarejar
garland = coroa de flores, grinalda
garlic = alho
garlic bulb = dente de alho
garment = veste, vestido, vestimenta, roupa, roupagem, traje, fato
garnish = guarnecer, rechear, revestir
garret = mansarda, trapeira
garrison = guarnição
gasolene = benzina, gasolina
gasoline = benzina, gasolina
gas tank = tanque de gasolina
gate = passagem, viela, portão
gateway = portão
gather = deduzir, inferir, colher, concluir, depreender, tirar conclusão de, reunir-se
gathering = assembléia, reunião
gaunt = angular, deserto, ermo, delgado, fino, delicado, sombrio, magro, triste, macambúzio, entristecedor, melancólico, nebuloso
gawk = embasbacar-se, ficar boquiaberto
gay = alegre, festivo, jovial
gazette = gazeta, folha
gem = jóia
gendarme = gendarme
general = general, mundial, ecumênico, genérico, geral, universal
generality = universalidade
generally = geralmente
generate = gerar, procriar
generation = geração
generous = obsequiador, desapegado, generoso, liberal
Geneva = Genebra
genital = genital
genius = gênio
genre = gênero
gentian = genciana
gentle = meigo, ameno, brando, doce, suave
gentleman = amo, patrão, senhor
genuine = autêntico
genuinly = deveras, na realidade, na verdade, verdadeiramente
geographer = geógrafo
geography = geografia
geologist = geólogo
geology = geologia
Georgia = Geórgia
germ = micróbio, broto, germe, grelo
German = alemão, teutão
Germany = Alemanha
germinate = brotar, germinar
gesture = fazer um aceno, fazer um gesto, aceno, gesto
get = adquirir, aportar, chegar, abranger, alcançar, atingir, chegar a, tocar, arranjar, acontecer, pegar, tirar, tomar, haver, obter, receber, fazer vir, ir buscar, mandar buscar
get a divorce = divorciar-se
get angry = zangar-se
get caught on = aferrar, enganchar, fixar
get divorced = divorciar-se
get dressed = vestir-se
get drunk = embebedar-se, embriagar-se
get in = introduzir-se, penetrar
get in a quarrel = brigar, indispor-se
get lost = perder-se
get married = casar-se, casarem-se
get mouldy = abolorecer, mofar
get off = descer
get off the subject = afastar-se, desviar-se
get out = desembarcar
get ready = preparar-se, prontificar-se
get rid of = afastar, banir
get tired = cansar-se, fatigar-se
get up = de súbito pôr-se de pé, levantar-se
get wet = molhar-se
ghastly = abominável, repugnante, desagradável, enjoado
ghost = aparição, fantasma, abantesma
giant = gigante
gift = brinde, mimo, presente, dádiva
gifted = dotado
gigantic = gigantesco
gild = dourar
gill = brânquia, guelra
gin = gim
ginger = gengibre
gird = cingir, rodear
girder = barrote, biga, trave
girdle = cinta, cintura
girl = garota, menina, moça, rapariga
gist = essência
give = brindar, doar, fazer doação de, presentear, dar, entregar, ministrar, apresentar, oferecer
give an account = comunicar, fazer relatório de, referir, relatar
give an airing = arejar, ventilar
give as an excuse = pretextar
give back = restituir, retribuir
give birth = dar à luz, parir, ter
give birth to = dar a luz, parir
give in = abdicar, alhear, ceder, submeter-se, transigir
give notice = anunciar, noticiar, notificar
give off an odour = cheirar, exalar cheiro
give rise to = causar, produzir, ser causa de
give up = abdicar, alhear, ceder, submeter-se, transigir, abrir mão de, renunciar, resignar
give way = abdicar, alhear, ceder, submeter-se, transigir
glacier = geleira
glad = alegre, contente
gladness = alegria, gozo
glamor = importância social, prestígio
glamour = importância social, prestígio
glamourous = prestigioso
glance = olhar de relance
glass = copo, de vidro, vítrio, vidreiro, vidro
glasses = óculos
glassy = vidracento
glaze = envernizar, vidrar, esmalte, vidro
glide = planar, deslizar, escorregar
glider = planador
globe = bola, globo, orbe, globo terrestre
globe-flower = trólio
gloomy = entristecedor, melancólico, nebuloso
glorify = glorificar, santificar
glorious = glorioso
glory = glória
gloss = brilho, luzeiro, glosso
glossary = glossário, terminologia
glove = luva
glow = arder, estar abrasado, flamejar, queimar-se, ardor, brasa incêndio
glow in the dark = ser fosforescente
glow with heat = arder, estar abrasado, flamejar, queimar-se
glue = colar, grudar, solvar, cola
gnash = ranger
gnat = mosquito
gnaw = mordiscar, roer
go = caminhar, andar, ir, viajar, rodar
goal = alvo, fim, ponto de mira
go around = circular, rodear
go astray = afastar-se, desviar-se, ir à garra, perder o rumo
goat = cabra
go away = afastar-se, ausentar-se, partir, retirar-se
go back = regressar, voltar
go beyond = ultrapassar, exceder, passar, transpor
goblet = cálice, copo, taça
go broke = falir, fazer bancarrota, quebrar
go crazy = enlouquecer-se
god = deus, divinidade, nume
godfather = padrinho, padrinho de batismo
go down = abaixar-se, descer, esconder-se, pôr-se
God's acre = cemitério
go fast = apressar-se
go for a walk = passear
go forward = adiantar-se, avançar, progredir
go in = entrar
gold = áureo, ouro
gold braid = galão
Gold Coast = Costa do Ouro
golden = áureo
golf = golfo
Golgotha = Calvário, Gólgota
gonorrhea = blenorréia
good = bom, bem
good afternoon = boa tarde, boas tardes
goodbye = adeus, despedida, até a vista, até logo, até mais ver
good-bye = adeus, despedida
goodbye- = de despedida
good day = bom dia
good evening = boa tarde, boas tardes
good-for-nothing = impróprio, inapto, inconveniente, imprestável, inútil, mandrião, traste
Good Friday = Sexta-feira Santa
good health = à sua saúde
good-hearted = bondoso
good-looking = de bom aspecto
good morning = bom dia, bons dias
good-natured = afável, amável, bondoso, gentil, lhano
goodness = bondade
good night = boa noite, boas noites
good taste = bom gosto, gosto bom
go on = avançar, continuar, prosseguir
go on foot = ir à pé
go on pension = tornar-se pensionista
go on pilgrimage = ir em romaria, peregrinar
goose = ganso, marreco, otário, pateta
gooseberry = groselha
go out = sair
gorilla = gorila
gospel = evangelho
go through = atravessar, percorrer, <viver até o momento>
go to bed = deitar-se na cama
go to court = acionar, processar
go to sleep = cair no sono aos poucos
goulash = goulache
go up = levantar-se, altear, elevar-se, ascender, subir
gourd = cabaça, abóbora
govern = administrar, dirigir, dominar, governar, reger
governess = governanta
government = governo
government inspector = inspetor geral
gown = beca, vestido
grace = garbo, graça, graça, mercê
graceful = esbelto, gracioso
gracefulness = garbo, graça
grade = apontamento, nota, classe, graduação, grau, posto
gradual = gradual
gradually = pouco a pouco
graduate = diplomado, graduar
grain = grão, semente, cereal
grain of salt = grão de sal
grain of sand = grão de areia
gram = grama
grammar = gramática
gramme = grama
grammophone disc = disco
granddaughter = neta
grandfather = avô
grandmother = avó
grandparents = avós
grandson = neto
granny = vovozinha
granule = grão, semente
grape = uva
grapevine = parreira, videira, vide, vinha
graphic arts = gráfico
graphics = gráfico
grapple = apanhar, aprisionar, capturar
grasp = pegar de súbito
grass = erva
grasshopper = gafanhoto, locusta
grate = ranger, cancela, grade, ralar, rapar, raspar
gratis = como um presente, grátis
gratitude = agradecimento, gratidão
grave = inquietante, alarmante, tumba, túmulo, sepultura, jazigo
gravel = areia grossa, brita, cascalho
graveyard = cemitério
gravity = gravitação
gravy = molho, tempero
graze = pastar
grease = lubrificar, untar, banha, gordura
greasy = gordo
great = excelente, ótimo, grande, magno, maiúsculo
Great Britain = Grã-Bretanha
Greater Antilles = Grandes Antilhas
great-grandfather = bisavô
great-grandmother = bisavó
greatgrandson = bisneto
Greece = Grécia
greediness = avidez, cobiça
greedy = ávido, cobiçoso, sedento, sequioso
Greek = grego
green = verdejante, verde, verdor, verdura
Greenland = Groenlândia
greet = cumprimentar, saudar
greeting = cumprimento, saudação
grenade = granada
grey = cinzento, pardo, cor cinzenta
greyhound = galgo, lebréu
grid = diese, sustenido, cancela, grade
grief = aflição, amargura, dor, pena, pesar
grieve = acabrunhar, angustiar, afligir, magoar, molestar
grill = cancela, grade
grimace = fazer caretas, careta, trejeito
grind = ranger, moer
grip = gripe
grisly = desagradável, enjoado
grit = areia grossa, brita, cascalho
groan = carpir, gemir
grocer = vendedor de especiarias
groin = virilha
groom = palafreneiro
grope = palpar, apalpar, tatear
groschen = ceitil, groche, vintém
grotesque = grotesco
grotto = caverna, furna, gruta
ground = fundo, terra, basear, dar base, terreno
ground-floor = andar térreo, rés-do-chão, térreo
groundless = sem base, sem fundamento
ground-nut = aráquida, amendoim
grounds = terreno
group = are, colecção, reunião, grupo, turma
grow = fazer-se, tornar-se, vir a ser, acontecer, aumentar, avultar, crescer, amanhar, cultivar
growl = resmungar, rosnar
grown-up = adulto, maior
grow sour = azedar-se
growth = crescimento, vegetação
grub = cavar, revolver, larva
gruel = mingau, papas, purê
gruesome = abominável, repugnante, horrível, terrível
gruff = arisco, brusco, rabugento
grumble = resmungar, rosnar
guarantee = aval, afiançar, garantir, caução, fiança, garantia
guarantee of a bill = aval
guard = guardar, velar, vigiar, guarda, corpo da guarda, condutor
guardian angel = anjo da guarda
guelder rose = viburno, vime, vimeiro, sabugueiro-de-água, novelos
guess = acertar, adivinhar, decifrar, conjetura, conjeturar, fazer de conta, supor
guesswork = conjetura
guest = freguês, hóspede, visita
guide = encaminhar, gerir, governar, dirigir, guia, conduzir, guiar, levar
guidebook = guia
guilder = florim
guilt = culpa, delito, falta
guilty = culpado, culpável
guitar = violão
gulden = florim
gulf = abismo, boqueirão, fundão, pélago, precipício, sorvedouro, golfo
Gulf of Aden = Golfo de Áden
Gulf of Bothnia = Golfo de Bótnia
gum = gengiva, goma
gun = espingarda, fuzil
gun-carriage = carreta
gunner = artilheiro
gunpowder = pólvora
gunsight = alça
gush = borbotar, esguichar, jorrar, minar
gusto = vivacidade, animação
gypsum = gesso
gypsy = cigano
habit = costume, hábito
hack = cortar com machado, picar, rachar
haddock = eglefim
haggle = pechinchar, regatear
hail = chuva-de-pedra, granizo
hailstone = glóbulo de granizo
hair = cabelo, pêlo
hair-do = frisagem
hairdresser = cabeleireira, cabeleireiro, frisador
hairpiece = peruca
hairy = peludo, piloso, viloso
halcyon = alcedo, alcíone
half = meio, metade
hall = hall, mercado, salão
halo = auréola, halo, nimbo
halt = demorar-se, deter-se, parar, fazer parar, reprimir
halyard = corda de içar vela
ham = presunto
Hamburg = Hamburg
hamlet = lugarejo, vila
hammer = martelar, marreta, martelo
hamper = dificultar
hand = obreiro, operário, trabalhador, mão, alienar, transmitir
handful = punhado
handicraft = arte, indústria, ofício, profissão
handkerchief = lenço
handle = alça, taramela, trinco, apalpar, manejar, manipular, asa, cabo, tenaz, agenciar, tratar
handlebars = leme, guidão, volante
hand over = alienar, transmitir
handshake = aperto de mão
handsome = belo, bonito, formoso, pulcro
handy = cómodo, cômodo, propício
hang = estar pendente, pender, enforcar
hanging lamp = lâmpada pendente
hangman = algoz, carrasco
hang onto = manter, segurar, sustenar, ter, conservar, guardar
happen = fazer-se, tornar-se, vir a ser, acontecer, suceder, ter lugar
happiness = felicidade
happy = feliz, alegre, contente
harbor = abrigo, porto
harbour = abrigo, porto
hard = afanoso, difícil, dificultoso, duro
harden = endurecer, enrijar, temperar
hardly = apenas, logo que, mal, quase não, dificilmente
hardworking = aplicado, assíduo, diligente, esforçado, laborioso, operoso, trabalhador
hare = lebre
harem = harém
haricot = feijão
harm = danificar, prejudicar, desvantagem, inconveniente, dano, inutilidade, prejuízo
harmful = daninho, prejudicial, nocivo
harmonious = harmonioso
harmonize = estar em harmonia
harmony = harmonia
harness = atrelar, jungir
harp = harpa
harrier = busardo
harrow = estorrar, gradar
harsh = acerbo, adstringente, brutal, pecuário, arisco, brusco, rabugento, agreste, grosseiro, ríspido, rude, tosco
harvest = ceifar, colher
hash = diese, sustenido
hashish = haxixe
haste = pressa
hastily = precipitadamente
hat = chapéu, sombreiro
hatch out = <chocar o tempo suficiente até que os filhotes saiam de ovo>
hate = odiar, ódio
haul = sacar, puxar, tirar
haunt = <aparecer como ou como se fosse fantasma>, infestar
have = ter, haver, obter, receber
have a bath = banhar-se
have a fever = estar com febre
have a good time = brincar, distrair-se, divertir-se
have a subscription = assinar
have a tendency = ter tendência a
have at one's disposal = dispor de, ter à disposição
have compassion on = apiedar-se de, compadecer-se, lastimar
have confidence in = confiar, contar com, crer, ter confiança em
have effect = actuar, agir, produzir efeito, ser eficaz
have faith = ter fé
have faith in = ter fé, ter fé em
have got = ter
have sex = copular, transar
have the right to = ter o direito de
have to = dever, ter a obrigação, ter de, ter que
hawk = acípitre, açor
hay = feno
haystack = montão de feno
hazard = acaso, azar, casualidade, arriscar, avançar, aventurar, risco
haze = aperrear, atazanar, chicanear, falar chicanas, fuxicar
hazel = avelãzeira, aveleira
hazelnut = avelã
hazel-tree = avelãzeira, aveleira
H-bomb = bomba de hidrogênio
he = ele
head = conduzir, dirigir, guiar, cabeça, cabeça
headache = dor de cabeça
header = coluna, rubrica
heading = cabeçalho, epígrafe, título, tratamento
headlight = farol, projetor, refletor
head of a department = chefe de secção
head of cattle = animal, bruto, rês
head of state = chefe de Estado
head up = administrar, dirigir
heal = curar, sarar
health = saúde
healthy = bom, são, sadio
heap = juntar em excesso, acumular, amontoar, empilhar, acervo, acúmulo, chusma, cúmulo, montão, multidão, pilha, ruma, are, colecção, grupo, reunião
hear = ouvir, ouvir dizer, informar-se
hearing aid = fone
hearsay = fama, renome, rumor, boato, nomeada
heart = coração
heart- = cordial, do coração, cardíaco
hearth = chaminé, lareira
hearty = cordial, do coração, cardíaco
heat = ardor, brasa incêndio, aquecer, cio, calor
heater = aquecedor
heath = charneca, tojal, urze
heaven = alturas, céu, olimpo
heavenly = celeste, celestial
heavenly body = astro
heavy = oneroso, pesado
Hebrew = judaico, judeu
hedge = cerca viva
heel = calcanhar, talão, salto de sapato
height = altitude, alto, eminência, altura
helix = espira, hélice, rosca
hell = inferno
hellebore = heléboro
hello = alô, bom día, olá
helm = leme, guidão, volante
helmet = capacete, elmo
help = assistência, assistir, ajudar, auxiliar, socorrer, ajuda, auxílio, socorro
helper = assistente
helpful = serviçal
hemisphere = hemisfério
hen = frango
her = dela, seu, sua
herald = anunciar, apregoar, arauto, pregoeiro
herb = erva
herd = are, colecção, grupo, reunião, gado, grei, rebanho
here = cá, aqui
here are = eis, eis aí, eis ali, eis aqui
here is = eis, eis aí, eis ali, eis aqui
heresy = heresia
heretic = herege
heretical = herético
herewith = aqui anexo
hermit = eremita
hero = herói
heroic = heróico
heroin = heroína
heroine = heroína
heron = airão, garça
herpes = herpes
herring = arenque
herself = mesmo, próprio
hesitate = hesitar, vacilar
hesitation = hesitação
hexagon = hexágono
hey = hei, psiu, olá
hiccup = soluçar, soluço
hide = pele, <pele de animal com pélos>, acobertar, esconder, ocultar
hide-and-seek = esconde-esconde
hideous = abominável, repugnante
high = alto, elevado, eminente
high-flown = extravagante
high school = ginásio
high society = alta roda, alta sociedade
high tide = preamar, premear, fluxo
highway = estrada de rodagem, rodovia
hill = chegar terra, colina, morro
hillside = declive, encosta, ladeira, rampa, vertente
hill up = chegar terra
him = ele
himself = mesmo, próprio
hind = corça
hinder = dificultar, atrapalhar, prejudicar, importunar, incomodar, molestar
Hindu = hindu
hinge = charneira, dobradiça, gonzo
hint = aludir, fazer alusão a, reportar-se
hip = quadril
hire = assalariar, contratar, empregar, engajar, tomar a serviço, alugar, fretar
his = seu, sua
hiss = assobiar, sibilar
historian = cronista
history = conto, crônica, história
hit = dar pancada, maçar, malhar, bater, golpear, percutir, furor, moda, voga, acertar, atingir, dar no alvo
hither = cá
hoarse = rouco, rouquenho
hoax = burlar, ludibriar, mistificar
hobby = hobby
hockey = hóquei
hoe = enxada
hog = porco
hoist = alçar, içar, levantar
hoist up = alçar, içar, levantar
hold = porão, manter, segurar, sustenar, ter, conservar, guardar
hold back = deter, reter
holder = bainha, estojo
hole = cava, fossa, abertura, buraco, furo, orifício
holiday = dia de folga, feriado, sueto
Holland = Holanda, Países Baixos
Hollander = holandês
hollow = côncavo, vazio, oco
holly = azevim, azevinho
holy = sacro, sagrado, santo
homage = homenagem, preito
home = casa
homesickness = nostalgia
honest = honesto
honey = mel
honeymoon = lua-de-mel
honor = homenagear, honrar, decoro, honra
honour = homenagear, honrar, decoro, honra
hood = apache, bigorrilha, vadio, capô, capote, capuz, pano de chaminé, capa, cobertura, tampa
hoodlum = bandido, gângster
hoof = casco
hook = cochete, colchete macho, anzol, adunco, curvo, enganchar, engatar, pendurar, gancho
hooker = puta, prostituta
hoopoo = poupa
hooter = buzina, chifre, corno
hop = saltitar
hope = esperar, ter esperança, esperança
hope for = aspirar, desejar vivamente, pretender
hopefully = conforme o que se pode esperar
horizon = horizonte
horizontal = horizontal
horn = chifre, buzina, chifre, corno
horned viper = cerasta, ceraste, víbora cornuda
horrible = repugnante, repugnante, desagradável, enjoado, abominável, horrendo, horrível, terrível
horror = abominação, asco, repulsão, horror, terror
horse = cavalar, hípico, cavalo
horse- = cavalar, hípico
horse-chestnut = castanha
horse-fly = mutuca, tavão
horsepower = cavalo-vapor
horseradish = rábano de cavalo, rábano-silvestre
horse-radish = rábano de cavalo, rábano-silvestre
horseshoe = ferradura
hospitable = hospitaleiro
hospital = hospital
hospitality = hospitalidade
host = anfitrião
hostage = refém
hostel = hospedaria
hot = ardente, forgoso
hotel = hotel
hour = hora
house = casa, habitação, vivenda
housefly = mosca
house of worship = casa de oração, igreja, templo
hovel = cabana, casebre, choça
hover = adejar, esvoaçar, librar-se, pairar
how = como, de que modo, qual, na qualidade de, quanto, como, de que modo, qual, na qualidade de, quanto
however = contudo, embora, entretanto, todavia, porém
howl = uivar, ulular, bramir, mugir, rugir
how many = quantos, quanto, que quantidade
how much = quanto, que quantidade
hub = cubo, cubo de roda
huddle = conviver
hue = matiz, nuança
hug = abarcar, abraçar
huge = gigantesco, enorme, imenso
hull = casco
hum = soar, zumbir, zunir
human = humano
human being = homem
humane = humanitário, humano
humanist = humanista
human race = humanidade
humble = humilde, ignoto, obscuro
humid = úmido, húmido
humility = humildade
humor = humorismo
humour = humor, humorismo
humourous = humorístico
hump = corcova, corcunda, giba
hunchback = corcunda, giboso
hundred = cem
Hungarian = húngaro
Hungary = Hungria
hunger = fome
hungry = esfomeado, faminto
hunt = andar à caça de, caçar, montear
hunter = caçador
hurray = hurra, viva
hurricane = furacão, tempestade, tufão, vendaval, procela
hurriedly = precipitadamente
hurry = apressar, instar, atropelar, apressar-se
hurt = causar dor, doer, fazer com que outro sinta dor, ferir, vulnerar
husband = cônjuge, esposo, marido
husk = casca, crosta
hut = cabana, choça, choupana
hydrogen bomb = bomba de hidrogênio
hygiene = higiene
hygienic = higiênico
hymn = hino
hypnosis = hipnose
hypnotic trance = hipnose
hypnotist = hipnotizador
hypnotize = hipnotizar
hypocrite = hipócrita
hypocritical = hipócrita
hypothesis = hipótese
hypothesize = fazer a hipótese de
hypothetical = hipotético
hysteria = histeria
hysterical = histérico