#setName = words_fi_en_aj
#sideOneTitle = FIN
#sideTwoTitle = ENG
aalto = fluid, liquid, wave
aamiainen = breakfast
aamu = morning
aamunkoitto = dawn, daybreak
aamurusko = aurora, dawn
aarre = treasure
aasi = ass, donkey
Aasia = Asia
aasialainen = Asian, Asiatic, Asian
aate = idea
aave = ghost, phantom
aavistaa = guess
abstraktinen = abstract
adjektiivi = adjective
adverbi = adverb
Afrikka = Africa
afrikkalainen = African, African
agentti = agent
ahkera = diligent, hardworking, industrious
ahne = acquisitive, eager, greedy, acquisitive
ahven = bass
aidata = bar, barrier
aihe = theme, topic, subject
aiheutua = conclusion, effect, result, result
aika = time, while
aikainen = early
aikaisin = early
aikakausjulkaisu = daily paper, journal, newspaper
aikakauslehti = magazine, periodical, revue
aikana = for, during, whereas, while, whilst
aikataulu = schedule, time-table
aikoa = intend, mean
aikomus = intention, meaning, plan
aikuinen = adult, adult, grown-up
aina = always, ever
ainakin = at least, at least
ainoa = mere, solitary, sole
ainoastaan = exclusively, just, only, alone, just, only, solely
ainutlaatuinen = unique
airo = oar
aistillinen = erotic
aivan = at all, entirely, quite, wholly
aivastaa = sneeze
aivot = brain
ajaa = go, ride, travel
ajaja = chauffeur, driver
ajanjakso = age, epoch, era
ajatella = think
ajattelutapa = thought
ajatus = idea
akademia = academy
Alankomaat = Holland, the Netherlands
alaston = bare, naked, nude
albumi = album
alistua = abandon, give up, resign, renounce
alkaa = begin, come on, set in, start
alku = beginning, commencement, start
alkuaine = element
alkusoitto = overture, prelude, overture
alla = below, beneath, under, underneath
aloittaa = begin, commence, start
alushousut = drawers, panties, underpants
alusta = base, basis, bench, easel, tressle, workbench
Amerikka = America, America, United States of America, USA
amerikkalainen = American, American, US citizen
ammatti = profession
ammentaa = draw
ammua = bellow, bleat, neigh
ampiainen = wasp
ankara = rigourous, stringent, severe, strict
ankerias = eel
ankkuri = anchor
ansaita = be worthy of, deserve, merit
antaa = give
antaa anteeksi = forgive, pardon
antaa ilmi = accuse, denounce
antaa tehtäväksi = entrust, tell
apina = ape, monkey
appelsiini = orange
arabi = Arab
arabialainen = Arabian, Arabic
arkkitehti = architect, architect
armahtaa = be lenient with, indulge, spare
armeija = army, army
arpi = scar
arvella = account, deem, opine, think
arvioida = appraise, estimate, rate
arvo = value, worth
arvoinen = deserving, worthy
arvoitus = enigma, puzzle, riddle
arvostaa = appreciate, like
arvovalta = authority
asema = stage, station, stop
asentaa = assemble, link, mount
asia = affair, business, business deal, case, matter
asiakas = client, customer
askel = pace, step, stride
aste = degree, grade
asteikko = scale
astia = vase, vessel
asua = dwell, live
asuinpaikkakunta = abode, dwelling-place, residence, abode, dwelling-place-residence
Atlantti = Atlantic, Atlantic Ocean
aurinko = sun
Australia = Australia
australialainen = Australian, Australian
autiomaa = desert
auto = automobile, car, motor car
auttaa = accomodate, aid, assist, help
avara = extensive, spacious, vast, wide
Brasilia = Brazil
brasilialainen = Brazilian, Brazilian
brittiläinen = British
bussi = omnibus
chilipippuri = chilli
edelleen = else, further, more, on
edessä = before, in front of
edistyä = advance, progress
Egypti = Egypt
egyptiläinen = Egyptian, Egyptian
ehdottaa = advance, offer, propose, suggest
ehdottomasti = absolutely, definitely, without fail
ehto = condition, stipulation, terms
ei kenenkään = no-one's
ei koskaan = never
ei kuinkaan = by no means, in no way, not at all, not on any account
ei kukaan = neither, nobody, none, no-one
eikä = neither, nor
ei lainkaan = not an ace
eilen = yesterday
ei mikään = nothing
ei missään = nowhere
ele = gesture
elokuu = August
eläin = animal, beast
elää = be alive, live
endiivi = endive
enemmän = more
Englanti = England
englantilainen = English, Englishman, Sassenach
eniten = most
enkeli = angel
epäillä = doubt, suspect
erehtyä = err, make a mistake
eri = apart, particular, separate, special
erilainen = diverse, varied, various
erota = differ, be different
erottaa = distinguish
erotus = difference
esimerkki = example
esine = article, object, thing
esittää = act, introduce, offer, present, perform, tender
Espanja = Spain
espanjalainen = Spanish, Spaniard
etana = slug
etelä = south
Etelä-Afrikka = South Africa
etenkin = above all, especially, chiefly, mainly, principally
etevä = eminent
etsiä = look for, seek
ettika = vinegar
että = that
etäisyys = distance, offset
euroopalainen = European
Euroopan Unioni = European Union
Eurooppa = Europe
Eurooppaa = Europa, Europe, Europa, Europa
eurooppalainen = European
fysiikka = physics
haapa = aspen
hai = shark
haistaa = smell
haka = hook
hakata = chop, cut, hack
hakkailla = flirt, flit, flutter
haljeta = burst
hallita = control, govern, restrain, rule
haltia = fairy
haluta = desire, wish
hame = skirt
hammas = tooth
hammasharja = tooth-brush
hammassärky = toothache
hammastahna = tooth-paste
han = certainly, indeed, rather, surely
hana = faucet, tap
hanhi = goose
hankkia = achieve, acquire, attain, get, obtain
hansikas = glove, mitten
happo = acid
harakka = magpie
haravoida = rake
harja = brush
harkita = account, consider, esteem, regard, take into account
harmaa = grey
harmonikka = accordion
hartia = shoulder
hattu = hat
hauki = pike
haukkua = bark
haukotella = yawn
haulipanos = cartridge
hauta = grave, tomb
hedelmä = fruit
hehkua = glow, glow with heat
heiluttaa = brandish, fling, swing, wave, wave about
heinäkuu = July
heinät = hay
heittää = throw
helmi = pearl
helmikuu = February
helppo = easy, facile
hengittää = breathe
henkevä = lively, witty
henki = spirit
henkilö = person
herjata = blaspheme, cuss, curse, swear
herkistymä = allergy
herkutella = relish
herra = gentleman, lord, Mr.
herättää = arouse, wake, awaken, wake up
heti = at once, immediately, just, right away, right now
hetki = instant, moment
hevonen = horse
hiekka = sand
hienon hieno = subtle
hiha = sleeve
hiili = coal, carbon
hiiri = mouse
hikoilla = sweat
hinta = price
hirsi = beam, girder
hirvi = elk, moose, deer
historia = story, history
hius = hair
hoitaa = attend, nurse, tend to, look after, nurse
hollantilainen = Dutch, Dutchman, Hollander
hopea = silver
horisontti = horizon
hotelli = hotel
houkutella = attract, decoy, lure
hourailla = be delirious
housut = pants, trousers
huhtikuu = April
huilu = flute
huippukohta = acme
hukkua = drown
hullu = crazy, insane, mad, nuts
hummeri = lobster
hunaja = honey
huokailla = groan, moan
huolehtia = care, see, take care, worry
huolimatta = despite, in spite of, notwithstanding
huomata = notice
huomenna = tomorrow
huone = place, chamber, room
huonekalu = piece of furniture
huono = rotten, ugly
hurmata = delight
hurskas = pious
hutiloida = botch, bungle, screw up, spoil
huuli = lip
huutaa = cry out, scream, shout
huvi = fun, pleasure
huvittaa = amuse
huvivene = yacht
hyeena = hyaena
hylly = shelf
hypätä = jump, leap, spring
hytti = cabin
hyvä = good, nice, okay
hyväillä = caress, chuck, fondle, stroke
hyväksyminen = acceptance, admission
hyväksyä = approve
hyvästi = adieu, farewell, bye, goodbye
hyödyllinen = advantageous, useful
hyökätä = assault, attack
hyönteinen = bug, insect
hyötyä = profit
häiritä = distract, divert, entertain
hämmentää = confuse, puzzle
hämärä = dusk, twilight
hän = he, him, her, she
häntä = tail
härkä = bovine, bovine animal
hävittää = exterminate, wipe out
höyry = steam, vapor, vapour
ies = yoke
ihmetellä = marvel, marvel at, wonder
ihminen = man, human being
iho = skin
ihra = bacon
ikkuna = window
ikä = age
ikävystyyää = bore
ikävöidä = be bored, be tired of something
ikäänkuin = as if, as though, in a way
ilkeä = malicious, mischievous, nasty, vicious
ilma = air
ilmaista = express
ilman = without
ilmapiiri = atmosphere, ethos, mood
ilmasto = climate
ilme = expression
ilmeinen = evident, obvious
ilmiö = phenomenon
ilmoitus = ad, advertisement
ilo = gladness, joy
iloinen = cheerful, gay, merry
ilta = evening
iltapäivä = afternoon
ilves = lynx
imarrella = flatter
imeä = absorb, sip, suck
improvisoida = ad-lib
imupaperi = blotter, blotting paper
imuri = blotter, blotting paper
inhimillinen = humane
inhottava = nasty
innostus = alacrity, enthusiasm, verve, vivacity
Intia = India
intialainen = Indian, Indian
into = fervor, fervour, zeal
intohimo = lust, passion
Irlanti = Ireland
irlantilainen = Irish, Irishman
iskeä = hit, knock, strike
Islanti = Iceland
iso = big, great, large
Iso-Britannia = Britain, Great Britain
isoisä = grandfather
Israel = Israel
israelilainen = Israelian, Israelian
istua = sit
isä = father, father
isäntä = boss, master
Italia = Italy
italialainen = Italian, Italian
itkeä = cry, weep
itse = self, herself, himself, itself
itsepäinen = obstinate, stubborn
itu = germ
itä = east, East
ja = and
jakaa = divide, separate, share
jalka = foot, paw
jalo = noble
jalokivi = jewel
Japani = Japan
japanilainen = Japanese, Japanese
jarru = brake
jatkaa = continue, go on, proceed with
jauhaa = grind, pulverize
jauhot = flour, meal
jo = already, by now, yet
jogurtti = yoghourt, yoghurt
jokainen = all the, each, every, everybody, every one
jokaisen = everyone's
joki = stream, river
jokin = anything, something
joku = a, any, anybody, some, somebody, one, someone, some one
jolloinkin = at some time, ever, sometime
jonkinlainen = some kind of
jonkin verran = a little, rather, some, somewhat, to some extent
jonkun = someone's
jonnekin = somewhere, to some place
jos = if, provided that
jossakin = anywhere, somewhere
jostakin syystä = for some reason
jotenkin = anyway, somehow
joulu = Christmas, Yule
joulukuu = December
joutsen = swan
jugoslaavi = Yugoslav, Yugoslavian
Jugoslavia = Yugoslavia, Yugoslavia
jugoslavialainen = Yugoslav, Yugoslavian
juhla = celebration, festival, party
juhlallinen = ceremonious, solemn
juhlia = celebrate
juliste = notice, placard, poster
julma = cruel
Jumala = God
juna = train, train
juoda = drink
juomalasi = glass
juonitella = intrigue
juopunut = drunk, intoxicated
juosta = run
juova = ray, strip, stripe
juuri = just, just now
juusto = cheese
juutalainen = Hebrew, Jewish, Hebrew, Jew, Jewish, Jew
jyrkkä = abrupt, steep, radical
jyvä = grain, granule, pip
jäljentää = copy
jäljitellä = imitate
jälkeen = after, behind
jälki = trace, track
jälleen = afresh, again, all over again, anew
jälleen- = re-
jänis = hare
jänne = cord, string
jännittää = strech, wind up
jännitys = tension
järjestelmä = system
järjestys = order
järjestää = arrange, fix up
järjetön = absurd
järki = reason, logical reasoning
järvi = lake, loch
jäsen = acolyte, member, supporter, limb, member
jäsenmaksu = dues, subscription
jättää = allow, leave, let, release
jää = ice
jäädä = remain, stay, stay over