#setName = longlist_en_da
#sideOneTitle = ENG
#sideTwoTitle = DAN
a = i, om, på, en, et
Aaron = Aaron
abacus = abacus
abandon = forlade
abashed = forlegen, genert, sky
abbey = abbedi
abbreviate = forkorte
ABC book = læsebog
abdomen = bug
aberrance = afvigelse
aberration = afvigelse, fejl
abhor = afsky
abhorrence = afsky
abide = forvente, gennemgå
abiding = uafbrudt
ability = egnethed
abjure = aflyse, sende afbud
Abkhazia = Abkhasien
Abkhazian = abkhasier
able = dygtig
abnormal = uregelmæssig
abode = bopæl, sted, bolig
abolish = afskaffe, aflyse, sende afbud
abolition = afskaffelse, afbud
abominate = afsky
abomination = afsky
aboriginal = oprindelig
abortion = abort
about = verdrørende, af, om, over, til, vid, omtrent, omkring
about-face = ændring
above = nord for, over, oven, op, op ad
above-board = ærlig
Abraham = Abraham
abrasion = ridse
abrasive = skarp
abridge = indskrænke, forkorte
abridgement = overblik
abroad = udenfor
abrogate = afskaffe, aflyse, sende afbud
abrogation = afskaffelse, afbud
abrupt = stejl, pludselig
abscess = absces
absence = fraværelse, mangel
absent = fraværende
absent onself = afgå, afrejse, go ud, rejse bort
absolute = absolut, fuldstændig
absolution = benådning, nåde
absorb = indsuge
abstract = abstrakt, slutte, tage bort, overblik
abstraction = tyveri
absurd = absurd
abundance = rigdom
abuse = fornærme, skælde, fornærmelse
abysmal = forfærdelig, rædsom, skrækkelig
abyss = afgrund
Abyssinian = abyssiner
acacia = akacie
academic = akademisk, student
academician = akademiker
academy = akademi
accede = samtykke
accent = accent, betoning, lægge vægt på
accent mark = accent
accentuate = lægge vægt på
accept = acceptere, sige ja tak til, modtage
access = angreb, adgang, tilstrømning
accessible = tilgængelig
accession = erhverv, erhvervelse
accidence = tilfælde
accident = ulykke, ulykkestilfælde
accidental = tilfældig
acclaim = bifald
acclamation = bifald, applaus
acclivity = skrænt
accommodate oneself = timelding
accommodation = anlæg, indretning, aftale, samtykke, kompromis, bolig
accomodate = fuldende, hjælpe
accompany = ledsage
accomplishment = handling
accord = stemme overens, akkord, aftale, samtykke, tillade
accordance = akkord
according as = i henhold til
accordingly = altså
according to = i henhold til
accordion = harmonika, trækharmonika
account = forklaring, information, beretning, tage hensyn til, konto, tro, afregning, bevæggrund, mene, synes, beskrivelse
accountable = ansvarlig
account for = forklare
accredit = tro
accretion = vækst
accrue = afstamme, vokse
accumulation = mængd
accumulator = akkumulator
accuse = anklage, angive, forråde
accustomed = almindelig, vanlig, sædvanlig
ace = es
acerbic = skarp, bitter
acerbity = skarphed
acetous = sur
acetylene = acetylen
ache = kræve, smerte, længsel
ache for = længes efter
Acheron = Akeron
achieve = aflægge, gøre, lave
achievement = handling, succes
Achilles = Achilles
Achilles' heel = achilleshæl
Achilles' tendon = achillessene
acid = sur, syre, skarp
acknowledge = takke for, bekende, skrifte, tilstå, bekræfte
acknowledgement = bekendelse, skriftemål, kvittering
acolyte = medlem
acorn = agern
acquaint = meddele
acquaintance = bekendtskab, bekendt, kundskab
acquire = købe
acquisition = erhverv, erhvervelse, indkøb, køb, indkøb
acrid = skarp
acrimonious = skarp
acrimony = skarphed
acrobat = akrobat
across = over, tværs
across from = imod
act = handling, aktstykke, akt, virke på, aflægge, gøre, lave, forestille, præsentere, servere, udføre
action = handling, kamp, slag, slagsmål, træfning, indflydelse, proces
active = aktiv
activity = aktivitet, beskæftigelse
act of grace = amnesti, benådning
actor = skuespiller
actual = virkelig, nærværende, reel
actually = faktisk
acuity = skarphed, opmærksomhed
acute = skarp
ad = annonce, reklame
adage = ordsprog
Adam = Adam
Adam's apple = adamsæble
adaptation = tilpasning
adapt oneself = timelding
add = addere, tilføje
addendum = bilag
Addis Ababa = Addis Ababa
addition = bilag
additional = øvrig, ekstra
additive = bilag
addled = dum
address = adressere, adresse
addressee = modtager
address list = vejviser
add up = addere
Aden = Aden
adieu = farvel, ha' det godt
adjective = adjektiv
adjourn = udsætte
adjunct = bilag, supplement
adjustable wrench = skruenøgle
adjustment = tilpasning, anlæg, indretning
administration = styre, regering
admiral = admiral
admire = beundre
admission = adgang, bekendelse, skriftemål
admit = indrømme, bekende, skrifte, tilstå, tillade
admittance = adgang
admixture = blanding
ado = larm
Adonis = Adonis
adopt = adoptere
adoptive child = adoptivbarn
adore = dyrke
adornment = dekoration
Adrianople = Adrianopel
Adriatic = Adriaterhavet
Adriatic Sea = Adriaterhavet
adroit = livlig
adult = voksen, myndig
advancement = fremskridt
advantage = fordel
advantageous = fordelagtig, gunstig, nyttig
advent = advent
adventitious = tilfældig
adventure = eventyr
adventurous = risikabel
adverb = adverbium
adversary = fjende
adverse = modsat, ufordelagtig, skadelig
adversity = forfald
advert = forvente, reklame
advertence = opmærksomhed
advertency = opmærksomhed
advertise = avertere
advertisement = annonce, reklame
advice = råd, bekendtgørelse
advise = råde
advocate = advokat, sagfører
Adzharia = Adzharien
Aegir = Ægir
Aeneas = Æneas
aerial = antenne
aeroplane = flyvemaskine
affable = flink, venlig
affair = affære, anliggende, tilfælde
affecting = følsom, modtagelig
affection = kærlighed
affiliate = filial
affiliation = filial
affined = i familie
affirm = forsikre
affirmation = løfte
affix = befæste, fassætte
affluence = rigdom
affluent = rig
afford = tillade, producere
Afghan = afghaner
Afghanistan = Afghanistan
Afghan woman = afghanerinde
afraid = bange, sky
afresh = igen
Africa = Afrika
African = afrikansk, afrikaner
African marigold = tagetes
African woman = afrikanerinde
Afrikaans = afrikaans, boer-sprog
Afrikaner = Afrikander, Boer
Afro-Asian = afro-asiat
after = efter
afternoon = eftermiddag
afterwards = derefter, herefter
again = igen
against = imod
Agamemnon = Agamemnon
age = alder, epoke
agency = agentur
agent = agent, redskab, verktøj
aggravate = plage
aggression = aggression, angreb
aggressive = offensiv
aggro = aggression
agile = livlig
agitate = oprøre, ryste
agitated = nervøs.. ago = for ... siden
agog = nysgerrig
agony = angst, rædsel
agree = stemme overens, samtykke
agreeable = behagelig, rar
agreement = akkord, aftale, samtykke, enighed
agree with = være enig med
ague = feber
ahead = forhen, fremad
aid = assistant, hjælp, hjælpe
ailment = sygdom
aim = sigte, hensigt, mål, formål, bestræbe sig
air = luft
aircraft = flyvemaskine
airplane = flyvemaskine
airport = lufthavn
airtight = hermetisk
Ajax = Ajax
akin = i familie
alacrity = begejstring
alarm = alarm, forskrække, vækkeur
alarmclock = vækkeur
alarmed = forfærdelig, rædsom
alas = desværre, det er en skam
Alaska = Alaska
Albania = Albanien
Albanian = albansk, albanierinde, albaner
Albanian language = albansk
Albanian woman = albanierinde
Albion = Albion
album = album
alcohol = alkohol
alcoholic = alkoholisk
ale = øl
Aleppo = Aleppo
alert = livlig
Alexander = Alexander
Alexandria = Alexandria
Alfred = Alfred
Algeria = Algeriet
Algerian = algerier
Algerian woman = algerierinde
Algiers = Algier
alibi = alibi
alien = udenlandsk, fremmed, modsat
alike = lignende
a little = lidt
alive = levende
all = all, alle
all about = overalt
Allah = Allah
allergic = allergisk
alley = stræde
All Hallows = allehelgensdag
all of a sudden = pludseligt
all over again = igen
allow = løslade, tillade
alloy = legering
All Saints' Day = allehelgensdag
All Souls' Day = allesjælesdag
all the = al, hver
allusion = hentydning
almost = næsten
alms = almisse
alone = alene, bare, blot, kun
alp = sæter
alphabet = alfabet
alphabetical = alfabetisk
Alpine hut = alpehytte
Alpinist = Alpinist
Alps = Alperne
already = allerede
Alsace = Alsace, Elsass
Alsace-Lorraine = Alsace-Lorraine, Elsass-Lothringen
Alsatian = Alsakser, Elsasser, schäferhund
also = også
altar = alter
alteration = ændring
alternation = afveksling
altitude = højde
altogether = all
alum = alun
aluminium = aluminium
aluminum = aluminium
Alva = Alba
always = altid
amateur = amatør
Amazon = Amazonfloden, amazone
Amazon River = Amazonfloden
ambassador = ambassadør, bud, gesandt
amber = rav
ambiguous = tvetydig
ambition = ærgerrighed
Amboina = Amboina, Ambon
Amboinese = amboner
ambulance = ambulance
America = Amerika
American = amerikaner, amerikansk
American football = amerikansk fodbold
American Indian = indianer
American Samoa = Amerikansk Samoa
American woman = amerikanerinde
Amman = Amman
ammunition = ammunition
amnesty = amnesti, benådning
among = mellem
amount = tal, antal, beløb, sum
amphitheatre = amfiteater
amputate = amputere
amusing = morsom
an = en, et
anarchist = anarkist
anatomical = anatomisk
anchor = anker
anchovy = ansjos
ancient = antik
and = og
anew = igen
angel = engel
anger = vrede
angina = angina
angle = vinkel
Anglican = anglikansk
angry = vred
anguish = angst, rædsel
animal = dyr
ankle = ankel
annotation = kommentar
announce = avertere
announcement = bekendtgørelse
annoy = plage
annual = årlig
annul = aflyse, sende afbud
anoint = smøre
anonymous = anonym
answer = svare, svar
ant = myre
Antarctic = Sydpolen
antenna = antenne
antibiotic = antibiotikum
antique = antik
anti-Semitism = antisemitisme
antiseptic = antiseptisk
antisocial = asocial
antithesis = modsætning
anus = endetarmsåbning, røv
anvil = ambolt
anything = noget
anywhere = nogensteds
apart = særskilt
apartment = appartement, lejlighed
apartment building = appartementhus, højhus
apathetic = apatisk
ape = abe
apiarist = biavler
apologize = undskylde sig
apology = undskyldning
apostle = apostel
apparatus = apparat
appeal = udnævnelse
appear = se ud, forekomme
appearance = fremkomst, syn
appear to be = forekomme
appellation = navn, benævnelse
appetite = appetit
apple = æble
apple-tree = æbletræ
apply = anvende
appointment = betegnelse, aftale, rendezvous
appointment to office = betegnelse
appraise = bedømme, vurdere
appreciate = kunne lide, sætte pris på, synes om
approval = bifald
approve = godkende
approximately = omtrent
apricot = abrikos
April = april
aptitude = talent
aquarium = akvarium
Arab = araber
Arabian = arabisk
Arabic = arabisk
arc = bue
archaeology = arkæologi
archbishop = ærkebiskop
architect = arkitekt
architecture = arkitektur
archive = arkiv
archives = arkiv
Arctic = Nordpolen
Arctic Ocean = Ishavet
are = gruppe
arena = arena
Argentina = Argentina
Argentine = argentinier
argument = bevis
arise = være født
aristocratic = aristokratisk
arm = arm
armchair = lænestol, armstol
army = armé, hær
aroma = aroma
around = om, omkring
arouse = vække
arrange = indrette, ordne, rede, rydde op
arrangement = anlæg, indretning
arrest = arrestere
arrival = ankomst, komme
arrive = ankomme
arse = endetarmsåbning, røv
art = kunst
artery = arterie
artichoke = artiskok
article = artikel, ting
article of dress = beklædning
artificial = kunstig
artillery = artilleri
artist = artist
as = når, hvornår, i henhold til, sådan, således, fordi
as a matter of fact = faktisk
as ... as = lige så ... som
ash = aske, ask, asketræ
ashamed = skammelig
ashtray = askebæger
Asia = Asien
Asian = asiatisk, asiat
Asiatic = asiatisk
ask = spørge, bede
ask for = bede
asparagus = asparges
aspect = syn
ass = æsel
assault = angribe, anslag
assemblage = forsamling, montage
assemble = forsamles
assembler = montør
assembly = montage
assert = hævde, påstå
assertion = påstand
asset = erhvervelse
assigned job = opgave
assist = hjælpe
assistant = assistent
associate with = omgås
as soon as = så snart som
assure = forsikre
aster = asters
asthma = astma
astonishment = forbavselse
astronaut = astronaut
astronomy = astronomi
asylum = asyl
at = for, på, til, hos, ved
at all = helt
athlete = atlet
at home = hjemme
Atlantean = atlantisk
Atlantic = Atlanterhavet, atlantisk
Atlantic Ocean = Atlanterhavet
atlas = atlas
at last = endelig
at least = i det mindste
atmospheric = atmosfærisk
atom = atom
atomic energy = atomenergi
at once = straks
at present = nu
at some time = nogensinde
attach = befæste, fassætte
attaché = attaché
attack = angribe, angreb
attempt = bestræbe sig, forsøg, forsøge, prøve
attend = passe, pleje, besøge
attendance = betjening
attention = opmærksomhed
attentive = opmærksom
at the right time = i tide, rettidigt
attic = loft, loftsrum
attitude = holdning
attract = tiltrække
attraction = tiltrækningskraft
at variance = uenig
aubergine = aubergine
auction = auktion
audit = kontrolere
auditorium = aula
August = august
aunt = faster, moster, tante
Australia = Australien
Australian = australsk, australier
Austria = Østrig
Austrian = Østriger
authentic = ægte
author = autor, forfatter
authorative = autoritær
authority = autoritet
autobus = bus
autodidact = autodidakt
automatic = automatisk
automobile = bil, automobil
automoton = automat
autopsy = autopsi
autumn = efterår, høst
avalanche = lavine
avaricious = gerrig
avenue = allé
average = gennemsnitlig, gennemsnit, midte
aversion = modvilje
avoid = undgå, undvige
await = forvente
awake = vågen
awaken = vække
awareness = bevidsthed
away = bort
axe = økse
axis = aksel
axle = aksel
azalea = azalea
baby = baby, spædbarn
baby's comforter = støvsuger
babysitter = babysitter
back = ryg, tilbage
back of the neck = nakke
bacon = bacon
bad = dårlig, ilde, ond, slet
badger = grævling
badly = dårligt
bag = taske
baggage = bagage
bairn = barn
bake = bage
baker = bager
bakery = bageri
baking oven = bageovn
balance sheet = status
balcony = altan, balkon
ball = bal, bold
ballast = ballast
ballet = ballet
ballgame = boldspiel
balloon = ballon
balm = balsam
balsam = balsam
Baltic Sea = Østersøen
bamboo = bambus
banana = banan
band = bande
bandage = bandage
bandit = bandit
bank = bank, bred
banknote = pengeseddel
bank-note = pengeseddel
bank note = pengeseddel
banner = flag
banquet = festmåltid
bar = briket, forhindre, hindre
barber = frisør
bare = nøgen
barely = knæppe
baritone = baryton
bark = bark
barley = byg
barn = lade, barak
barometer = barometer
barrack = lade
barracks = kaserne
barrel = beholder, rør
barricade = barrikade
barrister = advokat, sagfører
barrister-at-law = advokat, sagfører
base = base, basis
baseball = baseball
basement = kælder
basilica = basilika
basin = kumme
basis = base, basis
basket = kurv
bass = aborre
bast = bast
bat = flagermus
bath = badekar, bad
bathe = bade
bathing-suit = badedragt
bathing suit = badedragt
bathroom = badested, badeværelse
battery = akkumulator, batteri
battle = kamp, slag, slagsmål, træfning
bay = bugt
bayonet = bajonet
bazaar = basar, torv
be = være
be able to = kunne
be absent = være borte
beach = strand
be acquainted with = kende
be afraid of = være bange, være bange for
be a guest of = bo
beak = næb
be alive = leve
beam = stråle, bjælke
bean = bønne
bear = producere, gennemgå, bjørn
beard = skæg
be ashamed = skamme sig
be asleep = sove
beast = dyr
beat = slå
beautiful = skøn, smuk
beauty = skønhed
be bold = turde, vove
be born = være født
be burnt down = afbrænde
be called = hedde, kaldes
because = fordi
become = blive, ske
become engaged = forlove sig
become engaged with = forlove sig med
become the fiancé of = forlove sig med
become the husband of = gifte sig med
become the wife of = gifte sig med
bed = bed, seng
be dependent on = afhænge af
bedroom = sovekammer, soveværelse
bee = bi
beech = bøg
beef = oksekød
be effective = virke på
beefsteak = bøf
bee-keeper = biavler
bee-master = biavler
beer = øl
beet = bede
beetle = bille
be fond of = være vild efter
before = før
be found = forekomme, ligge
beg = bede
beggar = tigger
begin = begynde
beginning = begyndelse
be grieved = være ked af det
behave = opføre sig
behavior = opførsel
behaviour = opførsel
behind = bagom, efter
be inclined = bøje
be indignant = ærgre sig
be indignant with = ærgre sig over
Belgian = belgisk, belgier
Belgium = Belgien
belief = overbevisning, tro
believe = tro
believe in = tro på
bell = klokke
belly = bug
be located = forekomme, ligge
belong to = tilhøre
below = derunder, nede, forneden, under
belt = bælte, zone
be lucky = være heldig
be married = gifte sig
be missing = være borte
bench = bænk, sofa
bend = bøje, bøje sig, sving
beneath = under
benefit = fordel
bent = bøjet
be on a visit = bo
be quiet = tie
be related to = være i slægt med
be right = have ret
Berlin = Berlin
berry = bær
be sad = være ked af det
beside = hos
besides = desuden,, videre
be similar = ligne
be situated = ligge
be sorrowful = være ked af det
be sorry about = beklage, være ked af
best = bedst
bet = vædde
betrothal = forlovelse
better = bedre
between = mellem
beverage = drik
bevy = gruppe, bande
be willing to = ville
be worth = være værd
be worthy of = være værd, fortjene
be wrong = have uret
beyond = videre, derpå, forbi, over, tværs
biased = tendentiøs
bible = bibel
bicycle = cykel
bid = bede
big = stor
bike = cykel
bikini = bikini
bill = næb, billet
billiards = billard
bind = binde
binding = indbinding
binoculars = kikkert
birch = birk
bird = fugl
birth = fødsel
birthday = fødseldag
biscuit = kiks
bishop = biskop
bit = stykke
bite = bide, bid
bitter = bitter
black = sort
blackberry = brombær
blackbird = solsort
bladder = blære
blame = skyld, bebrejde
blank = hvid, formular
blanket = tæppe
blaspheme = bande
bleak = ubehagelig, mørk, kold
blend = blande
blind = blind, blind person
blindness = blindhed
block = blok
blockade = blokade, spærring
block of flats = appartementhus, højhus
blond = blond
blood = blod
bloody = blod-
bloom = blomst
blot = plet
blotter = trækpapir
blotting paper = trækpapir
blouse = bluse
blow = slag, blæse
blow one's nose = pudse sin næse
blue = blå
blueberry = blåbær
blunt = sløv, stump
blushing = rød
board = hylde
board of directors = myndighed, styre
boast = prale
boat = båd
body = karosseri, krop, legeme
Boer = Afrikander, Boer
boil = koge
boiled egg = spejlæg
bold = tyk
bomb = bombe
bonbon = bolsje
bon-bon = bolsje
bond = bånd
bone = ben, knogle
bonnet = motorhjælm
book = bog,. Bestille, anmelde, reservere
bookcase = bogskab
booking-office = billethul
book-keeper = bogholder
bookseller = boghandler
bookshop = boghandel
bookstore = boghandel
boot = støvle
booty = bytte
border = bred, kant, rand
bore = bore, bor, kede
borrow = låne, løne
bosom = bryst, barm
boss = chef
botany = botanik
both = både, begge
bother = hindre, forstyrre
bottle = flaske
bottom = grund
bough = gren
bouillon = bouillon
boulder = klippe
boundary = grænse
bouquet = blomsterbuket
boutique = butik
bow = bue, bov
bowl = kumme
box = kiste, dåse, beholder, potte
boxer = bokser
box-room = lager
boy = dreng, knægt, tjener
bracelet = armbånd
braces = seler
brag = prale
braid = bind
brain = hjerne
brake = bremse
branch = gren, afdeling, fag, filial
brandish = svinge
brandy = cognac
brass = messing
brave = modig, tapper
Brazil = Brasilien
Brazilian = brasilianer
bread = brød
bread and butter = smørrebrød
break = pause, brække, bryde, afbryde
breakable = skør
breakfast = morgenmad
breast = bryst
breath = ånde
breathe = ånde
breed = avle, opdrage, race
breeze = brise
brick = mursten
bride = forlovede, brud
bridegroom = brudgom
bridge = bro
brief = kort
brigade = brigade
bright = lys, let
brim = kant, rand
bring = bringe
bring up = opdrage
brinjal = aubergine
brink = kant, rand
brisk = livlig
Britain = Storbritannien
British = britisk
Briton = brite
brittle = skør
broad = bred
broadcast = udsende
broker = ejendomsmægler
bronze = bronze
brooch = broche
broom = kost, fegekost
brothel = bordel
brother = broder, bror
brother-in-law = svoger
brothers and sisters = søskende
brow = øjenbryn
brown = brun
brush = børste
Brussels-sprouts = rosenkål
brutal = uvenlig
bubble = blære
bucket = spand
buddy = kammerat
buffalo = bøffel
buffer = kofanger
buffet = buffet
bug = insekt
build = bygge, konstruere
builder = bygmester
building = bygning
building contractor = bygmester
building-plot = byggeplads
building-site = byggeplads
bulb = ampul, pære
bulk = størrelse
bull = tyr
bullet = kugle
bulletin = beretning
bump = pukkel
bumper = kofanger
buoy = bøje
burden = byrde, last
burdensome = tung
bureau = kontor
burgomaster = borgmester
burn = brænde
burn down = afbrænde
burst = briste
bury = begrave
bus = bus
bush = busk
business = affære, anliggende, handel
business deal = affære, anliggende
businessman = købmand
but = men
butcher = slagter
butter = smør
butterfly = sommerfugl
button = knap
buy = købe, køb, indkøb
buyer = køber
by = hos, af, for, om, siden, på, ved, i henhold til, forbi
by accident = tillfældigvis
by chance = tillfældigvis
bye = farvel, ha' det godt, farvel så længe, på gensyn, vi ses
by heart = udenad
by no means = ingenlunde
by now = allerede
by the way = apropos
cabaret = kabaret
cabbage = kål
cabin = hytte, kahyt
cabinet = skab
cable = kabel
cactus = kaktus
café = café
cage = bur
cake = kage
calculate = beregne, kalkulere
calendar = kalender
calf = kalv, læg
call = kalde, råbe
call on = besøge
calm = rolig
camel = kamel
camera = kamera
camping ground = camping
camping site = camping
canal = kanal
canary = kanariefugl
cancel = abbestellen, sende afbud, aflyse
candidate = ansøger, kandidat
cannon = kanon
can opener = dåseoplukkner
canteen = feltflaske
cap = kasket, hue
capable = dygtig
captain = kaptajn
capture = fange
car = bil, automobil
carburettor = karburator
cardboard = karton
cardiac = hjerte-, hjertelig
care = sorg
care about = bryde sig om
care for = behandle
careful = forsigtig
caress = stryge
carnival = karneval
carousel = karrusel
carp = karpe
carpet = gulvtæppe, tæppe
carriage = vogn, waggon
carrot = gulerod
carrousel = karrusel
carry = bære
cartridge = patron
case = affære, anliggende, tilfælde
casino = kasino
casserole = kasserolle
cassette = kassette
castle = slot, tårn
cat = kat
catalogue = katalog
catarrh = katar
catastrophe = katastrofe
catch = fange, fangst
caterpillar = kålorm
cathedral = domkirke, katedral
cauliflower = blomkål
cause = årsag
caution = advare, forsigtighed
cautious = forsigtig
cave = grotte
caviar = kaviar
cease = ophøre
cede = give efter
ceiling = loft
celebrate = fejre
celebrating one's birthday = fejre fødselsdag
celebration = fest, højtid
celebrity = star
cell = celle
cellar = kælder
cement = cement
cemetery = kirkegård
censor = censur
censure = kritisere
centennial = århundrede
centimetre = centimeter
central = central
central heating = centralvarme
centre = centrum
century = århundrede
ceremony = ceremoni
certain = sikker
certainly = nok
certificate = aktstykke, attest
chain = kæde
chair = stol
chairman = præsident
chalice = bæger
chalk = kridt
challenge = udfordre
chamber = værelse
chamois = vaskeskind
chamois leather = vaskeskind
champagne = champagne
chance = tilfældig, tilfælde, anledning, lejlighed
change = ændring, småpenge, forandre, veksle, ændre,
channel = kanal, rør
chaos = rod
chapter = kapitel
character = karakter, natur, tegn
characteristic = ejendommelig
charge = byrde, last
charity = almisse, barmhjertighed
charm = ynde
charming = fortryllende, rar
chase = forfølge, jage
chasm = afgrund
chat = sludre, snakke
chatter = sludre, snakke
chauffeur = chauffør, fører
cheap = billig
cheat = bedrage
check = kontrolere, bankanvisning
checkers = damspil
check up on = kontrolere
cheek = kind
cheerful = alvorlig, munter
cheers = skål
cheese = ost
chemist = apoteker, kemiker
chemistry = kemi
chemist's shop = apotek
cheque = bankanvisning
cherry = kirsebær
chess = skak
chest = bryst, kiste, kommode
chestnut = kastanie
chew = tygge
chicken = høne
chicory = julesalat
chief = chef, overordnet
child = barn
chilly = kold
chimney = skorsten
chin = hage
China = Kina
Chinaman = kineser
Chinese = kinesisk, kineser
chisel = mejsel
chlorine = klor
chocolate = chokolade
choice = valg
choke = kvæle
cholera = kolera
choose = vælge
chord = akkord
chorus = kor
Christian = kristen
Christianity = kristendom
Christian name = fornavn
Christmas = jul
chromium = krom
chuck = stryge
church = kirke
church-building = kirke
cider = æblevin
cigar = cigar
cigarette = cigaret
cinder = aske
cinema = biograf
circle = cirkel, selskab
circumference = omfang
circumstances = tilstand
circus = cirkus
citadel = citadel
cite = citere
citizen = statsborger
city = by
city hall = rådhus
civil = civil
civilian = civil
civil status = civilstand
clarify = forklare
class = klasse, kursus
classic = klassisk
classical = klassisk
claw = klo
clay = ler
clean = ren, gøre rent, rense
cleanliness = renhed
cleanse = gøre rent, rense
clear = lys, klar, tydelig
clergyman = gejstlig, præst
clerk = kontorist
client = køber, kunde
climate = klima
climb = klatre
climber = Alpinist
climber's hut = alpehytte
clip = klippe
cloakroom = garderobe
clock = ur
close = lukke, intim, nær, nærheden
closed = lukket
closet = skab
clothes = klæder, tøj
clothespeg = tøjklemme
clothespin = tøjklemme
clothing = klæder, tøj
cloud = sky
clown = klovn
club = klub, selskab
clutch = gribe, kobling
coach = vogn, waggon
coach-work = karosseri
coal = kul
coarse = ru
coast = kyst
coat = frakke
cock = hane
cocoa = kakao
coconut = kokosnød
cod = kabliau, torsk
coddle = forkæle
codfish = kabliau, torsk
coffee = kaffe
coffee-house = café
coffee-pot = kaffekande
cognac = cognac
cogwheel = tandhjul
cohabit = bo sammen
coir = kor
cold = kold, kulde, forkølelse
collar = flip
colleague = kollega
collect = samle
collection = gruppe, kollekt, samling
colony = koloni
colossal = kolossal
colour = farve, kulør
column = kolonne
comb = kæmme, kam
combination = kombination
combustion = forbrænding
come = afstamme, komme
come about = blive, ske, forekomme, ske
come across = møde, træffe
comedy = komedie
come to a halt = standse
comfort = komfort, trøste
comfortable = bekvem, komfortabel
comforter = støvsuger
comic = komisk, sjov
comical = komisk, sjov
comma = komma
command = befaling, kommando
commence = begynde
commencement = begyndelse
commend = rose, anbefale
commerce = handel
committee = komité
commodity = artikel
common = fælles, almindelig, ordinær, vanlig, sædvanlig, vulgær
communication = beretning, bekendtgørelse
communication-cord = nødbremse
companion = kammerat, samlever
company = firma, kompagni, selskab
compare = jævnføre, sammenligne
comparison = sammenligning
compartment = afdeling, fag, kupé
compass = kompas
compassion = medlidenhed
compatriot = landsmand
compel = tvinge
compensate = belønne
compensation = belønning
compete = konkurrere
competition = konkurrence
complain = klage
complaint = besvær
complete = fuldstændig, fuld
composer = komponist
composing = montage
comprise = indeholde
compulsory = nødt
comrade = kammerat
concave = hul
conceal = gemme, skjulle
concede = indrømme
conceited = forfængelig
concentrated = tæt
concept = begreb, opfattelse
concern = angå, koncern, sorg
concerned = pågældende
concerning = verdrørende, af, om, over, til, vid
concert = koncert
concert-room = koncertsal
conclusion = resultat, udfald
concord = akkord
concrete = beton
concurrence = akkord
condemn = dømme
condition = betingelse, tilstand
condolences = deltagelse
condom = kondom
conduct = føre, opførsel
conduct oneself = opføre sig
conductor = chauffør, fører
confectionery = konditori
confess = bekende, skrifte, tilstå
confession = bekendelse, skriftemål
confidence = tillid
confine = indskrænke
confirm = bekræfte
conform = passe
confuse = forvirre
confusion = rod
congratulate = gratulere, lykønske
congregate = forsamles
congress = kongres
connect = forbinde, koble til, binde
connection = forbindelse
connect up = forbinde, koble til
conquer = erobre
consciousness = bevidsthed
consent = samtykke, enighed
consequence = følge
conservative = konservativ
conserve = beholde, konservere
consider = tage hensyn til, betragte, se på
consignee = modtager
consistency = følge
consolation = trøst
console = trøste
constant = stadig
construct = bygge, konstruere
consul = konsul
consulate = konsulat
contact = kontakt
contain = indeholde
container = beholder, potte
contempt = foragt
contented = tilfreds
contention = påstand
contents = indhold
continent = fastland, kontinent, verdensdel
continual = stadig
continuation = fortsættelse
continue = vare, fortsætte
continuous = uafbrudt
contractor = bygmester
contradistinction = modsætning
contrary = modsat
contrast = modsætning
contribute = bidrage
control = styre, beherske, regere
control oneself = beherske sig
convention = kongres
converge = løbe sammen
conversance = bekendtskab
conversation = konversation
conversion = ændring
conviction = overbevisning
convince = overbevise, overtyde
co-occupant = samlever
cook = koge, kokkepige
cookie = kiks
cool = afkøle, kølig
cool down = afkøle
cooling = afkøling
Copenhagen = København
copper = kobber
copy = eksemplar, afskrive, kopiere, kopi
cord = reb, snor
cordial = hjertelig, hjerte-
core = kærne
cork = prop
corkscrew = proptrækker
corn = majs
corner = hjørne
corporation = fagforening
corpulent = tyk
corral = hestestald
correct = korrigere, rette, rigtig
corridor = gang, korridor
corridor train = eksprestog
corroborate = bekræfte
cost = koste
costly = dyr, værdifuld
costume = dragt
cotton = bomuld
cotton-wool = vat
couch = sofa
cough = hoste
counsel = advokat, sagfører, råde, råd
count = greve, beregne, kalkulere, tælle
countermand = abbestellen, sende afbud
count in = addere
country = land
countryside = land
coupé = kupé
couple = ægtepar
coupon = kupon
courage = mod
courageous = modig, tapper
courier = ilbud
course = kursus, fad
court = elske, gårdsplads
courteous = høflig
courtyard = gårdsplads
cousin = kusine, fætter
cover = indbinding, dække, låg, gennemse
cow = ko
cowardice = fejghed
crab = krabbe
crack = spalte
cradle = fødested
crawl = krybe
crayfish = krebs
crazy = sindssyg
cream = fløde
credit = kredit
creep = krybe
crevice = spalte
crew = mandskab
crime = forbrydelse
criticism = kritik
criticize = kritisere
crockery set = service
crocodile = krokodille
cross = vred, kors
cross roads = korsvej
crow = krage
crowd = mængd
crown = krone
crucifix = krucifiks
cruel = grusom
crush = knuse
cry = råb, græde
cry out = skrige
crystal = krystal
cube = terning
cuckoo = gøg
cucumber = agurk
cuff = manchet
culture = kultur
cultured = klog
cup = kop
cupboard = skab
cure = behandle
curious = nysgerrig
currant = ribs, solbær
currency = valuta
current = aktuel, strøm, nærværende
currently = nu for tiden, nu til dags
curse = bande
curtail = forkorte
curtain = gardin
curve = sving
curved = bøjet
cushion = pude
cuss = bande
custom = vane, sædvane
customary = almindelig, vanlig, sædvanlig
customer = kunde
customs = told
cut = slå, afbryde, koble fra, klippe, skære
cut a connection = afbryde, koble fra
cutlet = karbonade
cycle = cykel
cylinder = cylinder
cynical = kynisk
cypres = cypres
dabbler = amatør
dagger = dolk
dahlia = georgine
daily = daglig
daily paper = avis
dairy = mejeri
damage = skade, beskadige, defekt
dame = dame
damn = fordømme
dance = bal
dancer = danserinde, danser
Dane = dansker
danger = fare
dangerous = farlig
Danish = dansk
Danish woman = dansker, dansk kvinde
dare = turde, vove
dark = mørk
darkness = mørke
data = materiale
date = daddel, dato, aftale, rendezvous
daughter = datter
daughter-in-law = svigerdatter
dawn = daggry
day = dag
daybreak = daggry
dazzle = blænde
dead = død
deadly = dødelig
deaf = døv
deaf and dumb = døvstum
deal with = behandle
dean = dekan
dear = sød, dyr, værdifuld
death = død
debate = debat
debris = skrald
debt = gæld
decay = forfald
deceive = bedrage
December = december
decide = afgøre, beslutte
decider = finale
decision = beslutning
deck = dæk
declaration = angivelse, opgivelse
declaration of policy = program
declare = erklære
décor = dekoration
decoration = dekoration
deduce = slutte
deem = tro, mene, synes, betragte, se på
deep = dyb
defeat = nederlag, besejre
defence = forsvar
defend = forsvare
defense = forsvar
deficit = deficit
defy = provokere, udfordre
degree = grad, titel
delay = udsætte
delegate = delegeret
delegation = delegation
deliberately = forsætligt
delight in = nyde
deliver = aflevere
delivery = leverance, levering, aflevering
demand = fordre
democracy = demokrati
democratic = demokratisk
den = rede
Denmark = Danmark
denounce = angive, forråde
dense = tæt
dentist = tandlægge
deny = nægte, benægte
depart = afgå, afrejse, go ud, rejse bort
department = afdeling, fag
departure = afgang, afrejse
depend = afhænge
dependant on = afhængig af
dependence = afhængighed
dependent = afhængig
depend onldepend upon = afhænge af
deportment = opførsel
depository = lager, skur
depressed = deprimeret, nedtrykt
depth = dybde
deputy = delegeret
derive = afstamme
describe = beskrive
description = beskrivelse
desert = udørken, forlade
deserve = fortjene
design = tegning, tegne, plan
desire = ønske
desk = skrivebord
despair = fortvivle, fortvivlelse
desperate = desperat
despise = foragte
dessert = dessert
destine = bestemme
destiny = bestemmelse
destroy = ødelægge
destruction = ødelæggelse
detached house = villa
detachment = afdeling
detail = enkelthed
detain = opholde
detective = detektiv
determine = befæste, fassætte
detrimental = ufordelagtig
develop = udvikle
development = udvikling
device = apparat
devil = djævel
dew = dug
diagram = figur, plan
dial = diskos, skive
dialect = dialekt
diameter = diameter
diamond = diamant
diarrhoea = diarré
dictionary = ordbog
die = dø
diet = diæt
difference = forskel
different = forskellig
differentiate = skelne
difficult = vanskelig
dig = grave
digest = fordøje
digestion = fordøjelse
dike = dige, dæmning
dilettante = amatør
diligent = flittig
dim = mørk
dimension = størrelse
diminutive = lille
din = larm
dining-room = spisestue, spisesal
dinner = middag
diploma = aktstykke
direct = styrre, lige
direction = retning
director = bestyrer, direktør
directory = katalog
dirty = snavset
disabled person = invalid
disadvantage = ulempe
disagreeing = uenig
disagreement = uenighed
disappear = forsvinde
disappearance = forsvindelse
disappoint = skuffe
disappointment = skuffelse
disc = diskos, skive
discharge = affyre, afskedige
disciple = tilhænger
discipline = disciplin
discontented = utilfreds
discord = uenighed
discover = afsløre, opdage
discovery = afsløring, opdagelse
discrete = beskeden
discuss = behandle
discussion = diskussion, drøftelse
disease = sygdom
disgust = væmmelse
dish = fad
dish cloth = viskestykke
dishwasher = opvaskemaskine
disinfect = desinficere
dislike = modvilje, ikke at kunne lide
dismal = afskyelig, ubehagelig, mørk, bedrøvet, trist, sur
dismayed = forfærdelig, rædsom
dismiss = afskedige, afsende
disorder = rod
dispatch = afsende
display = parade
displeased = utilfreds
disposal = tendens
dispose of = sælge
disposition = talent
dispute = skænderi
dissatisfied = utilfreds
dissension = uenighed
dissolve = opløse
distance = afstand
distant = afsides
distinct = klar, tydelig
distraction = rekreation
distribute = fordele
distribution = fordeling
distributor = fordeler
district = distrikt, bydel, kvarter
distrust = mistro
disturb = hindre, forstyrre
divan = sofa
dive = dykke, synke
diversion = rekreation
divide = adskille, dele
divine = guddommelig
divorce = skilsmisse
divorced = fraskilt
do = aflægge, gøre, lave
do away with = afskaffe, fjerne
do business = handle
dock = dok
doctor = doktor, læge
document = aktstykke, dokument
dog = hund
dolphin = delfin
domestic animal = husdyr
donkey = æsel
don't mention it = det gør ikke noget
door = dør
dose = dosis
dot = punkt
double = dobbelt, fordoble
doubt = tvivle, tvivl
dove = due
down = dun, ned, ned ad
downstairs = derunder, nede, forneden
dozen = dusin
drag = trække
drain-pipe = afløb, afløbsrør
drama = drama
draw = tegne, trække
drawer = skuffe
drawers = underbukser
drawing = tegning
dreadful = forfærdelig, rædsom, skrækkelig
dream = drømme
dreary = afskyelig, ubehagelig, mørk, bedrøvet, trist
dress = kjole, klæde sig
dresser = kommode, køkkenbord
drill = bore
drink = drik, drikke
drive = køre
drive away = afrejse
drive off = afrejse
driver = chauffør, fører
driving-licence = kørekort, køretilladelse
droop = hænge
drop = falde
drown = drukne
drowsy = søvnig
drug = droge, lægemiddel, medicin, medikament
drugstore = apotek
drunk = beruset, drukken, fuld
dry = tør, tørre
dryness = tørhed
dual = dobbelt
duchy = hertugdomme
duck = and
dull = sløv, stump
dumb = stum
dumbfounded = forfærdelig, rædsom
dummy = støvsuger
dump = strø
dung = lort
duplicate = multiplicere
during = imitlertid
dusk = tusmørke
dust = støv, støve af
dust rag = viskestykke
dusty = støvet
Dutch = hollandsk, nederlandsk
Dutchman = hollænder
duty = pligt
dwarf = dværg
dwell = bo
dwelling = bolig
dwelling-place = bopæl, sted
dwelling-place-residence = bopæl, sted
dye = farve, kulør
dynamite = dynamit
each = al, hver
each other = hinanden
eagle = ørn
eagle owl = hornugle
ear = øre
earl = greve
early = tidlig
earmark = bestemme
earn = tjene, fortjene, vinde
earnest = alvorlig
earring = ørering
earth = jord
earthquake = jordskælv
easel = bænk
east = øst
Easter = påske
eastern = orientalsk, østlig
easy = let, nem
eat = æde, spise
echo = ekko
edge = bred, kant, rand
edging = kant, rand
edible = spiselig
edition = oplag
editor = redaktør
educate = opdrage
educated = klog
education = opdragelse, undervisning
eel = ål
effect = resultat, udfald
effort = forsøg
egg = æg
eggfruit = aubergine
eggplant = aubergine
Egyptian = ægyptisk
eight = otte
eighteen = atten
eighteenth = attende
eighth = ottende
eighty = firs
elastic = elastisk
elbow = albue
elder = hyld
elect = vælge
election = valg
electric = elektrisk
electric fan = ventilator
electricity = elektricitet
electric plug = stik
electric socket = stikkontakt
electronic = elektronisk
elegant = elegant
element = element, fundament
elemental = elementær
elementary = elementær
elephant = elefant
elevator = elevator, lift
eleven = elleve
eleventh = elvte
elm = elm
Elsass = Alsace, Elsass
else = mere
elsewhere = andetsteds, ellers
embankment = dige, dæmning
embassy = ambassade
embassy building = ambassade
emblem = emblem
embrace = give et knus, omfavne
emerald = smaragd
emissary = bud, gesandt
emmet = myre
emotion = fornemelse, følelse
emperor = kejser
emphasize = lægge vægt på, understrege
empire = kejserrige
employ = benytte, bruge, tilbringe
empty = tom, tømme
encounter = møde, træffe
encourage = opmuntre
end = fuldende, endelse, ende
endeavour = bestræbe sig
ending = ende
end up = ankomme
endure = vare, gennemgå, tåle
enemy = fjende
energetic = energisk
energy = energi
engagement = forlovelse
engine = lokomotiv, maskine, motor
engineer = ingeniør
England = England
English = engelsk, englænderinde
English language = engelsk
Englishman = englænder
Englishwoman = englænderinde
enjoy = nyde
enjoyable = behagelig, rar
enmity = fjendskab
enormous = enorm
enough = nok, tilstrækkelig
enter = indtaste
entertaining = morsom
entertainment = underholdning
enthusiasm = begejstring
entire = hel
entirely = helt
entomb = begrave
entrance = indgang
envelope = konvolut
envious = misundelig
environment = omgivelse
environs = omgivelse
envoy = bud, gesandt
envy = misunde, være misundelig, være misundelig på, misundelse
epoch = epoke
equal = lig
equilibrium = ligevægt
equivalent = surrogat
era = epoke
erect = oprette
erecting = montage
err = tage fejl
errand = beretning
error = fejl
escape = undfly, undkomme
establish = oprette
estate = bondegård, gård
esteem = agte, agtelse, tage hensyn til
estimate = bedømme, vurdere
ether = æter
Europa = Europa
Europe = Europa
European = europæisk, europæer
European Union = Europæisk Union
evade = undgå, undvige
evangelic = evangelisk
evaporate = lade fordampe, fordampe
even = flad, lig, selv, kvit, lige, regelmæssig
evening = aften
evening meal = aftensmad
evening paper = aftenavis
evening twilight = skumring
event = tildragelse, anledning, lejlighed
ever = nogensinde, altid
everlasting = uoverskuelig
ever since = siden
every = al, hver
everybody = al, hver
everyday = vulgær
every one = al, hver
everything = all
everywhere = overalt
evolution = udvikling
evolve = udvikle
exact = rigtig
exaction = pengeafpresning
exaggerate = overdrive
examination = undersøgelse
examine = undersøge
example = eksempel
exceed = overgå
exception = undtagelse
excite = oprøre
exciting = spændende
exclusive = udelukkende
exclusively = udelukkende, bare, blot, kun
excrement = lort
excuse = undskylde
excuse me = om forladelse, undskyld, undskyld mig
exercise = øve, øvelse
exert = praktisere
exhibit = udstille
exhibition = undstilling
exile = eksil
exist = eksistere
existence = eksistens
exit = udgang, gå ud, stige ud
expansion = udvidelse
expect = forvente
expectation = forventning
expenses = udgift
expensive = dyr, værdifuld
experience = erfaring, oplevelse, gennemgå
experiment = eksperiment
expire = dø
explain = forklare
explanation = forklaring
explode = eksplodere
exploit = udbytte
exploration = undersøgelse
explore = undersøge
explosion = eksplosion
exposition = undstilling
expression = udtryk
express oneself = udtrykke sig
expressway = bilvej
extend = størrelse
extensive = rummelig
external = ydre
extinguish = slukke, udslukke
extortion = pengeafpresning
extra = ekstra
extreme = ekstrem
eye = øje
eyebrow = øjenbryn
eyelid = øjenlåg
fable = fabel
fabricate = fabrikere
façade = facade
face = ansigt
facile = let, nem
fact = faktum
faction = parti
factory = fabrik
factual = virkelig
faculty = fakultet
failure = abort
faint = svag
fair = basar, torv, blond, retfærdig
faith = tillid
faithful = tro
falcon = falk
fall = falde, fald
fall in love with = forelske sig
false = falsk, usand
familiarity = bekendtskab
family = familie
famous = berømt
fancier = amatør
fancy = forestille
fantasy = fantasi
far = afsides
farewell = farvel, ha' det godt, afsked
farm = bondegård, gård
farmer = bonde, landmand
farther = videre
fashion = mode
fast = fast, hurtig, hurtigt
fasten = befæste, fassætte
fast train = iltog
fat = tyk, fed, fedt
fate = bestemmelse
father = fader, far, pater
father-in-law = svigerfar
fatherland = fædreland
fatty = fed
faucet = hane
fault = skyld
favourable = gunstig
fear = angst, rædsel, være bange, være bange for
feast = festmåltid
feather = fjeder, fjer
February = februar
feed = æde, spise, fodre, nære
feel = følelse
feeling = følelse
feign = lade som om, foregive
felloe = fælg
fellow = mand
felly = fælg
felt = filt
female = kvindelig
female cook = kokkepige
feminine = kvindelig
fence = indhegning
fennel = fennikel
fern = bregne
fertile = frugtbar
fertilizer = gødning
fervor = iver
fervour = iver
festival = fest, højtid
fetch = bringe, hente
fever = feber
fewer = mindre
fiancé = forlovede
fiancée = forlovede
field = mark
field hospital = ambulance
fifteen = femten
fifteenth = femtende
fifth = femte
fifty = halvtreds, halvtredsindstyve
fig = figen
fight = kæmpe, slås
figure = figur, beregne, kalkulere
file = fil
files = arkiv
fill = fylde
fillet = bind
fill in = fylde
fill up = fylde
film = film
filter = filtrere, filter
filthy = snavset
fin = finne
finally = endelig
find = finde
find oneself = forekomme, ligge
find out = høre, afhøre
fine = skøn, smuk, bøde
finger = finger
finish = fuldende
finished = færdig
Finland = Finland
Finn = finne
fir = rødgran
fire = affyre, afskedige, ild, skyde
fire off = affyre
fireplace = skorsten
firm = fast, firma
firm in one's principle = principiel
firm in one's principles = principiel
first = første, først
first aid = førstehjælp
firstly = først
first name = fornavn
first of all = først
fish = fiske, fisk
fishing rod = medestang
fist = næve
fit = passe
fit in = passe
fitter = montør
fitting up = montage
fit together = stemme overens
five = fem
fix = befæste, fassætte, reparere
fixed = fast
fix up = indrette, ordne
flag = flag, fane
flame = flamme
flannel = flonel
flask = feltflaske
flat = appartement, lejlighed, flad
flat-iron = strygejern
flatter = smigre
flavour = aroma
flax = hør
flea = loppe
flee = undfly, undkomme, flygte
fleet = flåde
flesh = kød
flight = flugt
fling = svinge
float = svømme
flood = flod
floor = etage, sal, gulv
flour = mel
flow = flyde, strøm
flower = blomst
flowerpot = urtepotte
flu = influenza
fluff = dun
fluid = flydende, vædske
flute = fløjte
fly = flyve, flue
foam = skumme, skum
focus = brændpunkt
fog = tåge
fold = folde, fold
folk = folk
follow = følge
following = fålgende, næste
fondle = stryge
food = mad, næring
foolish = dum
foot = fod, pote
football = amerikansk fodbold
for = imitlertid, fordi
forbid = forbyde
force = tvinge, kraft
fore- = primitiva
forecast = forudsige
forehead = pande
foreign = udenlandsk, fremmed
foreign country = udland
foreigner = udlænding
foresee = forudse
forest = skov
foretell = forudsige
foreward = fremad
forget = glemme
forgive = tilgive
form = danne, form, formular
former = forbigangen
formerly = forhen
formula = formel
for nothing = gratis
for rent = til leje
forsake = forlade
for sale = til salg
for the reason that = fordi
fortification = fæstning
fortify = forstærke
fortnight = fjorten dage
fortunate = lykkelig
forty = fyrre, fyrretyve
found = oprette
foundation = fundament, grund
fountain = fontæne, kilde
fountain-pen = fyldepen
fountain pen = fyldepen
four = fire
fourteen = fjorten
fourteenth = fjortende
fourth = fjerde, fjerdedel
fowl = høne
fox = ræv
fragile = skør
fragment = brud, brudstykke
France = Frankrig
free = fri, gratis
freedom = frihed
freemason = frimurer
freeway = bilvej
freeze = fryse
freezing cold = frost
French = fransk
French language = fransk
Frenchman = franskmand
Frenchwoman = fransk kvinde
frequently = ofte, tit
fresh = frisk
fresh water = ferskvand
Friday = fredag
friend = veninde, ven
friendly = flink, venlig, venskabelig
friendship = venskab
fright = angst, rædsel
frighten = forskrække
fringe = kant, rand
frivolous = forfængelig
frog = frø
from = af, for, om, siden, på, til, ud
from here = herfra
from there = derfra
from where = hvor ... fra
frontier = grænse
frost = frost
froth = skumme, skum
fruit = frugt
fruitful = frugtbar
frying-pan = stegepande
frying pan = stegepande
fuel = brændsel
full = fuld
full-grown = myndig, voksen
fume = uddunstning
fun = fornøjelse
function = fungere, funktion, embede
fungus = svamp
funny = morsom, komisk, sjov
fur = skind, pels
fur coat = pels
furious = rasende
furnace = ovn
furnish = aflevere
furnished = møbleret
furniture = indbo, møbler
furniture van = flyttevogn
fur piece = pels
furrow = fold, læg
further = videre, mere
furthermore = desuden, videre
fuse = væge
future = fremtidig, fremtid
gadfly = bremse
gain = erhverv, tjene, fortjene, vinde
gallery = galleri
gallop = galop
game = leg, spil
gang = bande
gangster = gangster
gangway = landgang
gaol = fængsel
garage = garage
garbage can = skraldespand
garden = have
gardener = gartner
gargle = skylle
garland = guirlande
garlic = hvidløg
garment = beklædning
garrison = garnison
gas = gas
gasolene = benzin
gasoline = benzin
gas tank = benzintank
gate = port
gateway = port
gather = slutte, samle, forsamles
gathering = forsamling
gaunt = mager, tynd, bedrøvet, trist
gay = alvorlig, munter
gazette = avis
gear = tandhjul, gear
general = almindelig, generel
generally = som regel
generation = generation
generative = seksuel
generous = gavmild
gentian = ensian
gentle = sød, mild
gentleman = herr, herre
genuine = ægte
genuinely = faktisk
geography = geografi
geology = geologi
geometry = geometri
German = tysk, tysker
German language = tysk
Germany = Tyskland
get = ankomme, hente, blive, gribe, tage, tage op, få, modtage
get a divorce = lade sig skille, skilles
get cold = afkøle
get divorced = lade sig skille, skilles
get married = gifte sig
get out = stige ud
get out of a car = stige ud
get rid of = afskaffe, fjerne
get up = stå op
ghastly = afskyelig, ubehagelig
ghost = ånd
gift = gave
gill = gælle
giraffe = giraf
girder = bjælke
girdle = bælte
girl = pige
give = give, forestille, præsentere, servere, udføre
give an account = meddele
give a ring = ringe, ringe på
give as an excuse = foregive
give in = give efter
give notice = avertere
give off an odour = lugte
give up = give efter
give way = give efter
glad = glad
gladness = glæde
glass = glas
glasses = briller
glorify = rose
glorious = berømt
glove = handske
glow = ild
gnat = myg
go = gå, fare, køre
goal = hensigt, mål, formål
goat = ged
go away = afgå, afrejse, go ud, rejse bort
goblet = bæger
god = gud
God's acre = kirkegård
go fast = skynde sig
go in = indtaste
gold = av guld, guld
gold-coloured = gylden
golden = av guld, gylden
goldfish = guldfisk
goldsmith = guldsmed
golf = bugt, golf
good = god
good afternoon = goddag
goodbye = farvel, ha' det godt, afsked, farvel så længe, på gensyn, vi ses
good-bye = afsked
good day = goddag
good evening = godaften
good health = skål
good-hearted = godhjertet
good morning = godmorgen
good-natured = flink, venlig
good night = god nat
go on = fortsætte
goose = gås
gooseberry = stikkelsbær
go out = gå ud, stige ud
gossip = sludre, snakke
go through = gennemse
go to bed = gå i seng
goulash = gullasch
govern = lede, beherske, regere
government = regering
gown = kjole
grab = gribe
grade = grad
gradually = efterhånden, gradvis
gram = gram
grammar = grammatik
gramme = gram
granddaughter = barnebarn
grandfather = bedstefader
grandmother = bedstemoder
grandparents = bedsteforældre
grandson = barnebarn
granite = granit
grant = indrømme
grape = vindrue
grapefruit = grapefrugt
grapevine = vinstok
grapple = fange
grasp = gribe
grass = græs
grasshopper = græshoppe
grate = hæk
grateful for = taknemlig for
gratis = gratis
gratitude = taknemmelighed, tak
graveyard = kirkegård
gravy = sauce
grease = fedt
greasy = fed
great = stor
Great Britain = Storbritannien
greatgrand- = primitiva
Greece = Grækenland
Greek = græsk, græker
Greek woman = græsk kvinde
green = grøn
greet = hilse, sige goddag
greeting = hilsen
grenade = granat
grey = grå
grid = hæk
grill = hæk
grimace = grimasse
grind = male
grip = gribe, influenza
grisly = ubehagelig
groan = stønne
groschen = skilling
grotesque = grotesk
grotto = grotte
ground = grund, terræn
ground-floor = stueetage
grounds = terræn
group = gruppe
grow = blive, ske, vokse
growl = brumme, knurre
grown-up = myndig, voksen
growth = vækst
grub = grave
gruel = grød, vælling
gruesome = forfærdelig, rædsom, skrækkelig
gruff = uvenlig
grumble = brumme, knurre
guarantee = garantere, sikre, garanti
guard = passe, konduktør
guess = gætte, antage, tro
guest = gæst
guide = styrre, føre
guilder = gylden
guilt = skyld
guiltless = uskyldig
guilty = skyldig
guitar = guitar
gulden = gylden
gulf = afgrund, bugt, golf
Gulf of Bothnia = Botniske Bugt
gum = tandkød
gun = gevær, bøsse
gymnastics = gymnastik
gypsy = sigøjner
habit = vane, sædvane
hail = hagl
hair = hår
hairdresser = frisør
hairpiece = paryk
half = halvdel
hall = entré
halt = standse, stoppe
ham = skinke
hammer = hammer
hand = arbejder, hånd
handicraft = stilling
handkerchief = lommetørklæde
handle = behandle
handlebars = ror
handshake = håndtryk
handsome = skøn, smuk
hang = hænge, hænge op
hangings = tapet
hang onto = bevare, holde
happen = blive, ske, forekomme
happiness = lykke
happy = lykkelig, glad
harbor = havn
harbour = havn
hard = hård, vanskelig
hardly = knæppe
hardness = hårdhed
hardworking = flittig
hare = hare
harmful = skadelig
harmonize = stemme overens
harsh = uvenlig
harvest = høste, høst
hashish = hashish
haste = hast
hat = hat
hate = hade, had
haul = trække
have = have, få, modtage
have a subscription = abonnere
have bad luck = være uheldig
have compassion on = have medlidenhed, have medlidenhed med
have effect = virke på
have faith = have tillid til
have faith in = have tillid til
have good luck = være heldig
have got = have
have to = måtte, skulle
hay = hø
hazard = tilfælde, riskere, risiko
hazardous = risikabel
hazelnut = hasselnød
he = han
head = hoved
headache = hovedpine
heading = titel
head of a department = afdelingschef
head of department = afdelingschef
head up = lede
health = sundhed
healthy = rask, sund
heap = mængd, gruppe
hear = høre, afhøre
hearing = hørelse
heart = hjerte
heart- = hjerte-
hearth = pejs, skorsten
hearty = hjertelig, hjerte-
heat = ild, hede
heath = hede
heaven = himmel, himmerig
heavy = tung
heel = hæl
height = højde
helix = skrue
hello = hallo, dav, davs, goddag, hej
helm = ror
help = hjælp, hjælpe
helper = assistent
hen = høne
hence = herfra
her = sin, sit, hun, hendes, hende
herb = græs
herd = gruppe
here = herhen, hid, her
hero = helt
heroin = heroin, heltinde
heroine = heltinde, heroin
heron = hejre
herring = sild
herself = selv
hesitate = tøve
hiccup = nulke
hide = skind, gemme, skjulle, skjule sig
hide oneself = skjule sig
hideous = afskyelig
high = høj
high school = gymnasium
high tide = flod
hill = bakke
hillside = skrænt
him = han, ham
himself = selv
hind = sidste
hinder = hindre, forhindre, forstyrre
hindmost = sidste
hip = hofte
hire = hyre, leje
his = hans, sin, sit
history = historie
hit = slå, banke
hither = herhen, hid
hobby = hobby
hockey = hockey
hoe = hakke
hog = gris, svin
hold = lastrum, bevare, holde
hold back = opholde
holder = bestik
hole = hul
Holland = Holland, Nederlanderne
Hollander = hollænder
hollow = hul
home = hjem
homy = hyggelig
honest = ærlig
honey = honning
honour = ære
hood = motorhjælm, låg
hoodlum = gangster
hoof = hov
hook = medekrog
hooker = skøge
hooter = signalhorn, horn
hope = håbe, håb
horizon = horisont
horn = horn, signalhorn
horoscope = horoskop
horrible = afskyelig, ubehagelig, forfærdelig, rædsom, skrækkelig
horror = afsky
horse = hest
horse-chestnut = kastanie
horse-fly = bremse
horsepower = hestekraft
horseradish = peberrod
horse-radish = peberrod
hospitable = gæstfri
hospital = hospital
hospitality = gæstevenskab
hostel = herberg, kro
hot = hed
hotel = hotel
hour = time
house = hus
housefly = flue
house of worship = kirke
house-owner = husejer
housewife = husmoder
how = hvordan
how many = hvor meget
how much = hvor meget
hug = give et knus, omfavne
huge = kolossal
human = menneskelig
human being = menneske
human race = menneskehed
humour = humør
hump = pukkel
hundred = hundrede
Hungarian = ungarer
Hungary = Ungarn
hunger = sult
hungry = sulten
hunt = jage
hunter = jæger
hurry = skynde sig
hurt = såre
husband = ægtefælle, mand, ægtemand
husk = bark
hut = hytte
hygienic = hygiejnisk
hysterical = hysterisk
ice = is
icecream = is
Iceland = Island
Icelander = islænding
Icelandic = islandsk
idea = begreb, idé, opfattelse
ideal = ideal
identify = identificere
identity = identitet
idiot = idiot, tosse
idol = afgud
ignition = tændling
ill = syg
illness = sygdom
illuminate = oplyse
illusion = indbildning
image = afbildning, billede, figur
imagine = forestille
imitate = efterligne
imitation = efterligning, imitation
immediately = straks
impartial = neutral, unpartisk
impatient = utålmodig
impertinent = fræk
impetus = tilstrømning
imply = betyde
import = importere, indføre
important = vigtig
impression = indtryk
impulse = tilstrømning
in = i, om, på
in action = aktiv
in addition = desuden, videre
incendiary bomb = brandbombe
incest = blodskam
incite = provokere, udfordre
inclination = tendens
incline = bøje
include = indeholde, indeslutte
income = indkomst
inconvenient = vanskelig
increase = tiltagende
increasingly = mer og mer
incus = ambolt
indeed = faktisk
independant = selvstændig, uafhængig
index = tabel
India = Indien
Indian = inder, indianer
Indian corn = majs
indicate = angive, vise
indication = betegnelse
indispensable = uundværlig
indistinct = utydelig
individual = individuel, individ
induce = slutte
industrious = flittig
industry = flid, industri
in easy circumstances = velhavende
in exchange for = imod
inexpensive = billig
in fact = faktisk
infant = barn
infantry = infanteri
infect = smitte
infer = slutte
inflate = opblæse
inflation = inflation
influence = indflydelse
influenza = influenza
inform = meddele
information = information
in front of = før
inhabitant = beboer, indbygger
inherit = arve
inheritance = arv
inhibit = forhindre, hindre
initial = forbogstav
injection = injektion
injure = beskadige
injury = sår
ink = blæk
inn = herberg, kro
inner = indre
inner tube = slange
innocence = uskyld
innocent = uskyldig
in no way = ingenlunde
in question = pågældende
inquiry-office = oplysningskontor
inquisitive = nysgerrig
insane = sindssyg
inscription = timelding
insect = insekt
inside = i, om, på, indre, indenfor
inspection = inspektion
install = indrette
installment payment = afbetaling
instant = øjeblik
instantly = straks
institution = institution
instructor = lærer
insult = fornærme, skælde
insurance = forsikring
intellect = fornuft
intelligent = intelligent
intend = sigte
intention = hensigt
inter = begrave
intercessor = advokat, sagfører
interchange = udskifte
interest = interesse
interesting = interessant
intermission = pause
internal = indre
international = international
international express = eksprestog
international express train = eksprestog
interpreter = tolk
interrupt = afbryde
interruption = afbrydelse
interview = interview
intestine = tarm
intestines = involde
in the evening = om aftenen
intimate = intim
in time = i tide, rettidigt
into = i, om, på
intolerant = intolerant
intoxicated = beruset, drukken, fuld
introduce = forestille, præsentere, servere, udføre
in vain = forgæves
invasion = invasion
invective = skældsord
invent = opfinde
invention = opfindelse
inverted comma = anførelsestegn
investigate = undersøge
investigation = undersøgelse
invitation = indbydelse
invite = indbyde, invitere
in what way = hvordan
Ireland = Irland
Irishman = irlænder
iron = jern-, jern, strygejern
ironic = ironisk
island = ø
issue = udgive
it = den, det
Italian = italiener
Italy = Italien
it doesn't matter = det gør ikke noget
its = sin, sit, dens, dets
itself = selv
ivory = elfenben
ivy = vedbend
jack = donkraft
jail = fængsel
jam = marmelade
January = januar
Japan = Japan
Japanese = japaner
jaw = kæbe
jawbone = kæbe
jealous = misundelig, jaloux
jealousy = skinsyge
jest = spøge
jewel = ædelsten
jeweller = juvelér
jingle = ringe
job = arbejde, embede, opgave
jog = jogge
join = binde, forene
joint = fælles
joke = spøge
journal = avis
journalist = journalist
journey = rejse
joy = glæde
joystick = rat
jubilee = jubilæum
judge = dømme, dommer
judgment = dom
jug = kande, beholder, potte
juice = saft
July = juli
jump = springe, spring
June = juni
jungle = jungle
jurist = jurist
jury = jury
just = retfærdig, bare, blot, kun, straks
justice = retfærdighed
Jutland = Jylland
Jutlander = jyde
keel = køl
keen = livlig
keep = avle, passe, beholde, konservere, redde
keep house = holde hus
keep on = vare
keepsake = souvenir
kernel = kærne
kettle = kedel
key = nøgle
kick = sparke, spark
kill = dræbe
kiln = ovn
kilo = kilo, kilogram
kilometre = kilometer
kind = flink, venlig, godhjertet, art, slags
kindle = tænde
king = dame, konge
kiss = kysse, kys
kitchen = køkken
klaxon = horn, signalhorn
knee = knæ
kneel = knæle
knife = kniv
knock = banke
knot = knytte, knude
know = kende, vide
know how = vide
knowledge = kundskab
label = etiket
laboratory = laboratorium
laborer = arbejder
labourer = arbejder
labour-union = fagforening
lack = savne, mangel
lacquer = fernis
lad = dreng
ladder = stige
laddie = dreng
lady = dame, fru, frue
lake = sø
lamb = lam
lamp = lampe
land = lande, land, jord
landscape = landskab
lane = stræde
language = sprog
larch = lærk
large = stor
lass = pige
last = forbigangen, vare, sidst
lasting = uafbrudt
last night = i går aftes, sidste nat
late = sen, sent
lathe = drejebænk
Latin = latinsk
laud = rose
laugh = le
laugh at = udle
laughter = latter
laundry = vaskerj
lava = lava
law = lov
lawn = græsplæne
lawsuit = proces
lawyer = advokat, sagfører, jurist
lay = lægge
lay down = lægge, stille, sætte
layer = aflægger
lay hold of = gribe, tage, tage op
lay out = sprede
lazy = doven
lead = føre, bly
leader = chef, leder
leaf = blad
leaflet = brochure
lean = støtte, læne sig, mager, tynd
leap = springe, spring
leap-year = skudår
learn = lære
learned = klog
learn of = høre, afhøre
lease = lejekontrakt
leasurely = langsomt
leather = læder
leave = afgå, afrejse, go ud, rejse bort, forlade, løslade
leave behind = efterlade
leave out = udelade
leaving examination = afgangseksamen
lecture = lektion, foredrag
leek = hvidløg
left = venstre, til venstre
leg = ben
legal = legal
legation = legation
lemon = citron
lemonade = limonade
lend = låne, løne
length = længd
lentil = linse
leprosy = spedalskhed
less = mindre
less and less = mindre og mindre
let = løslade, udleje
let know = meddele
letter = brev, bogstav
letterbox = brevkasse
lettuce = salat, hovedsalat
level = flad, lig, niveau
level-crossing = togoverskæring
lever = løfte
liberal = liberal
library = bibliotek
licence = tilladelse
license = tilladelse
lid = låg
lie = ligge, lyve, løgn
lie down = lægge sig
lieutenant = løjtnant
life = liv
lifebelt = redningsbælte
life-belt = redningsbælte
life-boat = redningsbåd
lift = løfte, elevator, lift
light = tænde, lys, let, oplyse, svag
lighthouse = fyrtårn
lightning = lyn
light-switch = kontakt
like = hvordan, lignende, kunne lide, sætte pris på, synes om
likely = sandsynlig
likewise = også
lilac = syren
lily = lilje
limb = medlem
lime = kalk
lime-tree = lind
limit = indskrænke, grænse
limp = halte
linden-tree = lind
line = medesnøre, linie
lineage = afstamning
lion = løve
lip = læbe
liqueur = likør
liquid = flydende, vædske
liquidate = dræbe
list = liste
listen = lytte, lytte til
liter = liter
literature = litteratur
litre = liter
litter = båre
little = lille
little by little = efterhånden, gradvis
live = bo, leve
live in lodgings = bo på værelse
liver = lever
livestock = kvæg
live through = gennemgå
live together = bo sammen
living alone = enlig
living-room = stue, dagligstue
lizard = firben
load = byrde, last
loaf = brød
loan = låne, løne, lån
loathe = afsky
lobster = languster, hummer
location = plads, sted
loch = sø
lock = lås, låse
locust = græshoppe
lofty = høj
logical = logisk
logical reasoning = fornuft
London = London
long = lang
long for = længsel, kræve
longing = længsel
look = se ud, syn, betragte, se på, blik
look after = passe, se after
look at = betragte, se på
look for = søge
looking-glass = spejl
loose = løs
lord = herr, herre
lorry = lastbil, lastvogn
loss = tab
lottery = lotteri
loud = høj
lounge = aula
louse = lus
love = elske, synes om, kærlighed, være vild efter
lovely = behagelig, rar, skøn, smuk, pragtfuld, sød, fortryllende
low = lav
lower-arm = underarm
low tide = ebbe
loyal = tro
luck = held
luggage = bagage
luggage-van = bagagevogn
lukewarm = lunken
lump = brud, brudstykke, masse, stykke
lung = lunge
lurid = skarp
lyric = tekst
machine = maskine
mackerel = makrel
mad = sindssyg
madam = fru, frue
magazine = avis, tidskrift
magnet = magnet
magpie = skade
maid = tjener, stuepige
mail = post, postvæsen
mailbox = brevkasse
mainland = fastland, kontinent, verdensdel
maintain = beholde, konservere
maize = majs
majority = flertal
make = aflægge, gøre, lave
make ... acquaintance = stifte bekendtskab med
make a mistake = tage fejl
make a project of = planlægge
make clean = gøre rent, rense
make fast = befæste, fassætte
make-up = make-up, sminke
make up = sminke, make-up
make use of = benytte, bruge, tilbringe
malaria = malaria
male = mandlig
male cat = hankat
man = menneske, mand
manage = styrre, holde hus
management = styre
manager = dirigent, bestyrer, direktør
mankind = menneskehed
manner = maner
manufacture = fabrikere
manure = gødning
many = mange
map = landkort
maple = ahorn
marble = marmor
march = gå, marchere
margarine = margarine
mark = mærke, mark, signal, tegn
market = basar, torv
marketplace = torv
marmelade = marmelade
marriage = ægteskab
married = gift
married people = ægtepar
marry = gifte sig, gifte sig med
martyr = martyr
marvel = blive forbavset, undre sig
marvel at = blive forbavset, undre sig
masculine = mandlig
mask = maskere, maske
mass = mængd, masse
massage = massere, massage
mast = mast
master builder = bygmester
match = tændstik
mate = parre sig
material = materiel, materiale
maternal aunt = moster
maternal uncle = morbror
mathematics = matematik
matrimony = ægteskab
matter = affære, anliggende, tilfælde, materie, stof
mattress = madras
mature = moden
maybe = mulighvis, måske
mayhap = mulighvis, måske
mayor = borgmester
me = mig
meadow = eng
meager = mager, tynd
meal = mel, måltid
mealies = majs
mean = gennemsnitlig, midte, betyde
meaning = hensigt, betydning
means = redskab, verktøj
measure = måle, mål
measurement = mål
meat = kød
mechanic = mekaniker
mechanics = mekanik
medical = medicinsk
medicine = lægemiddel, medicin, medikament
meditate = synes
meet = forsamles, møde, træffe
meet each other = mødes
meeting = forsamling
meet one another = mødes
melody = melodi
melon = melon
melt = smelte
melting = tøvejr
member = medlem, partifælle, tilhænger
memento = souvenir
memory = erindring, hukommelse
menace = true, trussel
mend = reparere
mention = omtale
menu = menu, spiseseddel
merchant = købmand
mercifulness = barmhjertighed
mercury = kviksølv
mercy = barmhjertighed
merit = fortjene
merry = alvorlig, munter
merry-go-round = karrusel
mess = grød, vælling
message = beretning, bekendtgørelse
messenger = bud, gesandt
metal = metal
metalled = sten-
method = metode
methylated spirit = sprit
metre = meter
microphone = mikrofon
microscope = mikroskop
midday = middag
midday meal = middag
middle = midte
middleclass citizen = borger
midget = dværg
midnight = midnat
mild = mild
mile = mil
military = militær, krigs-
milk = mælk, malke
millimetre = millimeter
million = million
mind = fornuft
miner = grubearbejder
mineral = mineral
mingle = blande
minimum = minimal
minister = minister
ministry = ministerium
mint = mynte
minute = minut
minutes = protokol
mirror = spejl
miscarriage = abort
miserable = dårlig, ilde, ond, slet, fattig, bedrøvet, trist
miserly = gerrig
misery = elendighed
miss = savne
mission = mission
mist = tåge
mistake = fejl
Mister = herr
misunderstand = misforstå
mitten = handske
mix = blande
mixture = blanding
mobile = bevægelig
mode = maner, mode
model = model, skabelon, skema
modern = moderne
modernize = modernisere
modest = beskeden
Mohammedan = muhamedaner
moist = fugtig
mole = muldvarp
moment = øjeblik
monastery = kloster
Monday = mandag
money = penge
monk = munk
monkey = abe
month = måned
monument = monument
mood = stemning, humør
moon = måne
moped = knallert
morals = moral
more = flere, mere
more and more = mer og mer
moreover = desuden, videre
morning = morgen
morphia = morfin
morphine = morfin
mosaic = mosaik
mosaic work = mosaik
Moscow = Moskva
Moslem = muhamedaner
mosque = moské
motel = motel
moth = møl
mother = moder, mor
mother-in-law = svigermor
motion picture = film
motive = bevæggrund
motor = motor
motor-boat = motorbåd
motor car = bil, automobil
motorcycle = motorcykel
motorist = bilist
motor-launch = motorbåd
mountain = bjerg
mountain-ash = røn
mountain climber = Alpinist
mountaineer = Alpinist
mountain hut = alpehytte
mountain pasture = sæter
mounting = montage
mourn = sørge, beklage
mouse = mus
moustache = overskæg
mouth = mund
move = rykke, røre sig, flytte, flytning
movement = bevægelse
movie = film
movie theatre = biograf
moving = følsom, modtagelig
mow = slå
Mr. = herr, herre
Mrs. = fru, frue
mud = dynd
mudguard = stænkskærm
multiply = multiplicere
multitude = mængd
munition = ammunition
murder = mord
murderer = morder
murk = mørke
muscle = muskel
museum = museum
mush = grød, vælling
mushroom = champignon, svamp, champingnon
music = musik
musical = musical
musical instrument = musikinstrument
musical time = takt
musician = musiker
Muslim = muhamedaner
Mussulman = muhamedaner
must = måtte, skulle
mustard = sennop
mute = stum
mutiny = mytteri, opstand
mutton = fårekød
mutual = gensidig
mutual understanding = samtykke
my = min, mit, mine
mythology = mytologi
naïf = naiv
nail = søm, negl
naïve = naiv
naked = nøgen
nakedness = nøgenhed
name = navn, benævnelse
nameless = anonym
namely = nemlig
nape = nakke
napkin = serviet
narrate = fortælle
narrative = fortælling
narrow = smal, tæt
nasty = afskyelig, ubehagelig, grim, dårlig, ilde, ond, slet, uærlig, uvenlig
nation = nation, folk
national = national
nationality = nationalitet
natural = naturlig
naturally = naturligvis
nature = karakter, natur
naught = nul
nausea = væmmelse
near = hos, nær, nærheden
nearby = hos, nær, nærheden
nearest = næst
nearly = næsten
nearness = nærhed
near to = hos
necessary = nødvendig
necessity = nødvendighed
neck = hals
necktie = slips
need = behøve, kræve, trænge til, behov
needle = nål, knappenål
neglect = forsømme
négligé = negligé
negotiate = handle
neighbour = nabo
neighbourhood = bydel, kvarter, nabolag
neither = heller ikke, ingen
neither ... nor = hverken ... eller
neon = neon
nephew = brodersøn, nevø, søstersøn
nerve = nerve
nervous = nervøs
nest = rede
net = net
nettle = brændenælde
network = net
neutral = neutral, unpartisk
never = aldrig
never mind = det gør ikke noget
new = ny
news = nyhed
newspaper = avis
next = næst, derefter, herefter, derpå, fålgende, næste
next of kin = pårørende
next to = hos
nice = behagelig, rar, god
niece = broderdatter, niece, søsterdatter
night = nat
nightmare = mareridt
nine = ni
nineteen = nitten
nineteenth = nittende
ninety = halvfems
ninth = niende
no = nej
nobility = adel
noble = ædel
nobody = ingen
node = knude
no doubt = uden tvivl
noise = larm
non-alcoholic = alkoholfri
non-attendance = fraværelse
noncom = underofficer
non-commissioned officer = underofficer
none = ingen
non-military = civil
noon = middag
no-one = ingen
nor = heller ikke
normal = normal
north = nord
North America = Nordamerika
northern = nordlig
North Sea = Nordsøen
Norway = Norge
Norwegian = norsk, nordmand
nose = næse
not = ikke
notary = notar
not at all = ingenlunde, slet ikke
note = billet, kommentar
notebook = notesbog
noteworthy = mærkelig
notice = opslag, meddelelse, lægge mærke til, iagttagelse, bekendtgørelse
notification = meddelelse
notion = begreb
not on any account = ingenlunde
not yet = endnu ikke
nought = nul
nourish = fodre, nære
nourishment = næring
novel = ny, roman
novelty = nyhed
November = november
now = nå, nu
nowadays = nu for tiden, nu til dags
now and then = af og til, fra tid til anden
nowhere = ingensteds, intetsteds
nucleus = kærne, kerne
nude = nøgen
nudity = nøgenhed
null = nul
number = husnummer, tal, antal, nummer
number of the house = husnummer
numberplate = nummerplade
numeral = nummer
nun = nonne
nurse = passe, pleje, sygeplejerske, se after
nut = møtrik
nuts = sindssyg
nylon = nylon
oak = eg
oar = åre
oath = ed
oats = havre
obedient = lydig
obey = adlyde
object = ting
obligation = pligt
observation = iagttagelse
obtuse = sløv, stump
occasion = gang, tildragelse
occupation = stilling, beskæftigelse, besættelse
occur = forekomme, ske
occurence = tildragelse, anledning, lejlighed
ocean = ocean
o'clock = time
October = oktober
oculist = øjenlæge
odd = gal, sær, tosset, underlig
odor = lugt
odour = lugt
of = af, for, om, siden, på, til
offend = fornærme, skælde
offensive = offensiv
offer = byde, tilbyde, forestille, præsentere, servere, udføre, foreslå, forslag
offer up = byde, tilbyde
office = kontor, embede
officer = officer, embedsmand
official = officiel, embedsmand
offset = afstand
of noble birth = ædel
of sand = sandet
of steal = stål-
often = ofte, tit
of use = passende
oil = olie
okay = god, godt
old = gammel
old people's home = alderdomshjem
olive = oliven
olive-tree = oliventræ
olympic = olympisk
omelette = omelet
omit = udelade
omnibus = bus, omnibus
on = fremad, af, for, om, siden, i, om, på, ved, mere, over, til, vid
once = en gang, engang
once more = igen
one = en, et
one another = hinanden
one hundred = hundrede
onerous = tung
one thousand = tusinde
one time = en gang, engang
onion = løg
only = bare, blot, kun, alene
only just = knæppe
on purpose = forsætligt
on that account = derfor
on the contrary = tværtimod
on the occasion of = i anledning af
on the other side of = over, tværs
on top = oven
open = åbne, åben
opening = åbning
open up = åbne
opera = opera
operate = fungere, operere
operation = operation
operative = arbejder
ophtalmologist = øjenlæge
opine = mene, synes
opinion = mening, opfattelse
opium = opium
opportunity = tildragelse, anledning, lejlighed
oppose = brokke
opposed to = imod
opposite = imod, modsat
opposition = modsætning, opposition
oppress = trykke
optician = optiker
optimist = optimist
or = eller, og
orange = appelsin
orange-coloured = orange
orchestra = orkester
orchid = orkidé
ordain = bestemme
order = bestille, bestilling, ordre, ordning, befaling
ordinarily = sædvanligvis, som regel
ordinary = almindelig, ordinær, vanlig, sædvanlig
organ = organ, orgel
organization = organisation
organize = organisere
Oriental = orientalsk, østlig
origin = oprindelse
original = oprindelig
originate = afstamme
ornament = dekoration
orthography = ortografi
otherwise = tværtimod
ought to = måtte, skulle
our = vor, vort
out = udenfor
outer = ydre
outfit = dragt
outlet-pipe = afløb, afløbsrør
out of = af, ud
outside = ydre, udenfor
outskirts = omfang
oven = bageovn, ovn
over = over
overall = hel
overalls = overall
overcoat = frakke
overhead = oven
overlook = udelade
overpower = besætte
owe = skylde
owl = ugle
own = besidde, eje, egen
owner = ejer
ownership = ejendom
ox = okse
oyster = østers
pace = træde, skridt
pacifier = støvsuger
pack = pakke, indpakke
package = pakke, indpakke
packet = pakke
pad = blok
page = side
paid-up = kvit
paid up = kvit
pail = spand
pain = smerte
painful = smertelig
paint = farve, male
painter = maler
painting = billede
pal = kammerat
palace = palads
pale = bleg
palisade = indhegning
palm = palme
palmtree = palme
pamper = forkæle
pamphlet = brochure
panic = panik
pantechnicon = flyttevogn
pantechnicon van = flyttevogn
panties = underbukser
pantry = spisekammer
pants = bukser
paper = dokument, tapet, papir, tapetsere
paperback = brochure
paper-basket = papirkurv
paperer = tapetserer
paper-hanger = tapetserer
paper-hangings = tapet
paprika = paprika
parachute = faldskærm
parade = parade
paradise = paradis
paraffin-oil = petroleum
paragraph = afsnit, afsnit, paragraf
parallel = parallel
parcel = pakke
pardon = tilgive, benådning, nåde
parents = forældre
parents-in-law = svigerforældre
Paris = Paris
park = parkere, park
parliament = parlament
parlour = aula
parrot = papegøje
parsley = persille
part = del, rolle
partially = dels, delvis
participate = deltage
particular = særskilt, særlig, speciel
partition = adskillelse
partly = dels, delvis
partridge = agerhøne
party = fest, højtid, parti
passage = gang, korridor
pass away = dø
passenger = passager
passion = ild
passport = pas
pass through = gennemse
past = fortid, forbi
pastor = præst
patch = reparere
patch up = reparere
pate = hoved
patent = patent
paternal aunt = faster
paternal uncle = farbror
path = sti
patience = tålmodighed
patient = patient, tålmodig
patriotic = patriotisk
pattern = skema
pause = pause
pavement = fortov
pavilion = pavillon
paw = ben, fod, pote
pawn = soldat
pay = betale
pay attention = forvente
pay attention to = forvente, tage hensyn til
payment = betaling, indbetaling
pay off = afbetale
pay out = give ud
pea = ært
peace = fred
peach = fersken
peak = spids, top
pear = pære
pearl = perle
peculiar = gal, sær, tosset, underlig
pedal = pedal
pedestrian = fodgænger
peel = skrælle, bark
pelvis = kumme
pen = fjeder, pen
pencil = blyant
peninsula = halvø
Pentecost = pinse
people = folk
pepper = peber
per = i, om, på
perchance = mulighvis, måske
perfect = perfekt
perform = indtaste, aflægge, gøre, lave, forestille, præsentere, servere, udføre
perfume = parfume
perhaps = mulighvis, måske
peril = fare
period = periode, punkt
periodical = avis, tidskrift
periphery = omfang
permanent = stadig
permission = enighed, tilladelse
permit = tillade
persecute = forfølge
Persian = persianer
person = person
personal = personlig, egen
personality = karakter
personal number = personnummer
perspective = udsigt
persuade = overbevise, overtyde, overtale
perverse = pervers
pestilence = pest
pet = forkæle
petition = bønskrift
petrol = benzin
petroleum = petroleum
petrol tank = benzintank
pfennig = pfennig
phantom = ånd
pharmaceutical = lægemiddel, medicin, medikament
pheasant = fasan
philately = filateli
photograph = fotografere
photographer = fotograf
photography = fotografi
physician = læge
physics = fysik
pick = plukke, stikke
pick out = vælge
pick up = hente, samle, gribe, tage, tage op
picnic = picnic
picture = afbildning, billede, figur
picture postcard = prospektkort
pie = tærte
piece = brud, brudstykke, del, stykke
pig = gris, svin
pigeon = due
pigeonhole = afdeling, fag
piglet = gris, pattegris
pigmy = dværg
pike = gedde
pile = mængd
pilgrimage = pilgrim
pill = pille
pillar = kolonne
pillow = pude
pilot = pilot
pin = knappenål
pine = fyr, fyrretræ
pineapple = ananas
pine-tree = fyr, fyrretræ
pioneer = pioner
pipe = pibe, rør
pistol = pistol
pit = kærne
pity = have medlidenhed, have medlidenhed med, medlidenhed
placard = opslag
place = plads, sted, lægge, stille, sætte
place of birth = fødested
place of refuge = asyl
place of worship = kirke
place to sit = plads
plague = pest
plaice = rødspætte
plain = slette, klar, tydelig
plan = hensigt, planere, plan, planlægge, projekt
plane = flyvemaskine, plan, høvl
planet = planet
plank = hylde
plant = plante
plate = fad, tallerken
platform = styre, kaj, perron, podium, program
platter = fad
play = lege, spille
play-off = finale
plaza = plads
plea = bevis
pleasant = behagelig, rar
pleasantness = behagelighed
please = vær så god at, behage
pleased = tilfreds
pleasure = fornøjelse
pledge = kaution
plough = pløje, plov
pluck = plukke
plug = tændrør, tampon, stik
plug in = forbinde, koble til
plum = blomme
plume = fjeder
plunder = plyndre
plunge = dykke
pocket = lomme
podium = podium
poem = digt
poet = digter
poetry = digtning
point = spids, top, punkt
pointed = spids
point out = vise
poison = forgifte, gift
poisonous = giftig
Poland = Polen
policeman = politibetjent
police-station = politistation
policy = politik
polite = høflig
politeness = høflighed
political = politisk
politician = politisk
politics = politik
pomegranate = granatæble
pond = dam
pony = pony
poop = agterstavn
poopdeck = agterstavn
poor = dårlig, ilde, ond, slet, fattig
pope = pave
poplar = poppel
popular = populær
population = befolkning
pork = svinekød
port = havn
portal = indgang, port
porter = portier, drager
portrait = billede, portræt
Portugal = Portugal
Portuguese = portugiser
possess = besidde, eje
possession = ejendom, besiddelse
possibility = evne, mulighed
possible = mulig
possibly = mulighvis, måske
post = embede, post, postvæsen
postage = porto
postage stamp = frimærke
postal code = postnummer
postcard = brevkort
poster = opslag
postman = postbud
post office = posthus
postpone = udsætte
postulate = fordre
pot = kande
potato = kartoffel
pound = pund
pour = øse, strø
pour out = strø
poverty = fattigdom
practical = praktisk, reel, virkelig
practice = anvende, øvelse, praktisere
practise = øve
praise = rose
pray = bede
preach = prædike
preacher = prædikant, præst
precede = gå foran
precipice = afgrund
prefer = foretrække
preferably = hellere, hellst
pregnant = svanger
prejudice = fordom
premium = præmie
preparation = tilberedelse, tillavning
prepare = forberede, fuldende
present = aktuel, gave, nærværende, forestille, præsentere, servere, udføre
presentation = forslag
present-day = aktuel, nærværende
present with = forestille, præsentere, servere, udføre
preservative = præservativ
preserve = beholde, konservere
president = præsident
press = presse, trykke
pressing = trængende
pressure = tryk
presume = antage, tro
pretend = foregive, lade som om
pretext = påskud
pretty = køn
prevent = hindre, forhindre
previous = forbigangen
previously = forhen
prey = bytte, fangst
price = pris
pricey = dyr, værdifuld
pride = stolt
priest = præst
primitive = primitiva
prince = prins
princess = prinsesse
principle = princip
print = trykke, tryk
prior = forbigangen
prison = fængsel
private = privat
prize = præmie
probable = sandsynlig
probably = sandsynligvis
problem = problem
proceed with = fortsætte
process = proces
procession = procession
proclamation = angivelse, opgivelse
produce = producere
product = produkt
production = produktion
profess = bekende, skrifte, tilstå
profession = stilling
professional = erhvervs-
professor = professor
profile = profil
profit = profitere
profound = dyb
programme = program
progress = bedring, fremskridt
prohibit = forbyde
project = projekt
promise = love, løfte
pronounce = udtale
proof = bevis
propaganda = propaganda
propeller = skrue
proper = rigtig
property = bondegård, gård, egenskab, ejendom
prophesy = forudsige
proposal = forslag
propose = byde, foreslå, tilbyde
prosecute = forfølge
prostitute = prostitueret
protect = beskytte
protection = beskyttelse
protest = protestere, protest
protocol = protokol
prove = bevise
proverb = ordsprog
provisional = foreløbig
provoke = provokere, udfordre
provost = borgmester
prow = bov
proximity = nærhed
prudent = fornuftig
psychiatrist = psykiater
psychic = psykisk
public = offentlig
publicity = propaganda
public square = plads
publish = udgive, åbenbare
publisher = forlægger
pudding = budding
pull = træk, trække
pullover sweater = pullover
pulpit = kateder
pulverize = male
pump = pumpe, oppumpe
punish = straffe
punishment = straf
purchase = indkøb, købe, køb, indkøb
purchase money = købesum
purchaser = køber
pure = ren
purge = gøre rent, rense
purity = renhed
purpose = hensigt, mål, formål
purse = børs, pung
pursue = forfølge
pus = materie
push = støde, stød
push along = skubbe
put = lægge, stille, sætte
put down = lægge, stille, sætte
put in order = indrette, rede, rydde op
put on the stage = forestille, præsentere, servere, udføre
put out = slukke, udslukke
put out of countenance = forfærdelig, rædsom
putrefy = rådne
put up with = gennemgå, tåle
puzzle = forvirre
puzzle over = gruble
pyjamas = pyjamas
pyramid = pyramide
quality = egenskab
quarrel = skænderi, skændes
quarter = bydel, kvarter
quarter of an hour = kvarter
quash = ødelægge
quay = kaj, perron
queen = dame, dronning
question = spørgsmål
quick = hurtig
quickly = hurtigt
quicksilver = kviksølv
quiet = rolig
quinine = kinin
quinsy = angina
quit = forlade
quite = nok, meget, særlig, helt
quiver = ryste
quotation mark = anførelsestegn
quote = citere, anførelsestegn
rabbi = rabbiner
rabbit = kanin
race = race
rack one's brains = gruble
radiator = køler
radical = radikal
radio = radio
radish = radise
radius = radio, stråle
raffle = lotteri
rag = lap, pjalt
ragout = ragout
railroad = jernbane
railway = jernbane
railway carriage = vogn, waggon
railway platform = perron
rain = regne, regn
rainbow = regnbue
raise = avle, opdrage, løfte
ranch = bondegård, gård
rancher = bonde
rand = kant, rand
random = tilfældig
ransom = afkøbe
rapid = hurtig
rapier = kårde
rare = sjælden
raspberry = hindbær
rat = rotte
rate = bedømme, vurdere
rather = lidt, hellere, hellst, nok
raw = rå
ray = stråle
react = reagere
read = læse
ready = færdig
real = virkelig, reel
reality = sandhed
realization = begreb
realize = forstå
really = faktisk
rear = avle
reason = årsag, bevæggrund, fornuft
reasonable = fornuftig
rebel = rejse sig
rebellion = mytteri, opstand
rebuke = dadle, bebrejde
recall = huske
receipt = kvittering
receive = acceptere, sige ja tak til, modtage, få, modtage
recent = frisk
recently = nylig
recess = pause
recipient = modtager
reciprocal = gensidig
recite = recitere
recline = ligge
recognize = genkende
recollect = huske
recollection = erindring, hukommelse
recommend = anbefale
recommendation = anbefaling
record = diskos, skive, beretning, optage, registrere, rekord
records = arkiv
recover = komme sig
recruit = rekrut
red = rød
red currant = ribs
redeem = afkøbe
redemption = afskrivning
reek = stinke, lugte
reflect = kaste tilbage, reflektere
reflect on = synes
refrigerator = køleskab
refuse = nægte, vægre sig
regard = agtelse, tage hensyn til, betragte, se på
regiment = regiment
region = område, region
regional = regional
register = optage, registrere, anbefale
registered letter = anbefalet brev, befalet brev
regret = beklage, være ked af
regrettably = desværre, det er en skam
regular = regelmæssig
regularly = ofte, tit
regulation = regel
reign = styre
reject = afslå, afvise, sige nej tak til, nægte, vægre sig
relate = fortælle
related = i familie
relation = forhold
relations = slægt
relative = slægtning
relatives = slægt
release = udelade, løslade, frigive
reliable = pålidelig
relief = lettelse
relieved = lettet
religion = religion
religious = religiøs
relinquish = give efter
rely on = have tillid på, stole på
remain = blive, forblive
remainder = rest
remaining = øvrig
remark = bemærkning
remarkable = mærkelig
remember = huske
remit = aflyse, sende afbud
remote = afsides
removal = flytning
remove = afskaffe, fjerne
rendezvous = aftale, rendezvous
renew = forny, renovere
rent = leje
rental = leje
renter = lejer
rent out = udleje
repair = reparere
repeat = gentage
repeatedly = gentagne gange
repetition = gentagelse
reply = svare, svar
report = meddele, beretning, bekendtgørelse
repose = hvile, ro
representation = figur
representative = delegeret
reproach = dadle, bebrejde, bebrejdelse
reproduction = reproduktion
reprove = dadle, bebrejde
republic = republik
reputation = rygte
request = bede, bøn, henvendelse
require = behøve, kræve, trænge til, fordre
rescue = beholde, redde
research = undersøge, undersøgelse
resemblance = lighed
resemble = ligne
reserve = bestille
residence = bopæl, sted, bolig
resignation = udmeldelse, udtrædelse
resistance = modstand
respect = have respekt, respektere, respekt
respiration = åndedræt
respond = reagere, svare
responsible = ansvarlig
rest = rest, hvile, ro
restaurant = restaurant
rest of = øvrig
restrain = lede, beherske, regere
restrict = indskrænke
result = afstamme, resultat, udfald, følge
resumé = overblik
retain = opholde
return = indkomst
reveal = åbenbare
revenge = hævn
revise = revidere
revolt = rejse sig, mytteri, opstand
revolution = revolution
revolver = revolver
revue = tidskrift
reward = belønne, belønning
rheumatism = reumatisme
rhythm = rytme
rib = ribben
rice = ris
rich = rig
ride = ride, fare, køre
ridiculous = latterlig
rifle = gevær
right = til højre, ret, rigtig
right away = straks
righteous = retfærdig
righteousness = retfærdighed
right now = straks
rigid = stiv
rim = fælg, kant, rand
ring = ringe, ringe på
ring the bell = ringe, ringe på
rinse = skylle
ripe = moden
rise = stå op
risk = riskere, risiko
risky = risikabel
rival = konkurrere, rival
river = flod
road = vej
roam = strejfe om
roast = stege
rob = plyndre
robber = røver
robe = kjole
robust = fast
rock = klippe
rock-crystal = kvars
rocket = raket
role = rolle
rôle = rolle
roll = rundstykke, rulle
roller = cylinder
roller-blind = rullegardin
Roman = roman, romersk
romantic = romantisk
roof = tag
room = rum, værelse
rooster = hane
root = rod
rope = reb, snor
rose = rose
rostrum = tribune
rot = rådne
rough = uvenlig, ru
round = rund, afrunde, om, omkring
round off = afrunde
rouse = oprøre, stimulere
route = vej
routine = rutine
row = ro
rowan = røn
rub = gnide
rubber = gummi, kondom, viskelæder
rubbish = skrald
rubble = skrald
ruby = rubin
rucksack = rygsæk
rudder = ror
rude = uhøflig
ruin = ruinere, ruin
rule = styre, beherske, regere, regel
ruler = lineal
rumor = rygte
rumour = rygte
run = tilløb, fungere, flugt, løbe
run away = flygte
rush = skynde sig
Russia = Rusland
Russian = russisk, russer
rusty = rusten
rye = rug
Sabbath = lørdag
sack = afskedige, taske
sacrifice = byde, tilbyde
sad = bedrøvet, trist
saddle = sadel
safety = sikkerhed
safety-belt = redningsbælte
safety-pin = sikkerhedsnål
safety pin = sikkerhedsnål
sagacious = intelligent, fornuftig
sage = fornuftig
sail = sejle, sejl
sailor = sømand
salad = salat
salami = salami
salary = gage, løn
sale = salg
sallow = bleg
salmon = laks
salon = aula
salt = salt
salt water = saltvand
salute = hilse, sige goddag
Salvation Army = Frelsens hær
sample = mønster
sand = sandet, sand
sand- = sandet
sandal = sandal
sandwich = sandwich
sap = saft
Sassenach = englænder
satellite = satellit
satisfied = tilfreds
Saturday = lørdag
sauce = sauce
saucepan = kasserolle
saucer = underkop
sauna = sauna
sausage = pølse
savage = vild
save = beholde, redde, spare
saw = save, sav
say = sige
say goodbye = tage afsked, tage afsked med
say goodbye to = tage afsked, tage afsked med
scale = skæl
scales = vægt
Scandinavia = Skandinavien
Scandinavian = nordisk
scarcely = knæppe
scatter = strø, øse
scene = scene
scenery = landskab
scent = lugt
scheme = projekt, skema
school = skole
science = videnskab
scientific = videnskabelig
scientist = videnskabsmand
scissors = saks
scold = dadle, bebrejde
Scot = skotte
Scotland = Skotland
Scotsman = skotte
scrap = lap, pjalt
scrape = skrabe
scratch = kradse, skrabe, ridse
scream = skrige
screen = skærm
screw = skrue
screwdriver = skruetrækker
scuffle = kamp, slag, slagsmål, træfning
sculpture = skulptur
scythe = le
sea = hav
sea-dog = sæl
seagull = måge
seal = sæl
search = ransage
seasickness = søsyge
seaside = kyst
season = årstid
seat = plads
second = anden, sekund
secret = hemmelig, hemmelighed
secretary = kvindelig sekretær, sekretær
secrete = udelukke
section = afdeling, fag
secure = befæste, fassætte
security = kaution, sikkerhed
see = møde, træffe, se, besøge
seek = søge
seem = forekomme
seize = gribe
seldom = sjælden
self = selv
self-confidence = selvtillid
self-conscious = forlegen, genert, sky
self-interested = egoistisk
selfish = egoistisk
self-reliance = selvtillid
self-taught man = autodidakt
sell = sælge
send = sende
sender = afsender
send off = afsende
sensation = opsigt, sensation, følelse
sense = begreb, sans
sensible = fornuftig
sensitive = følsom
sentence = sætning, dømme
separate = særskilt, adskille, dele
separation = adskillelse
September = september
series = serie
serious = vigtig, alvorlig
serpent = slange
serum = serum
servant = knægt, tjener
serve = servere, tjene
service = betjening, tjeneste
set = apparat, gruppe, serie
set out = rejse bort
set straight = skuffe
settle = afregne
settlement = koloni, afregning
seven = syv
seventeen = sytten
seventeenth = syttende
seventh = syvende
seventy = halvfjerds, halvfjerdsindstyve
several = adskillige
several times = undertiden
sew = sy
sewer = kloak
sex = køn, sex
sexual = seksuel
shack = lade, hytte
shade = skygge
shadow = skygge
shake = ryste
shallow = lav
shame = skam, skændsel
shanty = lade
shape = danne, form
share = aktie, dele, deltage, del, andel, portion
shark = haj
sharp = skarp
sharpness = skarphed
shatter = knuse
shawl = tørklæde
she = hun
shear = klippe
shed = lade, barak, øse
sheep = får
sheep-dog = schæferhund
sheet = blad, lagen
sheet metal = blik
shelf = bræt
shell = skrælle, bark
shelter = asyl
shepherd = hyrde, fårehyrde
shilling = schilling
shine = skinne
ship = afsende, skib
shirt = skjorte
shiver = ryste
shock = ryste
shoe = sko
shoe-lace = skobånd
shoemaker = skomager
shoot = skyde
shoot dead = ihjelskyde
shop = butik
shore = bred, kyst
short = kort
shortage = mangel
shortcoming = mangel
shorten = forkorte
shorthand = stenografi
shortness of breath = astma
short pants = shorts
shorts = shorts
short story = novelle
should = måtte, skulle
shoulder = skulder
shout = skrige, råb
shove = skubbe
shovel = skovl
show = vise
shower = tage brusebad, brusebad
shrub = busk
shuffle = blande
shut = lukke, lukket
shut off = afbryde
shy = forlegen, genert, sky
siblings = søskende
sick = syg
side = side, parti
sideboard = skab
sideline = hobby
sidewalk = fortov
side-whiskers = kindskæg
sigh = sukke
sight = syn
sightless person = blind person
sign = bevis, signal, tegn, underskrive, undertegne
signal = signal, tegn
signature = underskrift
signify = betyde
silk = silke
sill = dørtrin
silver = sølv
similar = lignende
similarity = lighed
simple = enkelt
sin = synde
since = af, for, om, siden, fordi
sing = synge
singer = sanger
single = ugift, enlig
sink = synke, sænke, dykke
siphon = sifon
sir = herr
sister = søster
sister-in-law = svigerinde
sit = sidde
sit down = sætte sig
sitting-room = stue, dagligstue, aula
situation = tilstand
six = seks
sixteen = seksten
sixteenth = sekstende
sixth = sjette
sixtieth = tresindstvende
sixty = tres, tresindstyve
size = størrelse
skate = løbe på skøjter
skeleton = skelet
skeptical = skeptisk
sketch = planlægge
ski = ski
skid = glide ud
skimpy = mager, tynd
skin = skind, hud
skinny = mager, tynd
skirt = nederdel
sky = himmel, himmerig
slander = bagtale, sladre
slay = dræbe
sleep = sove, søvn
sleeping-car = sovvogn
sleepy = søvnig
sleeve = ærme
slender = mager, tynd, slank
slice = skære
slim = slank
slime = dynd
slip = glide ud
slipper = tøffel
slope = skrænt
slow = langsom
slowly = langsomt
small = lille
smallpox = kopper
smash = knuse
smear = smøre
smell = stinke, lugte, lugt
smell bad = stinke
smell of = lugte af
smile = smile, smil
smith = smed
smoke = ryge, røg
smokers = rygere
smokestack = skorsten
smooth = flad, glat
snail = snegl, snabel-a
snake = slange
snare = fælde
sneeze = nyse
snore = snorke
snow = sne
so = altså, sådan, således
soap = sæbe
sober = ædru
social = social
society = klub, selskab
sock = sok
socket = bestik
sofa = sofa, sovesofa
soft = sød, blød
soil = tilsøle, snavse til, jord
soiled = snavset
soldier = soldat
sole = fodsål, alene, tunge
solely = bare, blot, kun
solicitor = advokat, sagfører
solid = fast
solitary = alene
so long = farvel så længe, på gensyn, vi ses
solution = oplysning
some = lidt
something = noget
something new = nyhed
sometime = nogensinde
sometimes = undertiden
somewhat = lidt
somewhere = nogensteds
son = søn
song = sang
songbook = sangbog
son-in-law = svigersøn
soon = snart
sorrowful = trist
sort = art, slags
so to speak = så at sige
soul = vid
sound = lyde, lyd
soup = suppe
sour = sur, uvenlig
source = kilde
south = sydlig, syd
South America = Sydamerika
southern = sydlig
souvenir = souvenir
Soviet = sovjetisk
Soviet Union = Sovjetunionen
sow = så
spa = badested
space = rum
spaceman = astronaut
spacious = rummelig
spade = grave, spade
Spain = Spanien
Spaniard = spanier
spanner = skruenøgle
spare = spare
spare time = ferie
spark = gnist
spark plug = tændrør
sparrow = spurv
speak = snakke, tale
speaker's platform = tribune
special = særskilt, særlig, speciel
speciality = afdeling, fag
specific = særlig
specimen = mønster
spectacles = briller
speech = tale
speechless = stum
speed = fart, hast, tempo
speed-limit = hastighedsgrænse
speed limit = hastighedsgrænse
speedy = hurtig
spell = stave
spend = give ud
spider = edderkop
spiderweb = spindelvæv
spiked = spids
spinach = spinat
spine = rygrad
spiral = spiral
spirit = ånd
spit = spytte
Spitsbergen = Svalbard
split = spalte, briste
spoil = beskadige
spoiled = forkælet
sponge = svamp
spoon = ske
sport = idræt, sport
spot = plads, sted, punkt
spray gun = pistol
spread = sprede, smøre
spread out = sprede
spring = kilde, forår, fjeder, springe
springtime = forår
spruce = gran
spruce-fir = gran
spy = spion
square = firkantet, firkant, kvadrat, plads
square decametre = gruppe
square metre = kvadratmeter
square up = afregne
squatter = BZ'er
squeeze = trykke
squeeze out = trykke ud
squirrel = egern
stab = stikke
stable = fast, stald, hestestald
stadium = stadion
stage = styre, station
staid = alvorlig
staircase = trappe
stairs = trappe
stalk = træde, stilk
stall = stald
stallion = hingst
stamp = frimærke
stamp-collecting = filateli
stand = barak, stå op, stå
standard = fane
stand up = stå op
star = stjerne, star
starling = stær
start = begynde, begyndelse
starter = selvstarter
state = hævde, påstå, erklære, tilstand, stat
statement = angivelse, opgivelse
statement of policy = program
station = station
stationer's shop = papirhandel
station-master = stationsforstander
stay = bo, ophold, blive, forblive
stay over = blive, forblive
stay with = bo
steak = bøf
steal = stål-, stjæle
steam = damp
steel = stål
steep = stejl
steer = styrre
steering-wheel = rat
stem = stilk, stamme
stenography = stenografi
step = træde, skridt
stern = agterstavn
stew = gullasch, ragout
stick = klæbe
sticky = klæbrig
stiff = stiv
still = endnu
stimulate = stimulere
sting = stikke
stingy = gerrig
stink = stinke
stipulation = betingelse
stir up = oprøre, stimulere
stocking = strømpe
stomach = mave
stomach ache = mavesmerter
stone = sten-, sten
stool = taburet
stoop = bøje sig
stop = bo, holdeplats, standse, stoppe, afbryde, station, ophøre
stopper = stik
storage battery = akkumulator
storage room = lager
store = butik
storey = etage, sal
stork = stork
storm = storm
story = etage, sal, historie, fortælling
stove = ovn
straight = lige
straightedge = lineal
straightforward = enkelt
straight past = forbi
strange = fremmed, gal, sær, tosset, underlig
strangle = kvæle
strawberry = jordbær
stream = strøm, bæk
strech = trække op
strecher = båre
street = gade
strength = kraft
stress = accent, betoning
stride = træde, skridt
strike = slå, banke, strejke
striking = påfaldende
string = bind, reb, snor
stroke = stryge
stroll = spadseretur
strong = stærk
struggle = kæmpe, slås, kamp, slag, slagsmål, træfning
student = student
study = studium, studere
stuff = stof
stupid = dum
sturdy = fast
sty = stald
subject = emne, tema
subscription = abonnement
subsequently = derefter, herefter
subsidy = tilskud
substance = stof
subterfuge = kneb
subtract = fradrage
suburb = forstad
subway = undergrundsbane
succeed = lykkes
success = succes
such = sådan, således
such a = hvordan
such as = hvordan
suck = suge
sudden = pludselig
suddenly = pludseligt
suffer = gennemgå
sufficient = nok, tilstrækkelig
sufficiently = nok
sugar = sukker
suggest = angive, byde, foreslå, tilbyde
suit = dragt
suitable = passende
suitcase = håndkuffert
sum = beløb, sum
summer = sommer
summery = overblik
summit = spids, top, overflade
summon = kalde, råbe
sun = sol
Sunday = søndag
sunrise = solopgang
sunset = solnedgang
superficial = lav
superior = chef, overordnet
supersign = accent
superstition = overtro
superstitious = overtroisk
supervise = kontrolere
supper = aftensmad
supply = aflevere
support = støtte
supporter = medlem, partifælle, tilhænger
suppose = antage, tro
sure = sikker
surface = overflade, top
surgeon = kirurg
surgical operation = operation
surly = uvenlig
surmise = antage, tro
surname = efternavn
surpass = overgå
surprise = forbavselse, overraske, overraskelse
surround = omgive
surroundings = omgivelse
survive = gennemgå
suspect = mistro
suspenders = seler
suspicion = mistro, mistanke
sustain = støtte
sustained = stadig
swallow = svale
swan = svane
swap = udskifte
sway = svinge
swear = bande, sværge
sweat = svede
Swede = svensker
Sweden = Sverige, Sverrig
Swedish = svensk
sweep = feje
sweet = sød
swell = svulme
swift = hurtig
swiftly = hurtigt
swim = svømme
swimming trunks = badebukser
swindle = bedrag, bedrageri
swine = gris, svin
swing = svinge
Swiss = svejtser
switch = afbryder
switch off = afbryde
Switzerland = Svejts
sycamore = ahorn
symbol = symbol
sympathetic = sympatisk
symphony = symfoni
symptom = symptom
synagogue = synagoge
syndicate = fagforening
syphilis = syfilis
syrup = sirup
system = system
systematic = systematisk
table = tabel, bord
table-cloth = borddug
tablet = tabel
tabulation = tabel
tact = takt
tail = hale
tailor = skrædder
take = acceptere, sige ja tak til, modtage, gribe, tage, tage op
take account of = tage hensyn til
take away = tage bort
take care of = bryde sig om
take in = abonnere, acceptere, sige ja tak til, modtage
take into account = tage hensyn til
take leave = tage afsked, tage afsked med
take leave from = tage afsked, tage afsked med
take offence at = ærgre sig over
take over = købe
take part = deltage
take steps = bestræbe sig
taking = køb, indkøb
taking over = køb, indkøb
tale = fortælling
talent = talent
talk = snakke, tale
talkative = snaksom
tall = høj
tampon = tampon
tangerine = mandarin
tangle = rod
tank = tank
tap = hane
tapestry = tapet
tar = tjære
tardy = sen
target = hensigt, mål, formål
tart = sur, tærte
task = opgave
taste = smage, smag
tax = skat
taxi = taxa
taxidriver = taxachauffør
taxi-driver = taxachauffør
tea = te
teach = undervise
teacher = lærer
teapot = tepotte
tea-pot = tepotte
tear = rive itu, tåre
tear off = plukke
technical = teknisk
technics = teknik
technique = teknik
telegram = telegram
telegraph = telegrafere
telephone = telefonere, telefon
telescope = teleskop
television = fjernsyn
television set = fjernsynsapparat
tell = sige, fortælle
tell a lie = lyve
temper = humør
temperature = temperatur
tempest = storm
temple = tempel
temporary = foreløbig
ten = ti
tenant = lejer
tendencious = tendentiøs
tendency = tendens
tendentious = tendentiøs
tender = sød, forestille, præsentere, servere, udføre, byde, foreslå, tilbyde, forslag
tend to = passe, pleje
tennis = tennis
tension = spænding, anstrengelse
tenth = tiende
term = udtryk
terminate = fuldende, endelse
term of abuse = skældsord
terms = betingelse
terrace = terrasse
terraced house = rækkehus
terrace house = rækkehus
terrain = terræn
terrible = forfærdelig, rædsom, skrækkelig
terrify = forskrække
territory = område
test = undersøgelse, forsøge, prøve, teste, test
testament = testamente
testicle = testikel
testimony = attest
text = tekst
than = end
thank = takke
thank for = takke for
thankful = taknemmelig
thankless = utaknemlig
thanks = tak, tak for det
thank you = tak, tak for det
thank you very much = mange tak
that = hvad, der, som, sådan, således
that's all right = det gør ikke noget
that's okay = det gør ikke noget
that's too bad = det er en skam
that way = så, derhen, did
thaw = tøvejr
the Antarctic = Sydpolen
the Arctic = Nordpolen
theatre = teater
the day after tomorrow = i overmorgen
the day before yesterday = i forgårs
thee = Dem, dig, jer
theft = tyveri
their = sin, sit
them = dem
theme = emne, tema
then = altså, derpå, da, så
thence = derfra
the Netherlands = Nederlanderne
theory = teori
therapy = terapi
there = derhen, did, der
thereafter = derpå
therefore = altså, derfor
thermometer = termometer
thermos = termoflaske
thermos bottle = termoflaske
thermos flask = termoflaske
these days = nu for tiden, nu til dags
they = de
thick = tæt, tyk
thief = tyv
thigh = lår
thin = mager, tynd
thing = ting
think = mene, synes, tænke, synes
think about = synes
think to oneself = synes
think well of = agte
third = tredje
thirst = tørst
thirsty = tørstig
thirteen = tretten
thirteenth = trettende
thirty = tredive
this afternoon = i eftermiddag
this evening = i aften
thisle = tidsel
this morning = i morges
this way = herhen, hid
thither = derhen, did
thorn = torn
thou = De, du, I
thought = tanke
thousand = tusinde
thread = tråd
threat = trussel
threaten = true
three = tre
three times = tre gange
threshold = dørtrin
thrice = tre gange
throat = strube
through = færdig, gennem, igennem
throw = kaste
throw up = kaste op
thrust = støde
thumb = tommelfinger
thunder = tordne, torden
Thursday = torsdag
thus = sådan, således, så
ticket = billet
tickle = kildre
tidy = indrette, rede, rydde op
tie = slips, bind, binde, bånd
tie up = binde
tiger = tiger
tile = flise
till = indtil
timber = træ
time = gang, time, tid
time off = ferie
time to consider = betænkningstid
timid = bange, sky
tin = blik, tin
tinkle = ringe
tin-opener = dåseoplukkner
tin plate = blik
tint = farve
tip = spids, top, drikkepenge
tire = dæk
tired = træt
title = titel
to = for, på, til
toad = tudse
toast = stege
today = i dag
toe = tå
together = sammen, tilsammen
toilet = toilet
toilet-paper = toiletpapir
token = bevis, signal, tegn
tolerant = tolerant
tolerate = tåle
tomato = tomat
tomorrow evening = i morgen aften
tomorrow morning = i morgen tidlig
tone = tone
tongs = tang
tongue = tunge, sprog
tonight = i nat
too = også, for
tool = redskab, verktøj
too much = for
tooth = tand
toothache = tandpine
tooth-brush = tandbørste
tooth-paste = tandpasta
toothpick = tandstikker
top = overflade
topic = emne, tema
topical = aktuel
torch = fakkel
to some extent = lidt
to the left = til venstre
to the right = til højre
touch = berøre, berøring
touching = følsom, modtagelig
tourist agency = rejsebureau
toward = for, på, til, i forbindelse med, vedrørende
towards = for, på, til, i forbindelse med, vedrørende, om, omkring
towel = håndklæde
tower = tårn
town = by
town-hall = rådhus
town hall = rådhus
trade = handle, handel, stilling
trade-union = fagforening
tradition = tradition
traffic = færdsel, trafik
tragedy = tragedie
train = tog
tranquil = rolig
transformation = ændring
transgress = synde
transistor = transistor
translate = oversætte
translation = oversættelse
transmit = sende
transparant = gennemsigtig
transport = transportere
trap = fælde
travel = fare, køre, rejse
travel agency = rejsebureau
traveller = rejsende
tread = træde
treasure = skat
treat = behandle, beværtning, forplejning
treatment = behandling
tree = træ
tremble = ryste
tressle = bænk
triangle = trekant
trick = kneb
trickery = kneb
tricycle = trehjulet cykel
trimming = bort
trip = rejse
tropical = tropisk
trouble = problem, hindre, forstyrre
trousers = bukser
trout = forel
truck = lastbil, lastvogn
true = ægte, egentlig, sand
truly = faktisk
trumpet = trompet
trunk = kuffert, stamme
trust = have tillid til, tillid
trust in = have tillid på, stole på
trustworthy = pålidelig
truth = sandhed
try = forsøge, prøve
tub = kar
tube = slange, rør, ventil
Tuesday = tirsdag
tug = trække, bugserbåd
tugboat = bugserbåd
tulip = tulipan
tummy = bug
tummy ache = mavesmerter
tuna = tunfisk
tuna-fish = tunfisk
tune = melodi
tunny = tunfisk
Turk = tyrk
turkey = kalkun
turn = vende, vending
turn around = vende
turn away = afsende
turnip = roe
turn off = afbryde
turnover = omsætning
turn round = vende
turn to good account = benytte
TV = fjernsyn
TV set = fjernsynsapparat
twelfth = tolvte
twelve = tolv
twentieth = tyvende
twenty = tyve
twenty-one = en og tyve
twice = to gange
twilight = tusmørke
twin = tvilling
twins = tvilling
two = to
two weeks = fjorten dage
type = maskinskrive
typewriter = skrivemaskine
typhus = tyfus
typical = ejendommelig, typisk
typist = maskinskriverske
tyre = dæk
udder = yver
ugly = grim
ultimately = endelig
umbrella = paraply
uncle = farbror, morbror, onkel
unclean = snavset
unconscious = bevidstløs
uncooked = rå
uncouple = koble af
uncover = afsløre, opdage
under = under
under age = mindreårig
undergarment = underkjole
underground = undergrundsbane
underline = understrege
underneath = derunder, nede, forneden, ned, ned ad
underpants = underbukser
understand = forstå
understanding = forhold
undertake = foretage, bestræbe sig
undoubtedly = uden tvivl
undress = negligé
unemployed = arbejdsløs
unemployment = arbejdsløshed
unfortunately = desværre, det er en skam, lykkeligvis, ulykkeligvis
ungrateful = utaknemlig
unhappy = ulykkelig
uniform = uniform
unique = eneste
unit = enhed, eneh
unite = forene
United States of America = De forenede stater, USA
unity = enhed
universal = almindelig
university = universitet
unkind = uvenlig
unmarried = ugift
unpack = pakke ud
unpleasant = uvenlig
unreliable = upålidelig
unsocial = asocial
unthankful = utaknemlig
until = indtil
untrue = usand
up = op, op ad
uphill = op, op ad
upon = på, ved, imod, af, om, over, til, vid
upper = øverst
upper-arm = overarm
upper arm = overarm
upstairs = oven
up-to-date = aktuel
upwards = op, op ad
urgent = trængende
urinate = lade vandet, urinere
urine = urin
us = os
USA = De forenede stater, USA
US citizen = amerikaner
use = benyttelse, afbenyttelse, brug, benytte, bruge, tilbringe
used to = almindelig, vanlig, sædvanlig
useful = nyttig
USSR = Sovjetunionen
usual = almindelig, ordinær, vanlig, sædvanlig, generel
usually = sædvanligvis
usurp = besætte
utilize = udbytte, benytte
utopian = utopisk
vacation = ferie
vacuum-cleaner = støvsuger
vacuum cleaner = støvsuger
vain = forfængelig
valiant = modig, tapper
valid = gyldig
valise = håndkuffert
valley = dal
valuable = værdifuld
value = værdi
valve = ventil
vanilla = vanille
vanity = forfængelighed
vapor = damp
vapour = damp
variety entertainment = varieté
vase = beholder, vase
vaseline = vaseline
vast = rummelig
vat = kar
veal = kalvekød
vegetable = grønsager
vegetarian = vegetarisk, vegetar
vehicle = køretøj
vein = åre
vend = sælge
vengeance = hævn
ventilator = ventilator
venture = riskere
verify = kontrolere
vermin = utøj
vermouth = vermouth
very = meget, særlig
very much = meget, særlig
vessel = beholder, potte, vase, skib
vest = undertrøje, vest
veterinarian = dyrlæge
vicinity = nabolag
victory = sejr
view = syn, udsigt, panorama, betragte, se på, syn
vigour = aktivitet, kraft
villa = villa
village = landsby
vine = vinstok
vinegar = edikke
violet = viol
violin = violin
visa = visum
visé = visum
visible = synlig
visit = besøge, besøgn, visit
viz. = nemlig
vocabulary = ordbog
voice = stemme
void = tom
volcano = vulkan
vomit = kaste op
vote = stemme
vowel = vokal
voyage = rejse
vulgar = vulgær
wadding = vat
wage = gage, løn
wager = vædde
wages = gage, løn
waggon = vogn, waggon
waist = talje
waistcoat = vest
waistline = talje
wait = forvente
waiter = tjener
wait for = forvente
waiting = betjening
waiting-room = ventesal
waiting room = ventesal
wake = vække, vågne op
wake up = vække, vågne op
walk = gå, marchere, spadseretur
wall = mur, væg
wall covering = tapet
wallet = børs, pung
wall-paper = tapet
walnut = valnød
waltz = valse
wander = strejfe om
want = behov, ønske, ville
war = krig
warehouse = lager
warm = hjertelig, hjerte-, varm
warmth = varme
warn = advare
warning = advarsel
warrant = garantere, sikre, garanti
warrior = militær
wart = vorte
wash = vaske
wash up = vaske op
wasp = hveps
waste = spilde, forødelse
waste-pipe = afløb, afløbsrør
watch = ur, betragte, se på
watchmaker = urmager
watch out for = forvente
watch over = passe
water = vand
water-bottle = feltflaske
water-colour = akvarel
waterfall = vandfald
water-melon = vandmelon
watt = watt
wave = bølge, svinge, vinke
wave about = svinge
waver = tøve
way = vane, sædvane, maner, vej
way out = udgang
weak = svag
wealth = rigdom
wealthy = rig
weapon = våben
wear = bære
weasel = væsel
weather = vejr
weave = væve
wedding = bryllop
wedding-party = bryllop
Wednesday = onsdag
week = uge
week-end = weekend
weep = græde
weigh = veje
weight = vægt
well = godt, nå, brønd, rask, sund
well-informed = klog
well-mannered = høflig
well-off = rig
well then = nå
well-to-do = velhavende
wench = pige
west = vest
western = vestlig
wet = våd
whale = hval
wharf = kaj, perron
what = hvad
what a = hvordan
what a pity = det er en skam
what for = hvorfor
wheat = hvede
wheel = hjul
wheeziness = astma
when = når, hvornår
whence = hvor ... fra
where = hvor
whereas = imitlertid
wherefore = hvorfor
which = hvilken
while = imitlertid, tid
whilst = imitlertid
whipped cream = flødeskum
whiskers = kindskæg
whisper = hviske
whistle = fløte
white = hvid
Whitsunday = pinse
who = hvem
whole = hel
wholly = helt
whore = skøge
why = hvorfor
wick = væge
wide = rummelig
widow = enke, enkefrue
widower = enkemand
width = bredde
wife = ægtefælle, hustru, kone
wig = paryk
wild = vild
wild boar = orne
will = testamente, vilje
willingly = gerne
willingness = vilje
willow = pil
win = tjene, fortjene, vinde
wind = vind
window = vindue
window-glass = vinduesrude
wind up = trække op
wine = vin
wing = vinge
win over = besejre
winter = vinter
wire = tråd
wireless = radio
wise = fornuftig
wish = ønske, ville, vilje
witch = heks
with = med, hos
within = i, om, på
without = udder
without a name = anonym
without delay = straks
with reference to = i forbindelse med, vedrørende
with young = svanger
wolf = ulv
woman = kone, kvinde
wonder = blive forbavset, undre sig, forbavselse
wonted = almindelig, vanlig, sædvanlig
woo = elske
wood = træ
wooden = af træ, træ-
woods = skov
wool = uld
word = ord
work = fungere, arbejde
workbench = bænk
worker = arbejder
working man = arbejder
workman = arbejder
work out = beregne, kalkulere
world = verden
worldwar = verdenskrig
worldwide = almindelig
worm = orm
worse = værre
worship = dyrke
worst = værst
worth = værdi
wound = sår
wrangle = skændes
wrap up = pakke, indpakke
wreath = guirlande
wrench = nøgle
wrinkle = fold, læg
wrist = håndled
write = skrive
writer = forfatter
writing-desk = skrivebord
writing desk = skrivebord
writing-paper = brevpapir
yacht = yacht
yard = gårdsplads
yawn = gabe
ye = De, du, I
year = år
yearly = årlig
yearn = længsel, kræve
yellow = gul
yes = ja
yesterday = i går
yet = endnu, allerede
yew-tree = taks
yield = give efter
yoghourt = yoghurt
yoghurt = yoghurt
yonder = derhen, did
you = Dem, dig, jer, De, du, I
young = ung
youngster = ung
your = din, dit, Deres, jeres
you're welcome = det gør ikke noget
youth = ungdom, ung
Yule = jul
zeal = iver
Zealand = Sjælland
zero = nul
zilch = nul
zinc = zink
ZIP code = postnummer
zone = bælte, zone
zoo = zoologisk have