#setName = words_en_it_dd
#sideOneTitle = ENG
#sideTwoTitle = ITA
dagger = pugnale
daily = giornaliero, quotidiano, ogni giorno, quotidianamente
daily paper = giornale
dainty = delicato
Dalmatia = Dalmazia
damage = avaria, danneggiare, danno, difetto
Damascus = Damasco
damp = umido
dance = ballo, ballare, danza
dancer = ballerina, ballerino
Dane = danese
danger = pericolo
dangerous = pericoloso
Danube = Danubio
dare = osare
dark = buio, scuro, oscuro, tenebroso
dark blue = blu scuro
darkness = oscurità, tenebre
darling = prediletto
data = materiale
date = dattero, datare, data, appuntamento
daughter = figlia, figliuola, figliola
dawn = alba, aurora
day = giorno
daybreak = alba
daylight = luce del giorno
dazed = confuso, turbato
dead = morto
deaden = ammortizzare
deadly = mortale
deaf = sordo
deaf and dumb = sordomuto
deal with = trattare
dear = caro, costoso
death = morte
death throes = agonia
debt = debito
decayed = decrepito
deceive = ingannare, truffare
deceiver = imbroglione
December = dicembre
decent = decente
decide = decidere
decimetre = decimetro
decision = decisione, decreto, deliberazione
decisive = decisivo
deck = coperta, ponte
declaration = dichiarazione
decline = declinare, deperire, peggiorare, regressione
decorate = decorare
decrease = diminuire
decree = decreto
decrepit = decrepito
deduce = concludere, dedurre
deem = credere, guardare
deep = fondo, profondo
defeat = disfatta
defence = difesa, retroguardia
defend = difendere
defendant = accusato, imputato
defense = difesa
define = definire
defining = definito, determinato, fissato
definite = definitivo
definitive = definitivo
degree = grado
delay = ritardo
delegate = delegato, deputato
deliberately = apposta
delicate = delicato
delivery = consegna
demand = smercio, vendita
democratic = democratico
demolish = demolire
demolition = demolizione
demonstration = manifestazione
Denmark = Danimarca
denounce = denunciare
dense = denso
dentist = dentista
deny = negare
depart = andarsene, partire
departure = partenza
depend = dipendere
dependent = dipendente
depend onldepend upon = dipendere da
deportment = condotta
depression = crisi
depth = profondità
deputy = delegato, deputato
derive = derivare, discendere
descend = scendere
describe = descrivere
descry = accorgersi, intravedere, scorgere
desert = deserto, abbandonare
deserve = meritare
design = disegnare, disegno, progetto
desirable = desiderabile
desire = desiderare, desiderio
desk = banco, scrivania
despise = disprezzare
despot = despota
dessert = dessert
destine = destinare
destroy = distruggere
detachment = brigata
detail = dettaglio, particolare
detain = ritenere
detention = arresto
deter = impaurire, spaventare
determine = definire, fissare
determining = definito, determinato, fissato
deterrent = spaventevole
develop = svilupparsi
device = apparecchio
devil = demonio, diavolo
devilish = diabolico
dew = rugiada
dexterous = abile, destro, lesto, sveglio
diabolical = diabolico
diagram = figura, progetto
dialect = dialetto
diamond = diamante
diarrhoea = diarrea
diary = diario
dictionary = dizionario
die = morire, cubo, dado
die away = morire
diet = dieta, regime
different = differente
differently = diversamente, in modo diverso
difficult = difficile, pesante
dilapidated = decrepito
dim = oscuro, scuro, tenebroso
dimension = dimensione
diminish = diminuire
diminutive = piccolo
din = rumore
dining-room = sala da pranzo
dinner = colazione
diploma = atto, azione, documento, diploma
diplomat = diplomatico
direct = condurre, guidare, destro
director = amministratore delegato, direttore
directory = catalogo
disapprobation = disapprovazione
disapproval = disapprovazione
disapprove = biasimare, disapprovare
disapprove of = biasimare, disapprovare
disciples = partito, seguito
discourage = impaurire, spaventare
discover = scoprire
discovery = scoperta
discrete = discreto
discuss = discutere
disease = malattia
disgust = avversione, ripugnanza
dish = piatto
dislike = avversione, ripugnanza
dismal = abominevole, banale, sgradevole, spiacevole, mostruoso, schifoso, afflitto, triste, buio, scuro, miserabile, misero, povero
dismount = scendere
dispose of = vendere
disposition = disposizione, ingegno, talento
dissolve = risolvere
dissuade from = sconsigliare
distance = distanza
distant = distante, lontano
distil = distillare
distinct = distinto
distinguish = distinguere
distribute = distribuire
district = circondario, distretto
disturb = disturbare
dive = tuffarsi
divide = separare, dividere
divorce = divorzio
do = commettere, fare
doctor = dottore, medico
document = atto, azione, documento
dog = cane
doll = bambola
dolphin = delfino
done = finito, terminato
donkey = asino, ciuco
door = porta, uscio
dose = dose
dot = punto
double = doppio
doubt = dubitare
doubtful = dubbioso
dough = pasta
dove = piccione
dowry = dote
dozen = dozzina
draft = cambiale
drag = tirare
dragon = drago, dragone
draw = attrarre, disegnare, eguaglianza, tirare
drawer = cassetto
drawers = mutande
drawing = disegno
dreadful = terribile
dream = sognare, sogno
dreary = abominevole, sgradevole, spiacevole, mostruoso, schifoso, afflitto, triste, buio, scuro
dress = abito, vestire, vestirsi
drink = bevanda, bibita, bere
drinkable = potabile
drip = goccia
driver = autista
droop = pendere
drop = goccia, diminuire
drown = annegarsi, annegare
drugstore = farmacia
drunk = brillo, ubriaco, ubriacone
dry = secco, seccare
dry-nurse = asciutta, balia
dual = doppio
Dublin = Dublino
duck = anitra
dull = smussato, spuntato
dumb = muto
duplicate = moltiplicare
during = durante
dusk = crepuscolo
dust = polvere
Dutchman = olandese
duty = dovere
dwarf = nano
dwell = abitare, dimorare, stare
dwelling = alloggio, appartamento
dwelling-place = residenza
dwelling-place-residence = residenza
dye = colore
dynamite = dinamite