#setName = words_en_da_mn
#sideOneTitle = ENG
#sideTwoTitle = DAN
machine = maskine
mackerel = makrel
mad = sindssyg
madam = fru, frue
magazine = avis, tidskrift
magnet = magnet
magpie = skade
maid = tjener, stuepige
mail = post, postvæsen
mailbox = brevkasse
mainland = fastland, kontinent, verdensdel
maintain = beholde, konservere
maize = majs
majority = flertal
make = aflægge, gøre, lave
make ... acquaintance = stifte bekendtskab med
make a mistake = tage fejl
make a project of = planlægge
make clean = gøre rent, rense
make fast = befæste, fassætte
make-up = make-up, sminke
make up = sminke, make-up
make use of = benytte, bruge, tilbringe
malaria = malaria
male = mandlig
male cat = hankat
man = menneske, mand
manage = styrre, holde hus
management = styre
manager = dirigent, bestyrer, direktør
mankind = menneskehed
manner = maner
manufacture = fabrikere
manure = gødning
many = mange
map = landkort
maple = ahorn
marble = marmor
march = gå, marchere
margarine = margarine
mark = mærke, mark, signal, tegn
market = basar, torv
marketplace = torv
marmelade = marmelade
marriage = ægteskab
married = gift
married people = ægtepar
marry = gifte sig, gifte sig med
martyr = martyr
marvel = blive forbavset, undre sig
marvel at = blive forbavset, undre sig
masculine = mandlig
mask = maskere, maske
mass = mængd, masse
massage = massere, massage
mast = mast
master builder = bygmester
match = tændstik
mate = parre sig
material = materiel, materiale
maternal aunt = moster
maternal uncle = morbror
mathematics = matematik
matrimony = ægteskab
matter = affære, anliggende, tilfælde, materie, stof
mattress = madras
mature = moden
maybe = mulighvis, måske
mayhap = mulighvis, måske
mayor = borgmester
me = mig
meadow = eng
meager = mager, tynd
meal = mel, måltid
mealies = majs
mean = gennemsnitlig, midte, betyde
meaning = hensigt, betydning
means = redskab, verktøj
measure = måle, mål
measurement = mål
meat = kød
mechanic = mekaniker
mechanics = mekanik
medical = medicinsk
medicine = lægemiddel, medicin, medikament
meditate = synes
meet = forsamles, møde, træffe
meet each other = mødes
meeting = forsamling
meet one another = mødes
melody = melodi
melon = melon
melt = smelte
melting = tøvejr
member = medlem, partifælle, tilhænger
memento = souvenir
memory = erindring, hukommelse
menace = true, trussel
mend = reparere
mention = omtale
menu = menu, spiseseddel
merchant = købmand
mercifulness = barmhjertighed
mercury = kviksølv
mercy = barmhjertighed
merit = fortjene
merry = alvorlig, munter
merry-go-round = karrusel
mess = grød, vælling
message = beretning, bekendtgørelse
messenger = bud, gesandt
metal = metal
metalled = sten-
method = metode
methylated spirit = sprit
metre = meter
microphone = mikrofon
microscope = mikroskop
midday = middag
midday meal = middag
middle = midte
middleclass citizen = borger
midget = dværg
midnight = midnat
mild = mild
mile = mil
military = militær, krigs-
milk = mælk, malke
millimetre = millimeter
million = million
mind = fornuft
miner = grubearbejder
mineral = mineral
mingle = blande
minimum = minimal
minister = minister
ministry = ministerium
mint = mynte
minute = minut
minutes = protokol
mirror = spejl
miscarriage = abort
miserable = dårlig, ilde, ond, slet, fattig, bedrøvet, trist
miserly = gerrig
misery = elendighed
miss = savne
mission = mission
mist = tåge
mistake = fejl
Mister = herr
misunderstand = misforstå
mitten = handske
mix = blande
mixture = blanding
mobile = bevægelig
mode = maner, mode
model = model, skabelon, skema
modern = moderne
modernize = modernisere
modest = beskeden
Mohammedan = muhamedaner
moist = fugtig
mole = muldvarp
moment = øjeblik
monastery = kloster
Monday = mandag
money = penge
monk = munk
monkey = abe
month = måned
monument = monument
mood = stemning, humør
moon = måne
moped = knallert
morals = moral
more = flere, mere
more and more = mer og mer
moreover = desuden, videre
morning = morgen
morphia = morfin
morphine = morfin
mosaic = mosaik
mosaic work = mosaik
Moscow = Moskva
Moslem = muhamedaner
mosque = moské
motel = motel
moth = møl
mother = moder, mor
mother-in-law = svigermor
motion picture = film
motive = bevæggrund
motor = motor
motor-boat = motorbåd
motor car = bil, automobil
motorcycle = motorcykel
motorist = bilist
motor-launch = motorbåd
mountain = bjerg
mountain-ash = røn
mountain climber = Alpinist
mountaineer = Alpinist
mountain hut = alpehytte
mountain pasture = sæter
mounting = montage
mourn = sørge, beklage
mouse = mus
moustache = overskæg
mouth = mund
move = rykke, røre sig, flytte, flytning
movement = bevægelse
movie = film
movie theatre = biograf
moving = følsom, modtagelig
mow = slå
Mr. = herr, herre
Mrs. = fru, frue
mud = dynd
mudguard = stænkskærm
multiply = multiplicere
multitude = mængd
munition = ammunition
murder = mord
murderer = morder
murk = mørke
muscle = muskel
museum = museum
mush = grød, vælling
mushroom = champignon, svamp, champingnon
music = musik
musical = musical
musical instrument = musikinstrument
musical time = takt
musician = musiker
Muslim = muhamedaner
Mussulman = muhamedaner
must = måtte, skulle
mustard = sennop
mute = stum
mutiny = mytteri, opstand
mutton = fårekød
mutual = gensidig
mutual understanding = samtykke
my = min, mit, mine
mythology = mytologi
naïf = naiv
nail = søm, negl
naïve = naiv
naked = nøgen
nakedness = nøgenhed
name = navn, benævnelse
nameless = anonym
namely = nemlig
nape = nakke
napkin = serviet
narrate = fortælle
narrative = fortælling
narrow = smal, tæt
nasty = afskyelig, ubehagelig, grim, dårlig, ilde, ond, slet, uærlig, uvenlig
nation = nation, folk
national = national
nationality = nationalitet
natural = naturlig
naturally = naturligvis
nature = karakter, natur
naught = nul
nausea = væmmelse
near = hos, nær, nærheden
nearby = hos, nær, nærheden
nearest = næst
nearly = næsten
nearness = nærhed
near to = hos
necessary = nødvendig
necessity = nødvendighed
neck = hals
necktie = slips
need = behøve, kræve, trænge til, behov
needle = nål, knappenål
neglect = forsømme
négligé = negligé
negotiate = handle
neighbour = nabo
neighbourhood = bydel, kvarter, nabolag
neither = heller ikke, ingen
neither ... nor = hverken ... eller
neon = neon
nephew = brodersøn, nevø, søstersøn
nerve = nerve
nervous = nervøs
nest = rede
net = net
nettle = brændenælde
network = net
neutral = neutral, unpartisk
never = aldrig
never mind = det gør ikke noget
new = ny
news = nyhed
newspaper = avis
next = næst, derefter, herefter, derpå, fålgende, næste
next of kin = pårørende
next to = hos
nice = behagelig, rar, god
niece = broderdatter, niece, søsterdatter
night = nat
nightmare = mareridt
nine = ni
nineteen = nitten
nineteenth = nittende
ninety = halvfems
ninth = niende
no = nej
nobility = adel
noble = ædel
nobody = ingen
node = knude
no doubt = uden tvivl
noise = larm
non-alcoholic = alkoholfri
non-attendance = fraværelse
noncom = underofficer
non-commissioned officer = underofficer
none = ingen
non-military = civil
noon = middag
no-one = ingen
nor = heller ikke
normal = normal
north = nord
North America = Nordamerika
northern = nordlig
North Sea = Nordsøen
Norway = Norge
Norwegian = norsk, nordmand
nose = næse
not = ikke
notary = notar
not at all = ingenlunde, slet ikke
note = billet, kommentar
notebook = notesbog
noteworthy = mærkelig
notice = opslag, meddelelse, lægge mærke til, iagttagelse, bekendtgørelse
notification = meddelelse
notion = begreb
not on any account = ingenlunde
not yet = endnu ikke
nought = nul
nourish = fodre, nære
nourishment = næring
novel = ny, roman
novelty = nyhed
November = november
now = nå, nu
nowadays = nu for tiden, nu til dags
now and then = af og til, fra tid til anden
nowhere = ingensteds, intetsteds
nucleus = kærne, kerne
nude = nøgen
nudity = nøgenhed
null = nul
number = husnummer, tal, antal, nummer
number of the house = husnummer
numberplate = nummerplade
numeral = nummer
nun = nonne
nurse = passe, pleje, sygeplejerske, se after
nut = møtrik
nuts = sindssyg
nylon = nylon