#setName = words_en_fr_pp
#sideOneTitle = ENG
#sideTwoTitle = FRE
pace = faire les cent pas, pas
Pacific = Pacifique, océan Pacifique
Pacific Ocean = Pacifique, océan Pacifique
pacifier = aspirateur, soucette, sucette
pack = paquet
packet = paquet
pad = bloc, rembourrer
paddle = barboter, patauger
padre = aumônier
page = page
pail = seau
pain = douleur, mal, peine
painful = pénible
paint = couleur, peinture, peindre, dépeindre
paintbrush = pinceau
painter = peintre
pair = apparier, couple, paire
pair of pincers = tenailles
Pakistan = Pakistan
Pakistani = Pakistanaise, Pakistanais
Pakistani woman = Pakistanaise
pal = camarade
palace = palais
pale = pâle
Palestine = Palestinien
Palestinian = Palestine, Palestinien
palladium = palladium
palm = paume, palmier
Palm Sunday = Rameaux
palmtree = palmier
pamper = choyer, dorloter
pamphlet = brochure
Pan = Pan
Panama = Panama
Panamanian = Panaméen
Panamanian woman = Panaméenne
pancake = crêpe
Pandora = Pandore
panel = lambris, panneau
panic = panique
pansy = pensée
panther = panthère
panties = caleçon, culotte
pantry = buffet, office, réserve
pants = pantalon
paparazzo = paparazzo
paper = document, papier, tapisser
paperback = brochure
paprika = paprika
Papuan = Papou
parachute = parachute
parade = parader, pompe
paradise = paradis
paradox = paradoxe
paraffin-oil = pétrole
paragraph = alinéa
parallel = parallèle
paralyse = paralyser
parapet = balustrade, rampe
parasite = parasite, parasite
parcel = paquet
pardon = excuser, pardonner, pardon
parenthesis = parenthèse
parents = parents, père et mère
parents-in-law = beaux-parents
Paris = Pâris, Panam, Paname, Paris
parish = paroisse
Parisian = Parisien
park = garer, stationner, parc
parliament = parlement
parlour = salon
parrot = perroquet
parsley = persil
part = contingent, part, partie, portion, rôle
parterre = parterre
Parthian = Parthe
partially = en partie
participate = participer, prendre part
participle = participe
particular = particulier, spécial
particularly = particulièrement, spécialement, surtout
partly = en partie
partridge = perdrix
party = fête, adhérents, parti, suite
party members = adhérents
pass = permission, col, donner, passer, dépasser, doubler
passage = corridor, couloir
pass away = décéder, mourir
pass by = passer, passer, dépasser
passenger = passager
passion = ardeur, passion
passport = passeport
pass the night = passer la nuit
pass through = abattre, parcourir
past = passé, au-delà de
paste = agglutiner, coller, pâte
paste up = agglutiner, coller
pastor = pasteur, abbé, curé, prêtre
pat = taper
patch = rapiécer
patch up = rapiécer
pate = tête, pâté
path = chemin, piste, sentier
patience = patience
patient = patient
patriot = patriote
patrol = reconnaissance
patrolman = gendarme
patron = protecteur
pattern = schéma, modèle, patron
pause = pause, repos, trêve
pavement = pavé, trottoir
pavilion = pavillon
paw = jambe, patte, pied
pawn = emprunter sur gages, soldat
pay = payer
pay attention = surveiller
pay attention to = surveiller, faire attention à, prêter attention à
paying off = congé
payment = réglement, paye, versement
pay off = acquitter
pay out = dépenser
pea = pois
peace = paix
peach = pêche
peacock = paon
peak = bout, cime, pointe, sommet
peal = sonner, tinter
peanut = arachide, cacahouète, cacahuète
pear = poire
pearl = perle
pear-tree = poirier
peasant = paysan
peat = tourbe
peculiar = drôle, étrange, singulier
pedal = pédale
pedestrian = piéton
peel = dépouiller, coque, écorce
peep = gazouiller, pépier
peevish = maussade
peg = apéritif, apéro
Pegasus = Pégase
Peiping = Pékin
Peking = Pékin
pelican = pélican
pelvis = bassin, bol
pen = plume
pencil = crayon
Penelope = Pénélope
penetrate = entrer, pénétrer
peninsula = péninsule, presqu'île
penis = pénis
pension = pension, retraite
Pentateuch = Pentateuque
Pentecost = Pentecôte
penthouse = abri, hangar
people = gens, peuple
pepper = poivre
per = au milie de, en, dans, parmi, à, à raison de, par
perceive = s'apercevoir, se rendre compte, apercevoir, discerner, percevoir, saisir
percent = pourcentage
percentage = pourcentage
perchance = peut-être
perfect = accompli, achevé, parfait
perfection = perfection
perform = paraître, apparaître, surgir, entrer, entrer dans, construire, fabriquer, faire, opérer, poser, accomplir, assurer, réaliser, remplir, offrir, présenter
perfume = parfumer, parfum
perhaps = peut-être
peril = danger, peril
period = période, point
periodical = gazette, journal, revue
perish = périr, s'abîmer
periwinkle = pervenche
permanent = continuel, constant, invariable, permanent
permission = autorisation, licence, permis, permission
permit = permettre
perplexity = embarras
persecute = poursuivre
persevere = persévérer, perséverer, persister
Persia = Iran, Perse
Persian = Iranien, Persan
Persian Gulf = golfe Persique
Persian woman = Iranienne, Persane
persist = persévérer, s'obstiner, perséverer, persister
person = personnage, personne, individu
personal = personnel, propre
personality = caractère
perspective = perspective
perspiration = sueur
persuade = convaincre, inspirer, persuader
perturb = brouiller, déranger, perturber, rendre confus, rendre trouble
Peru = Pérou
pessimism = pessimisme
pessimist = pessimiste
pestle = pistil
pet = choyer, dorloter
petal = pétale
petrol = essence
petroleum = pétrole
pettish = maussade
petulant = maussade, malin
phantom = apparition
pharmaceutical = remède
phase = phase
pheasant = faisan
pheasant's eye = adonis
phenomenon = phénomène
phi = horreur, ignominie
Philippine = des Philippines, philippin
Philippine Islands = Philippines
Philippines = Philippines
Philippine woman = Philippine
philosophy = philosophie
phoenix = phénix
phone booth = cabine téléphonique
phonograph = phonographe
phosphorus = phosphore
photograph = photographier, photo
photographer = photographe
photography = photographie
physician = docteur, médecin, docteur médecin
physics = physique
piano = piano
pick = piquer, cueillir, rammasser
pick-axe = pioche
pickle = affreux jojo, gamin, morpion, saler
pick out = adopter, choisir, désigner, opter
pick up = accélérer, hente, collectionner, ramasser, rassembler, recueillir, prendre
picture = image, figure
picturesque = pittoresque
pie = pâté, tarte
piece = contingent, part, partie, portion, fragment, morceau, pan, pièce
piece of furniture = meuble
piece of mail = correspondance, courrier
pier = débarcadère
pig = cochon, porc
pigeon = colombe, pigeon
pigeonhole = domaine, spécialité
piglet = cochonnet, goret
pigmy = pygmée
pike = brochet
pile = amas, foule, masse, multitude, hémorrhoïde, tas
pile up = accumuler, entasser, ramasser, rassembler
pill = pilule
pillar = colonne, pilier
pillow = oreiller
pilot = pilote
pimple = bouton
pin = épingle
pincers = pinces, tenailles
pinch = pincer
pine = pin
pineapple = ananas
pine-tree = pin
pink = oeillet, rose
pioneer = pionnier
pious = pieux
pip = grain, graine, pépin
pipe = pipe, tube, tuyau
pistol = pistolet
piston = piston
pit = fossé, centre, noyau
pitcher = cruche
pitiful = malheureux, misérable, pauvre
pity = mal, avoir pitié, compatir, plaindre, s'apitoyer, apitoiement, compassion, pitié
pivot = pivot
placard = afficher, affiche, placard, agglutiner, coller
place = adapter, local, placer, situer, déstination, endroit, lieu, localité, place, appliquer, mettre, poser
place of refuge = abri, refuge
place of worship = église
plain = plaine, clair, limpide, net
plait = natter, tisser, tresser
plan = dessein, intention, propos, plan, projeter, projet, esquisser
plane = aéroplane, avion, planer, plan, projet, platane, rabot
planet = planète
plane-tree = platane
plank = panneau, planche
plant = végétal, planter, plante
plash = barboter, clapoter
plaster = revêtir, stuc
plaster of Paris = plâtre
plastic = plastique, matière plastique
plate = met, plat, plaque, assiette
plateau = plateau
platform = tenue, quai, estrade, programme
platinum = platine
Plato = Platon
platter = met, plat
plausible = vraisamblable
play = représenter, jouer, représenter, pièce de théâtre
plaza = esplanade, place, rond-point
plea = argument, plaider
plead = plaider
pleasant = agréable
pleasantly = agréablement
pleasantness = agrément
please = s'il vous plaît, s.v.p., plaire
pleased = content, satisfait
pleasure = plaisir
plentiful = abondant
plenty = abondance
plenty of = beaucoup de
plot = intrigue
plough = labourer, charrue
pluck = cueillir, rammasser
plug = bougie, bougie électrique, bouchon, prise de courant mâle
plug in = aboucher, connecter
plug up = boucher, raccommoder
plum = prune
plunder = piller, ravir
plunge = plonger
plus = plus
Pluto = Pluton
plutonium = plutonium
pocket = poche
podium = estrade
poem = poème
poet = poète
poetry = poésie
point = bout, cime, pointe, sommet, score, point
pointed = pointu
point out = indiquer, montrer, désigner, marquer
poison = poison, venin
poisonous = venimeux
Poland = Pologne
pole = pieu, poteau, pôle, barre, barreau, bâton, gaule, perche
police = police
policeman = agent
police-station = commissariat
policy = politique
polish = polir, tailler
Polish woman = Polonaise
polite = courtois, poli
politeness = politesse
politics = politique
Polynesia = Polynésie
Polynesian = Polynésien
polyp = pieuvre
polyvinyl chloride = chlorure de polyvinyle
Pomerania = Poméranie
pomp = pompe, splendeur
pond = étang
pool = s'accoupler, piscine
poor = misérable, mal, mauvais, méchant, pauvre, malheureux
pope = pape
poplar = peuplier
poppy = coquelicot, pavot
popular = populaire
population = population
pork = porc
porpoise = marsouin
port = port
portent = augure
porter = bagagiste, porteur
porthole = lucarne
portrait = portrait
port side = bâbord
Portugal = Portugal
Portuguese = portugais, langue portugaise
Portuguese language = portugais, langue portugaise
Portuguese woman = Portugaise
pose = agir avec affectation, poser, prétendre à, s'ériger en
poseur = faiseur d'embarras, poseur
position = position
positive = positif
possess = posséder
possession = possession
possible = possible
possibly = peut-être
post = afficher, agglutiner, coller, pieu, poteau, fonction, office, service, emploi, place, courrier, poste
postage = port
postage stamp = timbre, timbre-poste
postal rates = tarif postal
postcard = carte postale
poster = affiche, placard
postman = facteur
post office = bureau de poste
post-paid = affranchi
postpone = ajourner, différer, reculer, renvoyer, retarder, suspendre
postulate = demander, exiger
post up = afficher, agglutiner, coller
pot = pot
potassium = potassium
potato = pomme de terre
pound = broyer, piler
pour = verser
pour out = verser
powder = poudre
power = puissance
powerful = puissant
power station = central, centrale
practical = réel
practice = appliquer, exercice, pratiquer, pratique
practise = exercer, instruire
Prague = Prague
praise = glorifier, louange
prawn = crevette
pray = prier
prayer = prière
preach = prêcher
precede = avancer, précéder
precious = rare
precipice = gouffre, abîme
precise = net, précis
precision = exactitude
precize = net
predisposition = aptitude, disposition
predominant = principal
predominating = souverain
preface = introduction
prefer = aimer mieux, préférer
preferably = de préférence, mieux, le mieux, plutôt, volontiers
prefix = préfixe
pregnant = pleine, enceinte, pleine
prejudice = parti-pris, préjugé
premium = prix, récompense
preparation = préparation, préparatif
prepare = préparer, apprêter
prepay = affranchir
preposition = préposition
presage = augure
prescription = recette, ordonnance
presence = présence
present = actuel, cadeau, don, offrir, présenter, présenter, présent
presentation = représentation, proposition, séance, offre, proposition
present-day = actuel
present with = offrir, présenter
preservation = garde
preservative = préservatif
preserve = préserver, confire, conserver, maintenir, retenir
preside = présider
president = président, speaker
press = presse, serrer, serrer plus fort, tasser, appuyer en écrasant, serrer, être urgent, presser
press firmly = presser, serrer, serrer plus fort, tasser
pressure = impulsion, vive sollicitation, instance, instances, pression, oppression
prestige = gloire, prestige
presume = aspirer à, prétendre à, supposer
pretend = prétexter, se retrancher
pretext = prétexte
pretty = aimable, bath, joli, mignon
prevent = empêcher, prévenir
previous = précédent
previously = auparavant, autrefois, devant
prey = proie
price = prix
pricey = précieux, cher, coûteux
prick = bitte, zob, piqûre
priest = abbé, curé, prêtre
primeval forest = forêt vierge
primrose = primevère
prince = prince
Prince Edward Island = Ile-du-Prince-Edouard
princess = princesse
principal = dominant, principal
principally = principalement, surtout
principle = principe
print = impression, imprimer
printed matter = impression
printer = imprimeur
prior = précédent
prison = prison
prisoner = prisonnier
private = privé
privet = troène
privilege = privilège
privileged = privilégié
prize = prix, récompense
probable = probable, vraisemblable
probably = probablement
problem = problème
proboscis = trompe
procedure = procédé, recette
proceed = procéder
proceed with = continuer, maintenir, reconduire
process = procédé, recette, processus
procession = procession
proclaim = proclamer
proclamation = déclaration
procure = procurer
produce = produire, réaliser
production = production
profane = violer
profess = confesser, reconnaître, avouer
profession = profession
professor = professeur
profit = bénéfice, profiter, avantage, gain, profit
profound = profond
profuse = abondant
prognosis = prognostic
programme = programme
progress = avancer, progresser, progrès
prohibit = interdire
project = projeter une image, projet
proletarian = prolétaire
prologue = prologue
promenade = promenade
promise = assurer, promettre, promesse
promote = promouvoir
promotion = année, avancement, promotion
promotor = promoteur
prompt = ponctuel, mobile
pronounce = prononcer
proof = preuve, témoignage
prop = appui
propaganda = propagande
propeller = hélice
proper = convenable, exact, juste
properly = convenablement, proprement
property = bien, domaine, fonds, propriété foncière, propriété, qualité, possession
prophesy = augurer, prédire
prophet = prophète
proportion = proportion
proposal = offre, proposition
propose = proposer
prosecute = poursuivre
prospectus = prospectus
prosper = prospérer
prosperity = prospérité
prostitute = prostituer, fille, fille publique, prostituée, putain
prostitution = prostitution
protect = préserver, assurer, protéger, abriter, garantir
protect from = s'abriter, se mettre à l'abri de
protection = garde, protection
protectionist = protecteur
protein = protéine
protest = protester, protestation
Protestant = protestant
Proteus = Protée
protocol = compte-rendu, procès-verbal, protocole
proton = proton
prototype = prototype
proud = altier, fier
prove = démontrer, prouver
proverb = proverbe, sentence
provide = munir, pourvoir
provided that = à condition que, si
province = province
provisional = provisoire, temporaire
provoke = agacer, irriter, provoquer
provost = maire
proximity = voisinage
prude = bégueule
prudence = précaution, prudence
prudent = prudent, raisonnable, sage
prudish = bégueule
Prussia = Prusse
Prussian = Prussien
psalm = psaume
pseudonym = pseudonyme
psyche = psychisme
psychiatrist = aliéniste, psychiatre
psychiatry = psychiatrie
psychic = psychique
psychologist = psychologue
psychology = psychologie
Ptolemy = Ptolémée
pub = abreuvoir
puberty = adolescence
public = public
publicity = propagande, publicité
publicize = propager
public prosecutor = procureur
public square = esplanade, place, rond-point
publish = éditer, publier
pull = tirer
pull down = abattre, démolir
pull out = répandre
pullover sweater = chandail, pull-over
pull to pieces = abaisser, aboyer à
pulse = pouls
pulverize = moudre
puma = puma
pump = pomper, pompe
pumpkin = potiron
punctual = ponctuel
punctuate = parsemer
punctuation = ponctuation
punish = punir
punishment = peine, punition
puppet = guignol, marionnette, poupée
purchase = achat, emplette, acheter, acquérir
purchaser = acheteur, acquéreur
pure = blanc, propre, pur
purge = affinier, purifier
purity = propreté
purple = pourpre
purpose = but, dessein
purse = porte-monnaie, sacoche
pursue = poursuivre
pursue one's point = persévérer, persister
pus = pus
push = pousser
push along = faire glisser, fourrer
pussy = chatte, con
put = appliquer, mettre, poser
put away = serrer, fourrer, introduire, mettre, enlever, ôter
put down = appliquer, mettre, poser
put in = fourrer, introduire, mettre
put in order = ordonner, ranger, régler
put off = enlever
put on = activer, appliquer, imposer, mettre, revêtir
put on airs = agir avec affectation
put on stamps = affranchir
put on the stage = offrir, présenter
put onto = appliquer, apposer
put out = éteindre
put out to tender = mettre à l'entreprise, mettre en adjudication
putrefy = pourrir
put right = joindre, redresser un jugement
put to bed = coucher
put together = assembler, joindre
put to sleep = assoupir
put up = adapter, abriter
put up with = endurer, souffrir, subir, tolérer
puzzle = énigme, puzzle, confondre, troubler, abasourdir, consterner, stupéfier
PVC = chlorure de polyvinyle
pyjamas = pyjama
pyramid = pyramide