#setName = words_en_pt_aa
#sideOneTitle = ENG
#sideTwoTitle = POR
a = dentro de,em, alguém, algum, uma pessoa, a por, à razão de, um
Aaron = Aarão
abacus = ábaco
abandon = abandonar, abrir mão de, renunciar, resignar
abandonment = abandono, abdicação, cessão, submissão, naturalidade, simplicidade
abash = embaraçar, estorvar
abashed = acanhado, vergonhoso
abashment = aperto, embaraço, estorvo, óbice, perplexidade
abatement = abatimento, desconto
abbacy = abadia
abbatial = abacial
abbess = abadessa
abbey = abadia
abbot = abade
abbotcy = abadia
abbotship = abadia
abbreviation = abreviação
ABC = abc, alfabeto, cartilha de abc, conhecimento elementar
ABC book = cartilha de abc
abdicate = abdicar, demitir-se
abdication = abdicação, demissão
abdomen = abdome, barriga, ventre, abdômen, pança
abdominal = abdominal, relativo ao abdome, ventral
abductor = abdutor
aberration = aberração, defeito, erro, passo em falso
abet = agitar, amotinar, sacolejar, sacudir, ajudar, assistir, concitar, incitar, provocar, amparar, sustenar, suportar, escorar
abhor = abominar, detestar, ter nojo de
abhorrence = abominação, asco, horror, repulsão
abhorrent = abominável, repugnante, nauseante
abide = aguardar, esperar, estar à espera de, aguentar, agüentar, tolerar, insistir, perseverar, persistir, padecer, sofrer, suportar
abiding = duradouro
ability = faculdade, habilidade, poder, aptidão, conveniência, capacidade
abiogenesis = abiogenêse, abiogenesia
abject = desprezível, miserável
abjure = renunciar, anular, declarar sem efeito, revogar
ablative = ablativo
ablaze = ardente
able = apto, hábil, capaz, autorizado, competente, habilitado
abnegate = abnegar, renunciar
abnegation = abnegação, desprendimento
abnormal = anômalo, anormal
abnormity = anomalia
abode = domicílio, aposento, habitação, morada
abolish = abolir, anular, extinguir, declarar sem efeito, revogar
abolition = abolição
abominable = abominável, repugnante, nauseante
abominate = abominar, detestar, ter nojo de
abomination = algo repugnante, abominação, asco, horror, repulsão
aboriginal = aborígene, indígena, nativo, relativo ao país mesmo
abort = abortar, fazer abortar, fracassar, malograr-se, fanar, morrer, ter mau êxito
abortion = abortamento, fiasco, malogro
abortive = inócuo, baldio, estéril, fútil, improfícuo, inútil, vão
abound = abundar, enxamear, formigar, pulular
about = acerca de, a respeito de, quanto a, aproximadamente, cerca, ao derredor de, cerca de, em redor de, em torno de, em volta de
about-face = mudança
above = acima de, sobre, para cima
above all = em especial, principalmente, sobretudo
above-board = honesto, franco, sincero
abracadabra = divagação
Abraham = Abraão
abrasion = abrasão
abrasive = acre, afiado, agudo, cortante, penetrante, picante, ríspido
abridge = demarcar, limitar, restringir
abridgement = resumo, sumário
abroad = ao estrangeiro, fora, de for a, exterior
abrogate = abolir, anular, extinguir, revogar, declarar sem efeito
abrogation = abolição, ab-rogação
abrupt = abrupto, chocante, rude, escarpado, íngreme, inesperado, inopinado, brusco, repentino, súbito
abscess = abscesso, apostema
abscissa = abcissa, abscissa
absence = ausência, carência, falha, falta
absence of mind = distracção
absent = ausente
absent onself = afastar-se, ausentar-se, partir, retirar-se
absinth = <licor verde preparado do absíntio>, absíntio, losna, artemijem, artemísia, erva-de-são-joão
absolute = absoluto, completo
absolutely = com efeito, de facto, efectivamente, absolutamente, impreterivelmente, infalivelmente, sem falta, deveras, na realidade, na verdade, verdadeiramente
absolute power = autocracia
absolute rule = autocracia
absolute ruler = autócrata
absolution = absolvição, perdão
absolutism = absolutismo
absolve = absolver
absorb = absorver, preocupar, dispor de, ter à disposição, sorver
absorbent = absorvente, hidrófilo
absorbing = fascinante, fascinador
abstain = abster-se
abstemious = comedido, parco, sério, sóbrio
abstention = abstinência
abstinence = abstinência
abstract = abstracto, abstrair, fazer abstracção de, deduzir, inferir, deter, reter, arrancar, tomar, concluir, depreender, tirar conclusão de, resumir, tornar a somar, resumo, sumário, teórico
abstraction = abstracção, coisa abstracta, distracção, extração, furto
absurd = absurdo, disparatado
absurdity = coisa absurda, absurdeza, absurdidade, absurdo
abundance = abundância, fartura, riqueza
abundant = abundante, basto, copioso, farto, lauto
abuse = insultar, injúria, insulto, defeito, desvantagem, inconveniente, fazer mau uso de, empregar mal, injuriar, ofender, ultrajar, tortura, atormentar, supliciar, torturar, mortificar
abutment = contraforte
abysmal = desesperado, horrível, terrível, imenso
abyss = abismo, boqueirão, fundão, pélago, precipício, sorvedouro
Abyssinia = Abissínia, Etiópia
Abyssinian = abexim
acacia = acácia
academic = acadêmico, estudante, universitário
academician = acadêmico
academy = academia
acanthus = acanto, erva-gigante
accede = <tornar-se membro de um grupo>, anuir, concordar, estar de acordo
accelerate = acelerar, adiantar, apressar, atirar, aumentar a velocidade de
acceleration = acelerção
accelerator = acelerador
accelerator pedal = acelerador
accent = acentuar, acento, enfatizar, ênfase
accent mark = acento
accentuate = acentuar, enfatizar
accept = aceitar, acolher, admitir, receber, topar
acceptance = aceitação, acolhida, acolhimento, admissão
access = crise, agressão, ataque, arranco, impulso
accessible = acessível, alcançável, atingível, impressionável, sensível
accession = presa, aquisição, ascensão ao trono
accessory = acessório, secundário, anexo
accidence = acaso, azar, casualidade
accident = acidente, sinistro
accidental = acidental, fortuito
acclaim = aclamar, ovacionar, aclamação, ovação, aplaudir, aprovar, bater palmas, louvar, aplauso
acclamation = aclamação, ovação, aplauso
acclimatize = aclimar, aclimatar
acclivity = declive, encosta, ladeira, rampa, vertente
accommodate = acomodar, adaptar, ajeitar, ajustar
accommodating = serviçal
accommodation = acomodação, arranjo, disposição, compromisso, aposento, habitação, morada
accomodate = acomodar, adaptar, ajustar, arranjar, acabar, encerrar, finalizar, terminar, hospedar, ajudar, auxiliar, socorrer
accomodate oneself = adaptar-se
accompaniment = acompanhamento
accompanist = acompanhante, acólito, companheiro
accompany = acompanhar, seguir
accompanying = anexado
accomplish = abranger, alcançar, atingir, chegar a, obter, tocar, efectivar, efectuar, realizar, acabar, levar ao cabo, cumprir, desempenhar
accomplished = autorizado, competente, habilitado, experiente, perito, versado, talentoso
accomplishment = façanha, feito, obra, ação
accord = acordar, estar de acordo, acorde, acordo, ajuste, concordância, conformidade, convenção, estar em harmonia, aquiescer, consentir, permitir
accordance = acorde, acordo, ajuste, concordância, conformidade, convenção
according as = ao longo de, conforme, de acordo de, relativamente a
accordingly = então, portanto, logo, por conseguinte, sendo assim
according to = ao longo de, conforme, de acordo de, relativamente a
accordion = acordeão, harmônica, gaita, sanfona
account = factura, nota, informação, explicação, comunicação, considerar, refletir, conta, acreditar, crer, causa, motivo, razão, julgar, opinar, ser de opinião
account book = registro
account for = explicar, compor, constituir, estabelecer
accounting = escrituração, contabilidade
accoutrement = equipamento
accoutrements = equipamento
accredit = atribuir, conferir, imputar, julgar, acreditar, crer
accrue = derivar, provir, vir de, aumentar, avultar, crescer, altear, elevar-se, subir
accumulate = juntar em excesso, acumular, amontoar, empilhar, acumular-se, amontoar-se
accumulation = acumulação, amontoamento, acervo, acúmulo, chusma, cúmulo, montão, multidão, pilha, ruma
accumulator = acumulador
accuracy = exactidão, precisão
accurate = pontual, certo, exacto, exato, preciso
accusal = acusação, arguição
accusation = acusação, arguição, denúncia
accusative = acusativo
accuse = arguir, criminar, inculpar, delatar, denunciar, acusar, culpar
accused = acusado
accuser = acusador
accustom = costumar, estar habitado a, ter o costume de
accustomed = usual
ace = ás
acerbic = acerbo, adstringente, acre, afiado, agudo, cortante, penetrante, picante, ríspido, amargo, amargoso, amaro
acerbity = acrimônia, acuidade, agrura, agudeza, amargor, amargura
acetate = acetato
acetic acid = aceto, vinagre
acetone = acetona
acetous = acerbo, ácido, azedo
acetylene = acetilene, acetilênio, acetileno
Achaea = Acaia
Achaia = Acaia
ache = almejar, anelar, aspirar, causar dor, doer, aflição, dor, dar ais, suspirar, ter saudades de
Acheron = Aqueronte
achievable = realizável
achieve = adquirir, arranjar, abranger, alcançar, atingir, chegar a, obter, tocar, efectivar, efectuar, realizar, acabar, levar ao cabo, fazer, formar, executar, cometer, confeccionar, cumprir, desempenhar
achievement = acção, façanha, feito, obra, ação, bom êxito, sucesso
Achilles = Aquiles
Achilles' tendon = tendão de Aquiles
achrostic = acróstico
acid = acerbo, azedo, ácido, adstringente, acre, afiado, agudo, cortante, penetrante, picante, ríspido, sarcástico
acidify = azedar, azedar-se
acidity = acidez, acididade, azedume
acidness = acidez, acididade, azedume, sarcasmo
acknowledge = admitir a veracidade de, confessar, professar, reconhecer, confirmar, homologar, ratificar
acknowledgement = confissão, recibo
acme = apogeu
acne = acnéia, dartro
acolyte = adepto, partidário, acólito, sacristão, cidadão, membro, sócio
aconite = acônito
acoustic = acústico
acoustics = acústica
acquaint = participar, informar, noticiar, notificar
acquaintance = pessoa conhecida
acquire = adquirir, arranjar, obter, comprar
acquirement = aquisição
acquisition = presa, aquisição, coisa comprada, compra
acquisitive = ávido, cobiçoso, sedento, sequioso
acquit = absolver
acquittal = absolvição
acre = acre, jeira
acrid = acerbo, acre, afiado, agudo, cortante, penetrante, picante, ríspido
acrimonious = acre, afiado, agudo, cortante, penetrante, picante, ríspido
acrimony = acrimônia, acuidade, agrura, agudeza
acrobat = acrobata
acronym = acrografia, sigla
across = transversalmente, além de, através de, do outro lado de, para lá de, além, do outra lado
across from = contra, defronte de, em frente de, em troca de
act = obrar, acção, funcionar como actor, auto, instrumento, acto, auto, escritura, instrumento, actuar, agir, produzir efeito, ser eficaz, fazer, formar, executar, cometer, confeccionar, façanha, feito, obra, ação, influenciar, apresentar, oferecer, proceder
act as agent = mediar
act as a middleman = corretar
act as patron = patrocinar, proteger
act for = representar
acting = representação
actinium = actínia, anêmona-do-mar, urtiga-do-mar, actínio
action = açcão, actividade, acção, batalha, combate, luta, peleja, pugna, façanha, feito, obra, influência, ação, pleito, processo
activate = activar, causar, produzir, ser causa de
active = activo, diligente, activo, agencioso, diligente, laborioso, operoso, trabalhador
activity = açcão, actividade, vivacidade, animação
act of grace = anistia, indulto geral
actor = actor, artista, comediante
act out = efectivar, efectuar, realizar
actress = actriz
actual = efectivo, hodierno, real, verdadeiro
actually = com efeito, de facto, efectivamente
actuary = actuário
actuate = mexer, mover
acuity = acrimônia, acuidade, agrura, agudeza, atenção
acupuncture = acupuntura
acute = acre, afiado, cortante, penetrante, picante, ríspido, agudo, pontiagudo, forte, intensivo, intenso, sagaz, astuto
ad = anúncio, reclamo, publicidade
adage = provérbio
adagio = adágio
Adam = Adão
adamant = resistente
adapt = ajustar, acomodar, adaptar, ajeitar, ajustar, adaptar-se, adaptar
adaptable = adaptável, ajustável
adaptation = adaptação, ajuste
adapt oneself = adaptar-se
add = somar, somar, acrescentar, dicionar, adicionar, ajuntar
adder = cobra, víbora
addition = adição, soma, acréscimo, emenda, suplemento
additional = aditivio, suplementar, outro, restante, extra
addled = podre, pútrido, estúpido, imbecil, tolo
address = endereçar, destino, endereço, sobrescrito
addressee = destinatário
address list = livro de endereços
add up = somar, adicionar, somar, totalizar
Aden = Áden
adept = adepto, partidário, mestre, experiente, perito, versado
adequate = adequado, apropriado
adhere = amoldar-se, adaptar-se, conformar-se
adherent = adepto, partidário
adherents = <grupo não organizado>
adhesion = adesão
adhesive = adesivo
adhesive plaster = diaquilão
adhesive tape = fita adesiva
adiabatic = adiabático
adieu = adeus, até logo
ad infinitum = infinitamente
adipose = adipose, obesidade
adjacent = apenso, contíguo, junto, vizinho, próximo, adjacente
adjective = adjetivo
adjoining = adjacente
adjourn = adiar, procrastinar
adjournment = adiamento, demora, protelação
adjudicate = pronunciar veredicto
adjudication = sentença, veredicto
adjunct = acréscimo, emenda, suplemento
adjust = acomodar, ajeitar, ajustar, adaptar, ajustar, adaptar, dispor
adjustable wrench = chave
adjustment = adaptação, ajuste, arranjo, disposição
adjutant = ajutante de ordens
administer = gerir, administrar, gerir, reger
administer the last sacraments = ungir
administration = administração, administração, governo
administrative = administrativo
administrator = administrador, gerente
admirable = admirável
admiral = almirante
admirality = almirantado
Admirality Islands = Ilhas do Almirantado
admiralship = almirantado
admiration = admiração
admire = admirar, ficar encantado com
admirer = admiradora, admirador
admission = aceitação, acolhida, acolhimento, admissão, confissão
admit = confessar, professar, reconhecer, aquiescer, consentir, permitir
admittance = admitância
admixture = mistura
admonish = admoestar, advertir, exortar, induzir, repreender
admonition = admoestação, repreensão
ado = barulho, ruído
adobe = adobe, adobo, tijolo cru
adolescent = adolescente
Adonis = Adônis
adopt = admitir, aceitar, admitir, adotar como própria
adopted = adoptivo
adoption = adopção
adoptive = adoptivo
adorable = adorável
adoration = adoração
adore = adorar, idolatrar, reverenciar
adorer = adorador
adorn = fazer decoração, adornar, decorar, ornamentar
adornment = adorno, ornamento
adrenaline = adrenalina
Adrian = Adriano
Adriatic = Adriático
Adriatic Sea = Adriático
adroit = hábil, jeitoso, ágil, alerta, animado, bem disposto, vivo, vigoroso, expedito
adult = adulto, maior
adulterate = diluir, falsificar
adulterer = adúltero
adulterous = adulterino
adultery = adultério
advance = dirigir-se, acercar-se, aproximar-se, adiantar-se, avançar, elevar, altear, elevar-se, subir, ganhar terreno, progredir
advancement = progresso
advantage = benefício, utilidade, vantagem
advantageous = favorável, propício, profícuo, útil, vantajoso, salutar
advent = Advento
adventitious = acessório, secundário, acidental, fortuito
adventure = aventura
adventurer = aventureiro
adventurous = aventureiro
adverb = advérbio
adverbial = advérbio
adversary = advesário, antagonista, competidor, contrário, inimigo
adverse = daninho, nocivo, prejudicial
advert = atender, fixar a atenção em, prestar a atenção, reclamo, publicidade
advertence = atenção
advertency = atenção
advertise = anunciar, noticiar, notificar, fazer propaganda de, fazer reclamo de
advertisement = anúncio, reclamo, publicidade
advice = conselho
advisable = aconselhável
advise = anunciar, avisar, comunicar, aconselhar, persuadir
advocate = advogado
adze = enxó
Aegean = Mar Egeu
Aegean Sea = Mar Egeu
aegis = amparo, defesa, protecção, égide
Aeneas = Enéias
Aeolus = Éolo
aeon = éon
aerate = arejar, abanar, joeirar, ventilar
aerial = aéreo, antena
aerobatics = acrobacias aéreas
aerobic = aeróbio
aerodrome = aeródromo, aeroporto
aerogramme = aerograma
aerolite = aerólito
aeronaut = aeronauta
aeronautical = <relativo à aviação>
aeronautics = aeronáutica, aviação
aeroplane = aeroplano, avião
aerosol = aerossol, aerosol
aesthete = esteta
aesthetic = estético
aesthetics = estética
aetiology = etilogia
a few = alguns, certo número de, vários
affable = afável, amável, bondoso, gentil, lhano
affair = assunto, causa, coisa, negócio, questão, caso
affect = influenciar, comover, abalar, tocar
affectation = afectação, fingimento, acção de afectar, acção de fingir
affected = afectado
affecting = comovente, enternecedor, tocante
affection = abalo, afecção, choque, comoção, impressão moral, amor, boa vontade
affectionate = que ama, dedicado
affiliate = <tornar-se membro de um grupo>, filial, sucursal
affiliation = filial, sucursal, parentesco
affined = aparentado
affinity = afinidade, parentesco
affirm = afirmar, assegurar, confirmar, dizer sim, responder que sim
affirmation = promessa
affix = afixo, aprazar, cravar, determinar, fixar
afflict = acabrunhar, afligir, angustiar
affliction = aflição, agonia, pesar
affluence = riqueza
affluent = rico
afford = aquiescer, consentir, permitir
Afghan = afegã, afegane
Afghanistan = Afeganistão
afire = ardente
aflame = ardente
afraid = tímido, timorato, medonho
afresh = de novo, novamente, outra vez
Africa = África
African = da África, africano
African marigold = tagete, cravo-de-defunto
Afrikaans = afrikaans
Afrikaner = bôer
after = detrás de, após, atrás de, depois de, por trás de, depois que
afternoon = tarde
afterwards = depois, atrás, em seguida
again = de novo, novamente, outra vez
against = contra, defronte de, em frente de, em troca de
against one's will = contra a vontade, de mau grado
Agamemnon = Agamemnon
agape = ágape
agar = ágar-ágar
agar-agar = ágar-ágar
agate = ágata
Agatha = Ágata
agave = agave, pita, piteira
age = época, idade, quadra
aged = idoso
agency = agência, <direito de representação comercial>
agenda = agenda, canhenho, memento, ritual, ordem do dia
agent = agente, ferramenta, instrumento, intendente, intermediário, mediador, representante
agglomerate = aglomerado, aglomerar
agglomeration = aglomerado, aglomeração
agglutinate = aglutinar
aggrandize = aumentar
aggregate = <aglomeração em virtude dessa força>
aggression = crise, agressão, ataque
aggressive = agressor, agressor, ofensivo, agressivo
aggressor = agressor, assaltante, atacante
aggro = agressão
agile = lépido, lesto, ágil, alerta, animado, bem disposto, vivo, vigoroso, expedito
agitate = agitar, amotinar, sacolejar, acirrar, aguçar, atiçar, estimular, excitar, inflamar, comover, tocar, inquietar, apoquentar, afligir, alarmar, abalar, estremecer, sacudir
agitated = ansioso, inquieto, desassossegado, aflicto, nervoso
agitation = alvoroço, excitação doentia, tumulto, agitação, bulício, arruaça, bulha, distúrbio, motim
aglow = ardente
agnostic = agnóstico, agnosticista