#setName = words_en_fi_u.txt
#sideOneTitle = ENG
#sideTwoTitle = FIN
ugly = huono
uncle = set‰
under = alla
underneath = alla
underpants = alushousut
understand = ymm‰rt‰‰
undertake = yritt‰‰, ponnistella
unfortunately = surukseni
unique = ainutlaatuinen
United Nations = Yhdistyneet Kansakunnat
United States of America = Amerikka, Yhdysvallat
until = saakka
untroubled = tyyni
upon = vastaan, -sta, -lla
upper-arm = olkavarsi
upper arm = olkavarsi
upset = kumota
upstairs = yl‰puolella
urge = yllytt‰‰
urgent = kiireellinen
USA = Amerikka, Yhdysvallat
US citizen = amerikkalainen
use = k‰ytt‰‰
useful = hyˆdyllinen
useless = turha
use up = kuluttaa
usual = tavallinen, yleinen
vain = turha
valiant = rohkea
valid = p‰tev‰
valley = laakso
value = arvo
vanilla = vanilja
vapor = hˆyry
vapour = hˆyry
varied = erilainen
various = erilainen
vary = vaihdella
vase = astia
vast = avara
veal = vasikanpaisti
vegetable = vihannes
vegetate = kasvaa
vend = myyd‰
venture = vaarantaa
verify = tarkastaa
vermouth = vermutti
verse = s‰e
verve = innostus
very = sangen
very much = sangen
vessel = s‰iliˆ, astia, laiva
vibrate = v‰r‰hdell‰
vicious = ilke‰
view = katsella
village = kyl‰
vinegar = ettika
violet = orvokki
violin = viulu
vision = n‰ky
visit = k‰yd‰ vieraissa
vivacity = innostus
vodka = vodka
voice = ‰‰ni
void = tyhj‰
vote = ‰‰nest‰‰
voyage = matka
wage = palkka
wager = lyˆd‰ vetoa
wages = palkka
waggon = vaunu
wail = valitella
wait = odottaa
waiter = tarjoilija
wait for = odottaa
wake = her‰tt‰‰
wake up = her‰tt‰‰
walk = marssia
wall = muuri, sein‰
walnut = saksanp‰hkin‰
wander = vaeltaa
wander about = vaeltaa
want = tahtoa
war = sota
wares = tavara
warm = l‰mmin
warn = varoittaa
warrant = taata
wash = pest‰
wasp = ampiainen
watch = kello, katsella
watch over = vartioida
water = vesi
water-closet = vessa
water-melon = vesimeloni
wave = aalto, heiluttaa
wave about = heiluttaa
way = tapa, tie
wealthy = rikas
wear = kantaa
weather = s‰‰
weave = kutoa
Wednesday = keskiviikko
week = viikko
weep = itke‰
weigh = painaa
well = no, kaivo, terve
well-informed = sivistynyt
well-known = tuttu
well-mannered = kohtelias
well-off = rikas
well then = no
west = l‰nsi
whale = valas
wharf = laituri
what = mik‰
what a = millainen, miten
what for = miksi
what kind of = millainen
what number = monesko
what sort of = millainen
wheel = pyˆr‰
when = milloin, milloin
where = minne, miss‰
whereas = aikana
where ... to = minne
which = kuka
which one's = kenen
while = aikana, aika
whilst = aikana
whim = oikku
whiskey = viski
whisky = viski
whisper = kuiskata
whistle = vihelt‰‰
white = valkea
whither = minne
who = kuka
whole = koko
wholly = aivan
whose = kenen
why = miksi
wide = avara
widow = leskirouva
widower = leski
willingly = mielell‰‰n
win = voittaa
wind = tuuli, k‰‰ri‰
window = ikkuna
wind up = j‰nnitt‰‰, k‰‰ri‰
wine = viini
win over = voittaa
winter = talvi
wipe out = h‰vitt‰‰
wireless = radio
wise = viisas
wish = haluta, tahtoa
with = kanssa, -lla, luona
within = -ssa
without = ilman
without fail = ehdottomasti
witty = henkev‰
woe = voi
wolf = susi
wonder = ihmetell‰
wood = puu
woodpecker = tikka
wool = villa
word = sana
work = toimia, tyˆskennell‰
workbench = alusta
work out = laskea
world = maailma
worm = mato
worry = huolehtia
worth = arvo
worthy = arvoinen
wrestle = painia
write = kirjoittaa, laatia
writhe = rimpuilla
yacht = huvivene
yard = piha
yawn = haukotella
ye = sin‰
year = vuosi
yearn = kaivata
yellow = keltainen
yes = kyll‰
yesterday = eilen
yet = viel‰, jo, kuitenkin
yield = v‰isty‰
yoghourt = jogurtti
yoghurt = jogurtti
yoke = ies
yon = siell‰
yonder = sinne, siell‰, se
you = sin‰, sin‰
young = nuori
Yugoslav = jugoslavialainen, jugoslaavi
Yugoslavia = Jugoslavia
Yugoslavian = jugoslavialainen, jugoslaavi
Yule = joulu
zeal = into
zero = nolla