#setName = words_fi_en_rt
#sideOneTitle = FIN
#sideTwoTitle = ENG
raaka = crude, raw, rough
raapia = scrape, scratch
radio = radio, wireless
raesade = hail
raha = money
rahasto = fund
raihnas = decayed, decrepit, dilapidated, lapsed, rickety
raitiovaunu = streetcar, tram
raivoisa = furious
raja = boundary, frontier, limit
rakastaa = love
rakentaa = build, construct
rangaista = punish
ranskalainen = French, Frenchman
ranta = bank, border, edge, shore
rasia = box
rasva = fat, grease
ratsastaa = ride
rauha = peace
rauta = iron
rautatie = railroad, railway
rautatieasema = station
ravintola = restaurant
ravita = feed, nourish
rehellinen = above-board, honest
reikä = hole
reisi = thigh
rengas = ring
repale = rag, scrap
repiä = rip, tear
retiisi = radish
reuna = border, brim, brink, edge, edging, fringe, rim
riimi = rhyme
riippua = droop, hang
riisi = rice
riittää = suffice
rikas = affluent, rich, wealthy, well-off
rimpuilla = flounder, struggle, writhe
rinne = acclivity, hillside, slope
rinta = bosom, breast, chest
risteillä = cruise
risti = cross
ristiriita = conflict
risuaita = grid, hash, number sign, pound sign, sharp
riuku = lath, slat
rivi = file, line, rank, row, turn
rohkea = brave, courageous, valiant
roisto = cheat, crook, rogue
romanssi = romance
romantiikka = romanticism
rommi = rum
rotta = rat
rotu = breed, race
rukoilla = pray
rumpu = drum
runotar = muse
runsas = abundant, copious, plentiful, profuse
ruoho = herb, grass
ruokahalu = appetite
ruokalista = menu
ruoste = rust
ruotsalainen = Swedish, Swede
Ruotsi = Sweden
ruskea = brown
ruukku = jug, pot
ruumis = cadaver, corpse, body
ruusu = rose
ruuvi = screw
ryhmä = group
rypäle = grape
rytmi = rhythm
ryöstää = plunder, rob
räjähtää = explode
saada = get, have, receive
saakka = until, till
saalis = prey
saapas = boot
saapua = arrive, end up, get
saari = island
saattaa = accompany
saavuttaa = accomplish, achieve, attain, get, reach
sade = rain
sahata = saw
saippua = soap
saita = avaricious, miserly, stingy
Saksa = Germany
saksalainen = German
saksanpähkinä = walnut
salama = lightning
sallia = accord, admit, afford, allow, permit
samanlainen = same
sammakko = frog
sammuttaa = extinguish, put out
sana = word
sangen = quite, very, very much
sankari = hero
sanoa = say, tell
sanoma = errand, message
sanomalehti = gazette, magazine, newspaper, periodical
sata = hundred, one hundred
sataa = rain
satama = harbor, harbour, port
sattuma = accidence, chance, hazard
savi = clay
savuke = cigarette
savuta = smoke
se = that over there, those, that, that one, yonder, it
seikkaperäinen = detailed
seinä = wall
seisoa = stand
seitsemän = seven
seitsemänkymmentä = seventy
seitsemäntoista = seventeen
seitsemäs = seventh
sekoittaa = blend, mingle, mix, shuffle
sekunti = second
selkä = back
selkäranka = spine
sello = cello
selostaa = give an account, report, review
selvä = clear, distinct, plain
sentti = cent
setä = uncle
seura = circle, club, society
seurakunta = parish
seurata = follow
sianliha = pork
sielu = soul
sieni = fungus, mushroom, sponge
sihteeri = secretary
siideri = cider
siis = accordingly, so, then, therefore
siittää = beget, generate
sija = affair, case, matter
sijaan = instead of
sijaita = be situated
sika = hog, pig, swine
siksi = on that account, therefore
sileä = smooth
silli = herring
silloin = then
silmä = eye
silta = bridge
sinappi = mustard
sinfonia = symphony
sininen = blue
sinne = that way, there, thither, yonder
sipuli = onion
sirkus = circus
siro = graceful
sisäinen = inner, inside, internal
siteerata = cite, quote
siten = so, such, thus
sitoa = bind, connect, join, tie, tie up
sitruuna = lemon
sitten = afterwards, next, subsequently
siunata = bless
siveellisyys = morals
sivistynyt = cultured, educated, learned, well-informed
sivu = side, page
Skotlanti = Scotland
skotlantilainen = Scottish, Scot, Scotsman
sohva = sofa
soida = sound, peal, ring
soikea = oval
sointuoppi = harmonica
soitin = musical instrument
sokea = blind
sokeri = sugar
solmu = knot, node
solu = cell
sonaatti = sonata
sopia = befit, be fitting, be appropriate, suit, be suitable
sopimus = accord, accordance, agreement, concurrence
sora = gravel, grit
sormi = finger
sorsa = duck
sorvata = turn
sota = war
sotajoukko = army
sotaväki = army
soutaa = row
soutuvene = boat
-ssa = a, in, inside, into, on, per, within
-sta = concerning, on, upon, about, round, around, towards
sudenkorento = dragonfly
suhista = rustle, swish
suhtautua = concern, relate
suhteellinen = relative
suihkuttaa = shower
sukka = stocking
suklaa = chocolate
sukulainen = relative
sukupolvi = generation
sukupuoli = sex
sukupuoliyhdyntä = coition
sulattaa = melt
sulhanen = fiancé
sulkea = close, shut
sulku = lock, sluice
suloinen = charming, lovely
summa = amount, sum
sumu = fog, mist
sunnuntai = Sunday
suo = marsh, swamp
suodattaa = filter
suojata = shelter, protect
suojella = protect
suola = salt
suoli = intestine
suomalainen = Finnish, Finn
suomen kieli = Finnish, Finnish language
suomi = Finnish, Finnish language
suopea = advantageous, favourable
suora = direct, straight
suositella = commend, recommend, register
suostua = accede, agree, consent
suostuttaa = persuade
supistaa = reduce
surista = buzz, hum
surukseni = alas, regrettably, unfortunately
surullinen = dismal, dreary, sad
survoa = crush, pound
susi = wolf
suu = mouth
suudella = kiss
suunnata = direct, guide, manage, steer
suunnitella = plan
suuttua = be angry
suvaitsevainen = tolerant
Sveitsi = Switzerland
sveitsiläinen = Swiss
sydän = heart
syksy = autumn
synnyttää = give birth, labour, be in labour, bear, give birth to
synti = sin, transgression
syntyä = arise, be born
syvä = deep, profound
syy = cause, account, reason
syyllinen = guilty
syyskuu = September
syyttää = accuse, blame
syödä = eat, feed
säde = beam, ray
säe = verse
sähkö = electricity
säie = fiber, fibre
säiliö = jug, box, container, vessel
säilyttää = conserve, keep, maintain, preserve
säkki = bag, sack
sämpylä = roll
särkeä = break
sävelasteikko = gamut, key, scale
sävelmä = melody, tune
säveltää = compose
sää = weather
sääliä = have compassion on, pity
säännönmukainen = normal
säännöttömyys = abnormity, anomaly
sääntö = norm, standard
sääri = leg, paw
säästää = save, spare
-ta = of
taata = guarantee, warrant
tahansa = at all, -ever
tahdikas = discrete
tahra = blot, spot
tahti = musical time, tact
tahtoa = be willing to, want, wish
tai = or
taide = art
taikoa = bewitch
taimen = trout
taipumus = tendency
taipuvainen = inclined
taitava = adroit, clever, dexterous, skillful
taivas = heaven, sky
taivuttaa = fold, bend
tajuta = be aware of, be conscious of, realize
takki = cloak, mantle
takoa = forge
talja = fur, hide, skin
tallata = trample on, tread
tallettaa = deposit
talo = house
talvi = winter
tammikuu = January
Tanska = Denmark
tanskalainen = Danish, Dane
tanssiaiset = ball, dance
tapa = habit, manner, mode, way, custom, mores
tapahtua = come about, happen, occur
tapaturma = accident
taputtaa käsiään = acclaim, applaud, clap
tarjoilija = waiter
tarjoiluhuone = buffet
tarkastaa = inspect, audit, check, check up on, supervise, verify
tarkastaja = auditor, government inspector
tarkka = accurate, precise
tarkkaavainen = attentive
tarvita = need, require
tasainen = even, flat, level, smooth
tasapaino = equilibrium
tasku = pocket
taso = level
tauko = break, intermission, pause, recess
taulu = board, plank
taulukko = index, table, tablet, tabulation
tausta = background
tavallinen = common, ordinary, usual
tavara = commodity, merchandise, wares
tavata = come across, encounter, meet, see
tee = tea
teeskennellä = dissemble
tehdas = factory, mill
tehdä = achieve, act, do, perform, cause, get, make
tehdä aloite = initiate, start
tehdä johtopäätös = abstract, induce, gather, infer
tehdä yhteenveto = abstract, summarize
teho = effect, impression
teko = achievement, act, action
teksti = lyric, text
teltta = tent
terve = healthy, well
tervehdys = greeting
tervehtiä = greet, salute
terä = blade
teräs = steel
terävä = abrasive, acerbic, acid, acrid, acrimonious, acute, lurid, sharp
teurastaa = butcher, slaughter
tie = road, route, way
tiede = science
tietysti = of course
tietää = know, know how
tiheä = concentrated, dense, thick
tiistai = Tuesday
tikka = woodpecker
tila = condition, state
tilanne = circumstances, condition, situation
tilapäinen = provisional, temporary
tilata = have a subscription, take in, book, order, reserve
tili = account
todellinen = actual, practical, real
todennäköinen = probable
todeta = ascertain, establish, take note
todistaa = attest, bear witness of, testify
toimia = act, take action, function, operate, run, work
toimittaa = edit
toinen = other, another, else, second
toistaa = repeat
toivoa = hope
tomaatti = tomato
Tonava = Danube
tonttu = goblin, imp
tori = plaza, square, public square
torni = castle, tower
torstai = Thursday
torvi = trumpet
tosi = true
tosiasia = fact
totuus = reality, truth
toukka = grub, larva, caterpillar
toukokuu = May
tsaari = czar
tuhat = thousand, one thousand
tuhka = ash, cinder
tuhoutua = perish
tukehduttaa = choke, quell, suffocate, suppress
tuleva = future
tuli = fire
tulitikku = match
tulkita = interpret
tulla = come
tulla joksikin = become, get, grow
tulla näkyviin = appear, emerge, perform
tulppaani = tulip
tunneli = tunnel
tunnus = emblem
tuntea = be acquainted with, know, feel, sense
tunti = hour, o'clock, time
tuoli = chair
tuomita = judge
tuomita kadotukseen = damn
tuore = fresh, recent
tuottaa = afford, bear, produce
tupakka = tobacco
turha = abortive, futile, useless, vain
turhanpäiten = for no reason
turkis = fur, fur coat, fur piece
Turkki = Turkey
turkkilainen = Turkish, Turk
turve = peat
tuska = agony, anguish, fear
tuskin = barely, hardly, only just, scarcely
tutkia = examine, explore, investigate, research
tuttu = well-known
tuuli = wind
tuutia = lull, rock
tyhjä = empty, void
tyhmä = addled, foolish, stupid
tylppä = blunt, dull, obtuse
tylsä = blunt, dull, obtuse
tyrkyttää = force, impose
tyyli = style
tyyni = quiet, serene, untroubled, calm, tranquil
Tyyni Valtameri = Pacific, Pacific Ocean
tyyppi = type
tyytyväinen = contented, pleased, satisfied
työntää = push, thrust, push along, shove
työskennellä = work
tähti = star
tähystää = keep an eye on, spy on
tämä = this
tänään = today
tärkeä = important, serious
täsmällinen = accurate, on time, prompt, punctual, exact
tässä = behold, here is, here are, look, there
täydellinen = absolute, complete, perfect
täysi = complete, full
täytyä = have to, must, ought to, should
töllistellä = gape, gawk
törmätä = collide