#setName = words_en_fi_eg.txt
#sideOneTitle = ENG
#sideTwoTitle = FIN
each = kohti, jokainen
eager = ahne
eagle = kotka
ear = korva
early = aikainen, aikaisin
earn = voittaa
earnest = vakava
earth = maa
earthquake = maanj‰ristys
easel = alusta
east = it‰
Easter = p‰‰si‰inen
easy = helppo
eat = syˆd‰
edge = ranta, reuna
edging = reuna
edit = toimittaa
edition = painos
educate = kasvattaa
educated = sivistynyt
eel = ankerias
effect = teho, aiheutua
egg = muna
Egypt = Egypti
Egyptian = egyptil‰inen
eight = kahdeksan
eighteen = kahdeksantoista
eighth = kahdeksas
eighty = kahdeksankymment‰
elect = valita
electricity = s‰hkˆ
element = alkuaine, osanen
elephant = norsu
eleven = yksitoista
elk = hirvi
else = toinen, edelleen
embankment = pato
embarrassment = pula
emblem = tunnus
emerge = tulla n‰kyviin
eminent = etev‰
emphasis = mahtipontisuus
employ = palkata, k‰ytt‰‰
empty = tyhj‰
encounter = tavata
encourage = yllytt‰‰
end = lopetta, loppu
endeavour = ponnistella, koettaa
ending = loppu
endive = endiivi
end up = saapua
endure = kest‰‰, k‰rsi‰
engine = veturi, kone, moottori
England = Englanti
English = englantilainen
Englishman = englantilainen
enigma = arvoitus
enjoy = nauttia
enjoyable = miellytt‰v‰
enough = kylliksi
entertain = h‰irit‰
enthusiasm = innostus
entire = koko
entirely = aivan
entrust = antaa teht‰v‰ksi, luottaa
envelope = kirjekuori
envy = kadehtia
epoch = ajanjakso
equal = yht‰l‰inen
equator = p‰iv‰ntasaaja
equilibrium = tasapaino
era = ajanjakso
erect = perustaa
erotic = aistillinen
err = erehty‰
errand = sanoma
error = virhe
escape = p‰‰st‰ karkuun
especially = etenkin
essence = olemus
establish = perustaa, todeta
estate = maatila
esteem = kunnioittaa, harkita
estimate = arvioida
ethos = ilmapiiri
Europa = Eurooppaa
Europe = Eurooppaa, Eurooppa
European = euroopalainen, eurooppalainen
European Union = Euroopan Unioni
evade = v‰ltt‰‰
even = tasainen, yht‰l‰inen, viel‰p‰
evening = ilta
eventual = mahdollinen
ever = jolloinkin, aina
ever = tahansa
every = jokainen
everybody = jokainen
every kind of = kaikenlainen
every one = jokainen
everyone's = jokaisen
everything = kaikki
everywhere = kaikkialla
evident = ilmeinen
evolve = kehitty‰
exact = t‰sm‰llinen, oikea
examine = tutkia
example = esimerkki
except = paitsi
except for = paitsi
excite = ‰rsytt‰‰
exclusively = ainoastaan, vain
excrement = lanta
exercise-book = vihko
exhibition = n‰yttely
exist = olla olemassa
expect = odottaa
experienced = kokenut
expert = kokenut
expire = kuolla
explode = r‰j‰ht‰‰
explore = tutkia
export = vied‰ maasta
exposition = n‰yttely
express = ilmaista
expression = ilme
extend = laajuus, ojentaa
extensive = avara
exterminate = h‰vitt‰‰
extinguish = sammuttaa
extreme = ‰‰rimm‰inen
eye = silm‰
face = kasvot
facile = helppo
fact = tosiasia
factory = tehdas
faint = pyˆrty‰
fair = vaalea, markkinat, oikeudenmukainen
fairy = haltia
faithful = uskollinen
fall = pudota
falsify = v‰‰rent‰‰
fame = maine
family = perhe
fancy = uneksia
fantasy = mielikuvitus
fare = voida
farewell = hyv‰sti
farm = maatila, vuokrata maata, vuokrasopimus
fashion = muoti
fast = luja, nopea
fasten = kiinnitt‰‰, lukita
fat = paksu, rasva
fate = osa
fateful = kohtalokas
father = is‰
faucet = hana
favourable = suopea
fear = tuska, pel‰t‰
feather = kyn‰
feature = piirre
February = helmikuu
feed = syˆd‰, ravita
feel = tuntea
fellow = olio, mies
ferry = proomu
fervor = into
fervour = into
festival = juhla
fever = kuume
fiancÈ = sulhanen
fiber = s‰ie
fibre = s‰ie
fiction = kuvitelma
field = pelto, pelto
fifteen = viisitoista
fifth = viides
fifty = viisikymment‰
figure = numero, laskea
file = viilata, rivi
filter = suodattaa
find = lˆyt‰‰
fine = kaunis
finger = sormi
finish = lopetta
finished = valmis
Finland = Suomi
Finn = suomalainen
Finnish language = suomen kieli, suomi
fire = tuli
firm = luja
fish = kala
fit = kelvata
five = viisi
fix = kiinnitt‰‰
fix up = j‰rjest‰‰
flag = lippu
flame = liekki
flat = tasainen, laakea
flatter = imarrella
flee = p‰‰st‰ karkuun, paeta
fleet = laivasto
flesh = liha
fling = heiluttaa
flirt = hakkailla
flit = hakkailla
float = uida
floor = kerros, lattia
flounder = rimpuilla
flour = jauhot
flow = virrata
flower = kukka
fluff = untuva
fluid = aalto
flute = huilu
flutter = hakkailla
fly = lent‰‰, k‰rp‰nen
foam = vaahto
fog = sumu
fold = taivuttaa
folder = vihko
folk = kansa
follow = seurata
fondle = hyv‰ill‰
foolish = tyhm‰
foot = jalka
for = aikana, vuoksi, koska
force = tyrkytt‰‰
foreign = vieras
for every reason = mist‰ tahansa syyst‰
forge = takoa
forget = unohtaa
forgive = antaa anteeksi
form = muoto
for no reason = turhanp‰iten
for sake of = vuoksi
for some reason = jostakin syyst‰
fortunate = onnellinen
fortune = onnetar, osa
forty = nelj‰kymment‰
found = perustaa
foundation = pohja
fountain = kaivo
four = nelj‰
fourteen = nelj‰toista
fourth = nelj‰s, nelj‰nnestunti
fowl = kukko
fragment = osanen
frame = kehys
framework = kehys
free = vapaa
freeze = pakastaa
French = ranskalainen
Frenchman = ranskalainen
frequently = usein
fresh = tuore
Friday = perjantai
friend = yst‰v‰
friendly = yst‰v‰llinen
fringe = reuna
frog = sammakko
from = -lta, l‰htien, ulos
frontier = raja
froth = vaahto
fruit = hedelm‰
frying-pan = pannu
frying pan = pannu
fuel = polttoaine
full = t‰ysi, kyll‰inen
fun = huvi
function = toimia, virka
fund = rahasto, kassa
fungus = sieni
fur = talja, turkis
fur coat = turkis
furious = raivoisa
furnace = uuni
fur piece = turkis
further = edelleen
futile = turha
future = tuleva
gain = voittaa
gallant = uljas
gallery = parveke
gamut = s‰velasteikko
gape = tˆllistell‰
garden = puutarha
gas = kaasu
gather = ker‰t‰, tehd‰ johtop‰‰tˆs
gathering = kokous
gawk = tˆllistell‰
gay = iloinen
gazette = sanomalehti
general = yleinen
generate = siitt‰‰
generation = sukupolvi
genius = nerous
gentle = makea, lempe‰
gentleman = herra
geography = maantiede
germ = itu
German = saksalainen
Germany = Saksa
gesture = ele
get = hankkia, saapua, saavuttaa, tehd‰, tulla joksikin, ottaa, saada
ghost = aave
gift = lahja
girder = hirsi
girdle = vyˆ
gist = olemus
give = antaa, esitt‰‰
give an account = selostaa
give birth = synnytt‰‰
give birth to = synnytt‰‰
give in = v‰isty‰
give up = v‰isty‰, alistua
give way = v‰isty‰
gladness = ilo
glass = juomalasi, lasi
glide = liukua
globe = pallo
glorify = kunnioittaa
glove = hansikas
glow = hehkua
glow with heat = hehkua
glue = liimata, liima
go = menn‰, ajaa
goal = maali, p‰‰m‰‰r‰
goblet = malja
goblin = tonttu
go for a walk = olla k‰velyll‰
gold = kulta
golf = lahti
good = hyv‰
goodbye = hyv‰sti
good-natured = yst‰v‰llinen
go on = jatkaa
goose = hanhi
govern = hallita
government inspector = tarkastaja
gown = puku
graceful = siro
grade = aste, muistiinpano
grain = jyv‰, vilja
grandfather = isois‰
granule = jyv‰
grape = ryp‰le
grapple = pyydyst‰‰
grass = ruoho
grate = narista, kaapia
grave = hauta
gravel = sora
gravy = kastike
grease = rasva
great = iso
Great Britain = Iso-Britannia
Greece = Kreikka
greedy = ahne
Greek = kreikkalainen
green = vihre‰
greet = tervehti‰
greeting = tervehdys
grey = harmaa
grid = risuaita
grind = jauhaa
grit = sora
groan = huokailla
ground = pohja, maa
grounds = maa
group = ryhm‰
grow = tulla joksikin, kasvaa, viljell‰
growl = nurista
grown-up = aikuinen
grub = kaivaa, toukka
gruel = puuro
grumble = nurista
guarantee = taata
guard = vartioida
guess = aavistaa, olettaa
guest = vieras
guide = suunnata, opastaa
guilty = syyllinen
guitar = kitara
gulf = lahti
guy = olio