#setName = words_en_no_ps
#sideOneTitle = ENG
#sideTwoTitle = NOR
packet = pakke
pain = pine, smerte
painting = maleri
pair = par
palace = slott
pale = blek
pamper = skjemme
pancake = pannekake
panic = panikk
pantechnicon = flyttebil
pantechnicon van = flyttebil
panties = underbukse
pants = benklær, bukser
paper = dokument, papir
parachute = fallskjerm
paraffin-oil = parafin
parcel = pakke
pardon = tilgi
parents = foreldre
parents-in-law = svigerforeldre
park = park
parking bay = parkeringsplass
parking garage = parkeringsplass
parking place = parkeringsplass
parlour = sal
parsley = persille
part = del
particular = spesiell
partridge = åkerhøne
party = fest
passport = pass
pate = hode
patience = tålmodighet
patient = tålmodig
paw = ben, fot
pawn = soldat
pay = betale
pay attention to = ta hensyn til
pea = ert
peace = fred
pear = pære
pearl = perle
peasant = bonde
peculiar = gal, rar, sprø
pedal = pedal
peg = dram
pelvis = skål
pen = penn
pencil = blyant
pen-knife = lommekniv
pepper = pepper
per = i, på
perchance = kanskje
perform = gjøre, presentere
perhaps = kanskje
peril = fare
period = punkt
periodical = tidskrift
person = person
personality = karakter
personal number = personnummer
persuade = overbevise
pet = skjemme
petrol = bensin
petroleum = parafin
petticoat = underskjørt
pharmaceutical = medisin
pheasant = fasan
phone booth = telefonkiosk
photographer = fotograf
physician = dokter, læge
piano = piano
pick = stikke
pick up = ta
picture = bilde, maleri
picture postcard = prospektkort
piece = del
pig = gris, svin
pigeon = due
pigeonhole = avdeling
pillow = hodepute
pilot = los
pin = knappenål
pincers = knipetang
pine = furu
pineapple = ananas
pine-tree = furu
pink = nellik, rosa
pipe = rør
piston = stempel
pitcher = krukke
pity = synes synd, synes synd på, medlidenhet
place = plass, legge, sette
place of birth = fødested
place of worship = kirke
plain = klar
plan = bykart
plane = fly, bykart
plaster = plaster
plate = fat, tallerken
platform = kai, perrong
platter = fat, tallerken
plaza = plass
pleasant = behagelig
please = vær så god
pleased = fornøyd
plug = tennplugg
plum = plomme
plume = penn
pocket = lomme
point = punkt
poison = gift
pole = stang
police = politi
policeman = politikonstabel
police-station = politistasjon
polite = høflig
pool = svømmebad, svømmeplass
poor = dårlig, fattig, stakkars
population = befolkning
pork = svinekjøtt
port = havn
portable = transportabel
portal = inngang
porter = portier, bybud, bærer
possess = eie
possession = eiendom
possibly = kanskje
post = post
postage stamp = frimerke
postal code = postnummer
postcard = brevkort
postman = postbud
post office = postkontor
pot = gryte, potte
potato = potet
pound sign = firkant, grind, nummertegn
powder = pudder, pulver
prescription = resept
present = gave, presang, presentere
present with = presentere
preservative = prevensjonsmiddel
pressing = inntrengende
pretend = late som, late som om
price = pris
pricey = dyr, kostbar
print = trykke, kopiere
prison = fengsel
profess = tilstå
profession = yrke
profit = gagn
profound = dyp
promise = love, løfte
property = gård, egenskap, kvalitet, eiendom
public square = plass
pudding = pudding
pulse = puls
pump = pumpe
purchase = kjøpe
purchase money = kjøpesum
purchaser = kjøper
pure = ren
purple = purpur
purpose = mål
purse = børs, pung, pengepung
put = legge, sette
put down = legge, sette
put in order = innrede
put on the stage = presentere
put out of countenance = forferdelig
put up with = tåle
puzzle over = gruble
quality = egenskap, kvalitet
quantity = beløp
quarrel = krangle, trette
quay = kai, perrong
queen = dronning
question = spørsmål
quick = hurtig
quickly = kvikk
quit = forlate
quite = meget
rabbit = kanin
rack one's brains = gruble
radio = radio
rag = klut
railway carriage = vogn
railway platform = perrong
railway station = jernbanestasjon
rain = regn
raincoat = regnfrakke
ranch = gård
rapid = hurtig
raspberry = bringebær
rat = rotte
ravine = kløft
razor = barberkniv
razor-blade = barberblad
read = lese
reality = sannhet
realize = forstå
rear-lamp = baklys
rear-light = baklys
rear wheel = bakhjul
rebuke = dadle, bebreide
receipt = kvittering
receive = godta, takke ja til, få
recent = frisk
recipe = resept
record = innskrive
red = rød
red herring = røkesild
reek = lukte
refuse = avfall, nekte
regard = ta hensyn til
register = innskrive
regret = angre på
regrettably = dessverre, det var synd
reject = takke nei til, nekte
relate = fortelle
relation = forhold
relations = familie
relative = slektning
relatives = familie
release = forlate
reliable = pålitelig
relief = lettelse
relieved = lettet
religion = religion
religious = religiøs, troende
rely on = ha tillit til, stole på
remarkable = merkelig
remedy = middel
remote = ensom, fjern
removal = flytting
rendezvous = avtale
rent = leie
rent money = leie
rent out = leie bort
repeat = gjenta
reply = svare
repose = hvile
reproach = dadle, bebreide, bebreidelse
reprove = dadle, bebreide
resemblance = likhet
resemble = ligne
resent = ergre seg over
residence = bolig
resources = middel
respect = ha respekt for, respektere
respond = svare
rest = hvile
restaurant = restaurant
restrain = beherske, styre
retardation = forsinkelse
return-ticket = returbillett
reveal = fremkalle
revue = tidsskrift
rice = ris
rich = rik
ride = kjøre
rifle = gevær
right = til høyre, riktig
rim = felg
ring = ring
ripe = moden
risk = risiko
river = elv, flod
road = vei
road-metal = steinsprut
roast = steke
robe = kjole
rod = stang
roll = bolle
roller = sylinder
roof = tak
room = rom, værelse
root = rot
rope = reip, tau
rough = uvennlig
round = reip, om, omkring
route = vei
rubber = gummi, kondom
rubbish = avfall
rubble = steinsprut
rucksack = ryggsekk
rudder = ratt
rude = uhøflig
rule = beherske, styre
run = løpe
Russia = Russland
Russian = russisk, russer
rust = rust
rye = rug
Sabbath = lørdag
sack = sekk, veske
sad = sturen, trist
saddle = sal
sadness = sorg
safety = sikkerhet
safety-belt = livbelte
safety pin = sikkerhetsnål
sailor = sjømann
sallow = blek
salmon = laks
salon = sal
salt = salt
salute = hilse
sample = mønster
sand = sand
Sassenach = engelskmann
satisfied = fornøyd
Saturday = lørdag
sauce = saus
saucer = koppeskål
sausage = pølse
say = si
say goodbye = ta farvel, ta farvel med
say goodbye to = ta farvel, ta farvel med
Scandinavia = Norden
Scandinavian = nordisk
schedule = rutetabell, timeplan
school = skole
science = vitenskap
scissors = saks
scold = dadle, bebreide
scrap = klut
scream = skrike
screw = skrue
screwdriver = skrujern
scuffle = slagsmål
sea = hav
section = avdeling
security = sikkerhet
see = møte, treffe, se, besøke
self = selv, sjølv
self-confidence = selvtillit
self-conscious = blyg, sjenert
self-reliance = selvtillit
sell = selge
send = sende
sender = avsender
September = september
serious = alvorlig
serpent = orm
servant = hushjelp
set straight = skuffe
seven = sju
seventeen = sytten
seventy = sytti
sew = sy
sex = kjønn, sex
sexual = seksuell
shack = hytte
shamrock = kløver
share = del
sharp = firkant, grind, nummertegn
shave = barbere
shaving-brush = barberkost
shawl = sjal
shear = klippe
sheep = får
sheet = blad, laken
shifting spanner = skiftenøkkel
shirt = skjorte, trøye
shock-absorber = støtfjær
shoe = sko
shoemaker = skomaker
shop = butikk, forretning
short = kort
short circuit = kortslutning
shoulder = vegkant, skulder
shout = skrike
shower = dusj
shuffle = blande
shy = blyg, sjenert
siblings = søsken
sick = syk
sight = utsikt
sightseeing trip = utflukt
sign = skrive under
signature = underskrift
signpost = veiviser
silent = stille
silk = silke
silver = sølv
similarity = likhet
since = om, fordi
sing = synge
single = ugift, enslig
sir = herr
sister = søster
sister-in-law = svigerinne
sit = sitte
sitting-room = dagligstue, sal
six = seks
sixteen = seksten
sixty = seksti
size = størrelse
ski = ski
skin = hud
sky = himmel
slander = sladre
sledge = slede
sleep = sove
sleeping-car = sovevogn
sleigh = slede
slender = tynn
slice = skjære
slow = langsom
slow train = somletog
small = liten
smear = smøre
smell = lukte
smile = smile, smil
smoke = røyk
smokers = røyke-kupé
smooth = flat
snack = lunsj
snail = kringle, kroell-alfa
snake = orm
snifter = dram
snorter = dram
snow = sne
soap = såpe
so ... as = like ... som
soccer = fotball
society = forening
sock = sokk
sofa = sjeselong, sofa
soft = søt, bløt
soiled = skitten
soldier = soldat
sole = alene, aleine, tunge
solicitor = advokat
solitary = alene, aleine
so long = ha det så lenge, på gjensyn, vi ses, vi sees
solution = oppløsning
somber = sturen, trist
something = noe
son = sønn
son-in-law = svigersønn
sorrow = sorg
soup = suppe
sour = sur, uvennlig
source = kilde
south = syd
South America = Sør-Amerika
souvenir = minnesmerke
Soviet Union = Sovjetunionen
space = rom
spacious = romslig, vid
Spain = Spania
spare time = ferie
spark = gnist
spark plug = tennplugg
speak = prate, snake, tale
special = spesiell
speciality = avdeling
specimen = mønster
spectacles = briller
speechless = stum
speed = fart
speed-limit = fartsgrense
speed limit = fartsgrense
speedy = hurtig
spell = stave
spice = kryddek
spinach = spinat
Spitsbergen = Svalbard
spoiled = bortskjemt
spoon = skje
spot = plass, punkt
spread = smøre
spring = kilde, vår
springtime = vår
spruce = gran
spruce-fir = gran
square = plass
square metre = kvadratmeter
squatter = husokkupant
stab = stikke
stable = stall
stage = scene, stasjon
staid = alvorlig
staircase = trappe
stairs = trappe
stall = stall
stamp = frimerke
stand = stå
star = stjerne
start = begynne
starter = starter
state = hevde, påstå
station = stasjon
station-master = stasjonmester
statue = statue
steak = biff
steal = stjele
steamship = dampbåt
steel = stål
steering-wheel = ratt
stick = stokk
sting = stikke
stock exchange = børs
stocking = strømpe
stodgy = kjedelig
stomach = mave
stone = stein-, stein
stone-chippings = steinsprut
stop = holdeplass, stoppested, stasjon
storage battery = akkumulator
store = butikk, forretning
storey = etasje
storm = storm
story = etasje, historie
stove = ovn
strange = fremmed, gal, rar, sprø
stranger = fremmed
strawberry = jordbær
stream = å
street = gate
streetcar = sporvogn, trikk
strike = slå
striking = påfallende
string = reip, tau
stroll = spasertur, spasere
strong = sterk
struggle = slåss, slagsmål
student = student
sty = stall
subsequently = bak
subway = undergrund, undergrunnsbane
such a = hvordan
such as = hvordan
sufficient = nok
sugar = sukker
sum = beløp
summer = sommer
summon = kalle
sun = sol
Sunday = søndag
sun-glasses = solbriller
sunset = solnedgang
super highway = autobane
supper = aftens, kveldsmat
supply = levere
surly = uvennlig
surname = etternavn
surprise = forbauselse, overraske, overraskelse
suspect = mistro
suspenders = bukseseler
suspicion = mistro
swaddling cloth = bleie
swear = banne
Swede = svenske
Sweden = Sverige
Swedish = svensk
sweet = søt
swift = hurtig
swiftly = kvikk
swim = svømme
swimming-bath = svømmebad, svømmeplass
swimming-pool = svømmebad, svømmeplass
swimming trunks = badebukse
swindle = bedrag
swine = gris, svin
Switzerland = Sveits
sympathetic = grei, sympatisk