#setName = words_en_sv_np
#sideOneTitle = ENG
#sideTwoTitle = SWE
naïf = naiv
nail = spika, spik, nagel
nail-brush = nagelborste
naïve = naiv
naked = bar, naken
name = namn
nameless = anonym
namely = nämligen
nape = nacke
napkin = servett
narcissus = narciss
narrate = berätta
narrative = berättelse, historia
narrow = smal, trång
nasturtium = krasse, tusch
nasty = förtretlig, oangenäm, obehaglig, otrevlig, arg, dålig, ful, illa, ond, slätt, stygg, ohederlig, oärlig, nedrig
nation = nation, folk
national = nationell
nationality = nationalitet
native = infödd, inföding
natural = naturlig
natural gas = naturgas
nature = karaktär, art, natur
naught = nolla
nausea = vämjelse, äckel
navy = marin, sjömakt
Nazi = nazist
near = bi, hos, vid, när
nearby = bi, hos, vid, när
nearly = nästan
nearness = närhet
near-sighted = kortsynt, närsynt
near to = bi, hos, vid
necessary = behövlig
neck = hals
necklace = halsband
need = behöva, behov, förnödenhet
needle = knappnål, nål
negative = negativ
negligent = oaktsam, ouppmärksam
negotiate = handla
Negro = neger
neigh = bräka, böla, råma, yla, gnägga
neighbour = granne
neighbourhood = kvarter
neither = ingen
neither ... nor = varken ... eller
nephew = brorson, brorsson, systerson
nerve = nerv
nervous = nervös
nest = kyffe, näste
net = nät
nettle = brännässla, nässla
network = nät
neutral = neutral
never = aldrig
never mind = det gör ingenting, för all del, ingen orsak
nevertheless = likafullt, oaktat
new = ny
newspaper = dagblad, journal
New Year = nyår
next = kommande
next of kin = närmaste
next to = bi, hos, vid, bredvid
nice = angenäm, anslående, behaglig, trevlig, bra, god, läcker, smakfull, smaklig
niche = nisch
nickel = nickel
nickname = binamn, vedernamn
niece = brorsdotter, systerdotter
niggard = gnidare, knusslare
night = natt
nightingale = näktergal
nightmare = mara
night prayers = aftonbön
nine = nie, nio
nineteen = nitton
nineteenth = nittonde
ninety = nitti, nittio
ninth = nionde
nipple = spene, vårta
nitrogen = kväve
no = nej
nobility = adel
noble = ädel
nobleman = jarl, ädling
nobody = ingen
node = knut
noise = bråk, buller, dån, krasch, larm, oljud, olåt, oväsen, stoj, väsen
non-attendance = frånvaro
noncom = underofficer
non-commissioned officer = underofficer
none = ingen
no-one = ingen
normal = normal
north = norrut, nord
North America = Nordamerika
northern = nordlig, norr, norra
North Sea = Nordsjön
northward = norrut
northwards = norrut
Norway = Norge
Norwegian = norsk, norrman
nose = näsa
nostril = näsborr
not = ej, icke, ingen, intet
not at all = ingalunda, alldeles icke, alls icke, inte alls
note = biljett, annotera, anteckna, notera, anteckning, not
notebook = skrivbok, annotationsbok, notisbok
noteworthy = anmärkningsvärd, märklig, märkvärdig
nothing = ingenting, intet
notice = affisch, anslag, märka, bekantgörande, tillkännagivande
notice-board = anslagstavia
notion = begrepp
not on any account = ingalunda
notwithstanding = trots
nought = noll, nolla
noun = substantiv
novel = ny, romare, roman
November = november
now = nå, nåväl, nu
nowadays = nutida, nuvarande
nowhere = ingenstans, ingenstädes
nucleus = kärna
nude = bar, naken
null = nolla
number = husnummer, antal, nummer
number of the house = husnummer
numberplate = nummerplåt
numeral = nummer
nun = nunna
nurse = ansa, sköta, vårda, sjuksköterska, sjukvårdare, vårdare
nursery school = lekskola
nut = nöt
nuts = dåraktig, förryckt, galen, stollig, tok, tokig, vansinnig, vriden
nymph = nymf
oak = ek
oar = åra
oasis = oas
oath = ed
oats = havre
obedient = hörsam, lydig
obey = hörsamma, lyda, åtlyda
object = objekt
obscure = obskur
observe = observera
obstacle = hinder
obstetrician = ackuschörska, barnmorska, ackuschör
obtain = förvärva
obvious = synbarligen, uppenbar
occasion = gång
occur = hända, inträffa, passera
occurence = händelse, tillfälle
ocean = ocean
o'clock = timme
October = oktober
oculist = ögonläkare
odd = egendomlig, märkvärdig
odor = doft
odour = doft
of = alltifrån, efter, av
of all sorts = varjehanda
offence = anstöt, förargelse, förtrytelse, harm
offend = skälla ut, förnärma, förölämpa
offensive = offensiv
offer = offra, offert, presentera, bjuda, anbud, förslag
offer up = offra
office = byrå, kontor, ämbete
officer = officer, ämbetsman
official = officiell, ämbetsman
offset = avstånd, distans
of ill repute = ökländ
of noble birth = adlig, av adel
of sand = sandig
of silk = av siden
often = ofta
of the body = kroppslig, lekamlig
of the sun = solig
of the winter = vinterlig
of which = vars
oh = ack, åh
oil = olja
okay = god, bra, väl
old = åldrig, gammal, åldrig
old-fashioned = gammaldags, gammalmodig, urmodig
olive = oliv
omelette = omelett
omen = varsel
omnibus = omnibus
omnipotence = allmakt
omnipotent = allrådande, allsmäktig
omniscient = allvetande
on = alltifrån, av, efter, i, per, om, över, på
on account of = på
once more = åter
one = någon, en, ett
one another = varandra, varann, varannan
one hundred = hundra, ett hundra
onerous = tung, viktig
one thousand = tusen, ett tusen
onion = lök
only = ensam, bara, blott, endast
only just = knappast, knappt, näppeligen
on the occasion of = infall
on time = ackurat, prompt
on top = uppe, upptill
opal = opal
open = stänga, stängd
open up = stänga
opera = opera
operate = operera
operation = operation
operative = arbetare
ophtalmologist = ögonläkare
opine = anse, tycka
opinion = mening, uppfattning, omdöme, tycke, åsikt
opponent = vedersakare
opportunity = händelse, tillfälle
opposed to = emot, inemot, mot
opposite = emot, inemot, mot, motsatt
opposition = motsats
oppress = trycka
optician = optiker
optimism = optimism
option = alternativ
oracle = orakel
orange = apelsin, orange
orchestra = orkester
order = kommendera, orden, befalla, påbjuda, befallning, befäl, order, påbud
ordinarily = gemenligen, merendels
ore = malm
organ = organ, orgel
organization = organisation
Oriental = orientalisk, ostlig, österländsk, östlig, östra
original = original
originate = härstamma
ornament = smycka
orthodox = renlärig
ostrich = struts
other = annan
other than = utom
ought to = böra, må, måste
our = vår
out = ute
outfit = klädedräkt, kostym
outline = silhuett
out of = från, ifrån, ut, utav
out of date = gammaldags, gammalmodig, urmodig
out of order = kaputt
outside = ute
outskirts = periferi
oval = oval
oven = kamin, spis
overall = total, hel
overcoat = paletå
overhead = uppe, upptill
overpower = ockupera
overshoe = galosch
over there = där
ow = ack, åh
owing to = på
owl = uggla
own = innehava, äga
owner = ägare
ox = oxe
oxygen = syre
oyster = ostron
pace = steg
Pacific = Söderhavet
Pacific Ocean = Söderhavet
pack = packa, packe
packet = paket
pad = block
pagan = hednisk, hedning
pail = bytta, hink
pain = pina, smärta, värk
painful = pinsam, smärtsam
paint = färga, färg, måla
painter = målare
painting = målning, tavla
pair = duo, par
pal = kamrat, kompis
palace = palats
pale = glåmig
palm = palm
palmtree = palm
pamper = kela
pamphlet = broschyr, pamflett
panic = panik
pantechnicon = flyttbil
pantechnicon van = flyttbil
panties = underbyxor
pantomime = pantomim
pants = benkläder, byx, byxa, byxor
paper = dokument, tapet, tapetsera
paperback = broschyr
paperer = tapetserare
paper-hanger = tapetserare
paper-hangings = tapet
parachute = fallskärm
parade = parad
paradise = paradis
paraffin = paraffin
paraffin-oil = fotogen, petroleum
paragraph = paragraf
parallel = parallel
paralyse = förlama
parapet = balustrad
parasite = snyltdjur, parasit, parasit, snyltväxt, snyltgäst, tallricksslickare
parcel = paket
pardon = benåda, förlåta, benådning, förlåtelse, nåd
parenthesis = spasm
parents = föräldrar
parents-in-law = svärföräldrar
parish = prästgård, socken
Parisian = parisare
park = park
parliament = parlament
parlour = salong
parrot = papegoja
parsley = persilja
part = andel, del, part, roll
Parthian = andel, del, part
partial = partisk
particular = särskild, speciell
partridge = rapphöna
party = anhang, fest, kalas, part, parti
passable = gångbar
pass away = avlida, dö
passenger = passagerare, trafikant
passion = glöd, passion
passionate = passionerad
passport = pass
paste = deg
pastor = katolsk präst, kyrkoherde, pastor, prost, präst
patch = flicka
patch up = flicka
pate = huvud
patent = oktroj, patent
paternal aunt = faster
paternal grandfather = farfader, farfar
paternal grandmother = farmor
paternal grandparents = farföräldrar
paternal uncle = farbroder, farbror
path = bana, gång, stig, stråt
patience = tålamod
patient = tålig, tålmodig, patient
patriarch = patriark
patrol = patrull
patron = beskyddare
pattern = schema
pause = paus
pavement = gångbana, trottoar
pavilion = paviljong
paw = ben, fot, tass
pawn = pion, knekt, soldat
pay = betala, erlägga
pay attention = beakta
pay attention to = beakta, ta hänsyn till
payment = avbetalning, betalning, likvid
pay off = avbetala
pay the expenses of = bekosta
pea = ärt, ärta
peace = fred
peach = persika
peacock = påfågel
pear = päron
pearl = pärla
peasant = landsbo
peculiar = egendomlig, märkvärdig
pedal = pedal, trampa
pedestrian = fotgängare
peel = bark
peer = stirra
pelican = pelikan
pelvis = skål
pen = fjäder, penna, plym, bläckpenna
pencil = blyertspenna
peninsula = halvö
pen-knife = fickkniv, fällkniv
pension = pension
Pentecost = pingst
people = folk
pepper = peppar
per = i
percent = procent
percentage = procent
perchance = kanhände, kanske, måhände, törhända
perform = göra, presentera
perfume = parfym
perhaps = kanhände, kanske, måhände, törhända
peril = fara, våda
period = period
periodical = tidskrift
periphery = periferi
perish = förgås
permanent = konstant
perplexed = oredig
persecute = förfölja
persecution = förföljande, förföljelse
Persian = perser
person = person
personal = personlig
personality = art, karaktär
personal number = personnummer
perspiration = svett
persuade = överbevisa, övertyga
pessimistic = pessimistisk
pestilence = pest
pet = kela
petrol = bensin
petroleum = fotogen, petroleum
phantom = gast, spöke
pharmaceutical = läkemedel, medicin
pheasant = fasan
phenomenon = fenomen
philosopher = filosof
phlegm = slem
phone booth = telefonhytt
phosphorus = fosfor
photograph = fotografera
photographer = fotograf
photography = fotografi
physical = kroppslig, lekamlig
physician = doktor, läkare
physics = fysik
piano = piano
pick = sticka, plocka
pick out = kora
pick up = avhämta, hala, församla, samla, fatta, ta, taga
picture = bild, figur, gestalt, målning, tavla
picture postcard = vykort
pie = tårta
piece = andel, del, part, bit
piece of furniture = möbel
pig = gris, svin
pigeon = duva
pigeonhole = fack, yrke
pigmy = dvärg
pike = gädda
pile = hop, mängd, stack
pilgrimage = pilgrim
pill = piller
pillar = pelare, spalt
pillow = huvudgärd
pilot = lotsa, lots
pin = knappnål, nål
pine = fur, fura, pinie, pinje, tall
pineapple = ananas
pine-tree = fur, fura, pinie, pinje, tall
pink = nejlika
pioneer = pionär, pionjär
pious = gudlig
pip = korn
pipe = pipa, rör
pirate = pirat, sjörövare
pistol = pistol
pit = kärna
pitch black = becksvart
pitcher = kruka, stop
pity = ha medlidande, ha medlidande med, tycka synd om, medlidande, misskund
pivot = spindel
placard = affischera, affisch, anslag
place = ort, lägga, ställa, sätta
place of birth = födelseort
place of worship = kyrka
plague = pest
plaice = rödspotta, rödspätta
plain = slätt, klar, tydlig
plan = projekt
plane = flygmaskin, platan, hyvla, hyvel
planet = planet
plane-tree = platan
plank = bräde, plank, tilja
plant = planta, plantera, plant
plaster of Paris = gips
plate = fat, tallrik
platform = kaj, perrong, program
platinum = platina
platter = fat
plausible = trolig, trovärdig
play = spela, leka, spela, skådespel, teaterpjäs
plaza = torg
pleasant = angenäm, anslående, behaglig, trevlig
please = varsågod, behaga
pleased = belåten, nöjd
pleasure = behag, fröjd
plot = intrig, komplott
plough = plöja, plog
pluck = plocka
plug = gnista, tändstift
plug in = ansluta
plum = plommen
plume = bläckpenna, fjäder, penna, plym
plunder = roffa, råna, röva
plunge = dyka
pocket = ficka
poem = dikt
poet = diktare, skald
poetry = poesi
point out = uppvisa
poison = förgifta, gift
poisonous = ettrig, giftig
Poland = Polen
pole = grav, påle, stör, pol
police = polis
policeman = konstapel, poliskonstapel
police-station = polisstation
policy = politik
polish = glansslipa, polera
polite = artig, hövlig
politeness = artighet
political = politisk
politician = politiker, statsman
politics = politik
polyp = polyp
pond = damm
pool = para, bassäng
poor = arg, dålig, ful, illa, ond, slätt, stygg, behövande, arm, fattig
pope = påve
poplar = poppel
poppy = vallmo
popular = populär
population = befolkning
porch = partvalv, veranda
porcupine = piggsvin
pork = fläsk
port = hamn
portable = portativ
portal = inträde, port
portent = varsel
porter = dörvakt, dörvaktare, portvakt, portvaktare, vaktmästare, bärare, stadsbud
portfolio = portfölj
port side = babord
Portuguese = portugis
position = position
possess = innehava, äga
possession = egendom
possible = möjlig
possibly = kanhände, kanske, måhände, törhända
post = affischera, påle, stör, ämbete, post
postage = porto
postage stamp = frimärke
postal code = postnummer
postcard = brevkort
poster = affisch, anslag
postman = brevbärare, postbud
post office = postkontor
post-paid = portofri
post up = affischera
pot = kanna
potato = potatis
pound = pund
pour = gjuta, hälla, stöpa
poverty = armod, fattigdom
powder = pulver
powerful = mäktig
practicable = gångbar
practical = praktisk, real, reell
practice = övning, praktik
practise = inöva, öva
praise = berömma, lova, prisa, beröm
prawn = räkna
pray = bedja
prayer = bön
preach = predika
preacher = predikant
precipice = avgrund, gap
precise = ackurat, noga, precis
precursor = varsel
preferably = hellre
pregnant = havande, dräktig
prejudice = fördom
preparation = beredelse, förberedelse
prepare = bereda, förbereda, tillaga, tillreda
presage = varsel
prescription = recept
presence = närvaro
present = gåva, present, skänk, presentera, närvarande
presentation = anbud, förslag
present with = presentera
preservative = preventivmedel
preserve = behålla, förvara, konservera
president = president
press = trycka, tryckpress
pressure = tryck
presume = anta
pretend = låtsas som om
pretext = förevändning, undanflykt, undflykt
prevent = förhindra, hindra
prey = fångst, kap
price = pris
pricey = dyr, dyrbar
pride = stolthet
primeval forest = urskog
primitive = primitiv
primrose = viva
prince = furste, prins
princess = furstinna
principality = furstendöme
principle = princip
print = trycka
prison = fängelse
privilege = privilegium
probable = antaglig, sannolik, trolig
probably = troligtvis
problem = problem
procedure = förfäringssätt
proceed = processa
process = förfäringssätt, process
procession = procession
proclamation = förklaring, proklamation
produce = alstra, producera, realisera
product = alster, produkt
production = alstring
profess = bikta, skrifta sig, bekänna
profession = profession
professor = professor
profile = profil
profit = profitera, vinst
profound = djup
programme = program
project = projekt
proletarian = proletär
promise = lova, löfte
prompt = ackurat, prompt
proof = bevis, gärd, prov
prop = stöd
propaganda = propagando
property = bondgård, gård, säteri, egenskap, kvalitet, egendom, besittning
prophesy = varsla
prophet = profet, siare
proposal = anbud, förslag
propose = bjuda
prose = prosa
prosecute = förfölja
protect = beskydda, freda, skydda, värja, värna
protection = beskydd, beskärm
protégé = skyddsling
protégée = skyddsling
protest = protest
Protestant = protestant
prototype = urbild
proud = stolt
prove = bevisa
proverb = ordspråk
provided that = om, såvida, såvitt
province = landskap, län, provins
provincial = provinsiell
proximity = närhet
Prussian = preussare
psalm = psalm
pseudonym = pseudonym
psyche = psyke, själ
psychiatrist = psykiater, psykiatriker
psychiatry = psykiatri, själsläkekonst
psychic = psykisk
public = allmän, offentlig, publik
publicity = propagando
public square = torg
publish = offentliggöra, publicera
publisher = förläggare, utgivare
pudding = pudding
pull = rycka, dra, draga, hala
pull down = slopa
pulpit = kateder
pulsate = pulsera
pulse = puls
pump = pumpa, pump
punctual = ackurat, prompt
punish = aga, bestraffa, näpsa, straffa
punishment = straff
puppet = docka
purchase = anskaffa, köpa, anskaffning, inköp, köp
purchase money = köpesumma
purchaser = köpare
pure = lutter, ram, ren, gedigen, idel, oblandad, pur
purge = luttra, rena, rengöra, rensa, sovra
purple = purpur
purse = börs, portmonnä
pursue = förfölja
pursuit = förföljande, förföljelse
push = puffa, stöta, knäck, puff, stöt, törn
put = lägga, ställa, sätta
put down = lägga, ställa, sätta
put in order = inreda
put on the stage = presentera
put out of countenance = förfärlig, hemsk
putty = kitt
put up with = lida, tåla
puzzle = gåta
puzzle over = grubbla
pyjamas = pyjamas
pyramid = pyramid