#setName = words_en_da_il
#sideOneTitle = ENG
#sideTwoTitle = DAN
ice = is
icecream = is
Iceland = Island
Icelander = islænding
Icelandic = islandsk
idea = begreb, idé, opfattelse
ideal = ideal
identify = identificere
identity = identitet
idiot = idiot, tosse
idol = afgud
ignition = tændling
ill = syg
illness = sygdom
illuminate = oplyse
illusion = indbildning
image = afbildning, billede, figur
imagine = forestille
imitate = efterligne
imitation = efterligning, imitation
immediately = straks
impartial = neutral, unpartisk
impatient = utålmodig
impertinent = fræk
impetus = tilstrømning
imply = betyde
import = importere, indføre
important = vigtig
impression = indtryk
impulse = tilstrømning
in = i, om, på
in action = aktiv
in addition = desuden, videre
incendiary bomb = brandbombe
incest = blodskam
incite = provokere, udfordre
inclination = tendens
incline = bøje
include = indeholde, indeslutte
income = indkomst
inconvenient = vanskelig
increase = tiltagende
increasingly = mer og mer
incus = ambolt
indeed = faktisk
independant = selvstændig, uafhængig
index = tabel
India = Indien
Indian = inder, indianer
Indian corn = majs
indicate = angive, vise
indication = betegnelse
indispensable = uundværlig
indistinct = utydelig
individual = individuel, individ
induce = slutte
industrious = flittig
industry = flid, industri
in easy circumstances = velhavende
in exchange for = imod
inexpensive = billig
in fact = faktisk
infant = barn
infantry = infanteri
infect = smitte
infer = slutte
inflate = opblæse
inflation = inflation
influence = indflydelse
influenza = influenza
inform = meddele
information = information
in front of = før
inhabitant = beboer, indbygger
inherit = arve
inheritance = arv
inhibit = forhindre, hindre
initial = forbogstav
injection = injektion
injure = beskadige
injury = sår
ink = blæk
inn = herberg, kro
inner = indre
inner tube = slange
innocence = uskyld
innocent = uskyldig
in no way = ingenlunde
in question = pågældende
inquiry-office = oplysningskontor
inquisitive = nysgerrig
insane = sindssyg
inscription = timelding
insect = insekt
inside = i, om, på, indre, indenfor
inspection = inspektion
install = indrette
installment payment = afbetaling
instant = øjeblik
instantly = straks
institution = institution
instructor = lærer
insult = fornærme, skælde
insurance = forsikring
intellect = fornuft
intelligent = intelligent
intend = sigte
intention = hensigt
inter = begrave
intercessor = advokat, sagfører
interchange = udskifte
interest = interesse
interesting = interessant
intermission = pause
internal = indre
international = international
international express = eksprestog
international express train = eksprestog
interpreter = tolk
interrupt = afbryde
interruption = afbrydelse
interview = interview
intestine = tarm
intestines = involde
in the evening = om aftenen
intimate = intim
in time = i tide, rettidigt
into = i, om, på
intolerant = intolerant
intoxicated = beruset, drukken, fuld
introduce = forestille, præsentere, servere, udføre
in vain = forgæves
invasion = invasion
invective = skældsord
invent = opfinde
invention = opfindelse
inverted comma = anførelsestegn
investigate = undersøge
investigation = undersøgelse
invitation = indbydelse
invite = indbyde, invitere
in what way = hvordan
Ireland = Irland
Irishman = irlænder
iron = jern-, jern, strygejern
ironic = ironisk
island = ø
issue = udgive
it = den, det
Italian = italiener
Italy = Italien
it doesn't matter = det gør ikke noget
its = sin, sit, dens, dets
itself = selv
ivory = elfenben
ivy = vedbend
jack = donkraft
jail = fængsel
jam = marmelade
January = januar
Japan = Japan
Japanese = japaner
jaw = kæbe
jawbone = kæbe
jealous = misundelig, jaloux
jealousy = skinsyge
jest = spøge
jewel = ædelsten
jeweller = juvelér
jingle = ringe
job = arbejde, embede, opgave
jog = jogge
join = binde, forene
joint = fælles
joke = spøge
journal = avis
journalist = journalist
journey = rejse
joy = glæde
joystick = rat
jubilee = jubilæum
judge = dømme, dommer
judgment = dom
jug = kande, beholder, potte
juice = saft
July = juli
jump = springe, spring
June = juni
jungle = jungle
jurist = jurist
jury = jury
just = retfærdig, bare, blot, kun, straks
justice = retfærdighed
Jutland = Jylland
Jutlander = jyde
keel = køl
keen = livlig
keep = avle, passe, beholde, konservere, redde
keep house = holde hus
keep on = vare
keepsake = souvenir
kernel = kærne
kettle = kedel
key = nøgle
kick = sparke, spark
kill = dræbe
kiln = ovn
kilo = kilo, kilogram
kilometre = kilometer
kind = flink, venlig, godhjertet, art, slags
kindle = tænde
king = dame, konge
kiss = kysse, kys
kitchen = køkken
klaxon = horn, signalhorn
knee = knæ
kneel = knæle
knife = kniv
knock = banke
knot = knytte, knude
know = kende, vide
know how = vide
knowledge = kundskab
label = etiket
laboratory = laboratorium
laborer = arbejder
labourer = arbejder
labour-union = fagforening
lack = savne, mangel
lacquer = fernis
lad = dreng
ladder = stige
laddie = dreng
lady = dame, fru, frue
lake = sø
lamb = lam
lamp = lampe
land = lande, land, jord
landscape = landskab
lane = stræde
language = sprog
larch = lærk
large = stor
lass = pige
last = forbigangen, vare, sidst
lasting = uafbrudt
last night = i går aftes, sidste nat
late = sen, sent
lathe = drejebænk
Latin = latinsk
laud = rose
laugh = le
laugh at = udle
laughter = latter
laundry = vaskerj
lava = lava
law = lov
lawn = græsplæne
lawsuit = proces
lawyer = advokat, sagfører, jurist
lay = lægge
lay down = lægge, stille, sætte
layer = aflægger
lay hold of = gribe, tage, tage op
lay out = sprede
lazy = doven
lead = føre, bly
leader = chef, leder
leaf = blad
leaflet = brochure
lean = støtte, læne sig, mager, tynd
leap = springe, spring
leap-year = skudår
learn = lære
learned = klog
learn of = høre, afhøre
lease = lejekontrakt
leasurely = langsomt
leather = læder
leave = afgå, afrejse, go ud, rejse bort, forlade, løslade
leave behind = efterlade
leave out = udelade
leaving examination = afgangseksamen
lecture = lektion, foredrag
leek = hvidløg
left = venstre, til venstre
leg = ben
legal = legal
legation = legation
lemon = citron
lemonade = limonade
lend = låne, løne
length = længd
lentil = linse
leprosy = spedalskhed
less = mindre
less and less = mindre og mindre
let = løslade, udleje
let know = meddele
letter = brev, bogstav
letterbox = brevkasse
lettuce = salat, hovedsalat
level = flad, lig, niveau
level-crossing = togoverskæring
lever = løfte
liberal = liberal
library = bibliotek
licence = tilladelse
license = tilladelse
lid = låg
lie = ligge, lyve, løgn
lie down = lægge sig
lieutenant = løjtnant
life = liv
lifebelt = redningsbælte
life-belt = redningsbælte
life-boat = redningsbåd
lift = løfte, elevator, lift
light = tænde, lys, let, oplyse, svag
lighthouse = fyrtårn
lightning = lyn
light-switch = kontakt
like = hvordan, lignende, kunne lide, sætte pris på, synes om
likely = sandsynlig
likewise = også
lilac = syren
lily = lilje
limb = medlem
lime = kalk
lime-tree = lind
limit = indskrænke, grænse
limp = halte
linden-tree = lind
line = medesnøre, linie
lineage = afstamning
lion = løve
lip = læbe
liqueur = likør
liquid = flydende, vædske
liquidate = dræbe
list = liste
listen = lytte, lytte til
liter = liter
literature = litteratur
litre = liter
litter = båre
little = lille
little by little = efterhånden, gradvis
live = bo, leve
live in lodgings = bo på værelse
liver = lever
livestock = kvæg
live through = gennemgå
live together = bo sammen
living alone = enlig
living-room = stue, dagligstue
lizard = firben
load = byrde, last
loaf = brød
loan = låne, løne, lån
loathe = afsky
lobster = languster, hummer
location = plads, sted
loch = sø
lock = lås, låse
locust = græshoppe
lofty = høj
logical = logisk
logical reasoning = fornuft
London = London
long = lang
long for = længsel, kræve
longing = længsel
look = se ud, syn, betragte, se på, blik
look after = passe, se after
look at = betragte, se på
look for = søge
looking-glass = spejl
loose = løs
lord = herr, herre
lorry = lastbil, lastvogn
loss = tab
lottery = lotteri
loud = høj
lounge = aula
louse = lus
love = elske, synes om, kærlighed, være vild efter
lovely = behagelig, rar, skøn, smuk, pragtfuld, sød, fortryllende
low = lav
lower-arm = underarm
low tide = ebbe
loyal = tro
luck = held
luggage = bagage
luggage-van = bagagevogn
lukewarm = lunken
lump = brud, brudstykke, masse, stykke
lung = lunge
lurid = skarp
lyric = tekst