#setName = words_en_la_tt
#sideOneTitle = ENG
#sideTwoTitle = LAT
table = mensa
tactic = ars
tactics = ars
tail = cauda, penis
take = accipere, capere
take action = agere
take away = abdere, adimere
take in = accipere
talisman = phylacterium, præbia
talk = loquere, loqui, orare
tall = altus, arduus, celsus
tamarisk = tamarix
tambourine = tympanum
tame = cicur, cicurare
tangle = chaos
taper = cereus
tardy = serus
tart = acerbus, austerus
taste = gustus
tasteless = bliteus
tax = vectigal
teach = docere
team of three horses = trigarium
tear = lacrima
teat = mamma, uber
tell = dicere, narrare
tell a lie = mentiri
tempest = auster, tempestas
temple = delubrum, fanum, templum
ten = decem
tench = tinca
tender = suavis
tendon = nervus
tend to = alere
tenth = decimus
test = attemptare, argumentum
text = textus
textile = tela, textile, textura, textus
that = qui, sic
that way = sic, eo, illuc
theatre = theatrum
thee = tibi
theologian = theologus
theology = theologia
theory = ars
there = eo, illuc, ibi, illic
thesis = thesis
thick = carnatus, crassus, obesus
thief = clepta, fur
thigh = bracchium, femur
thin = petilus
think = opinari, censere, cogitare, reri
third = tertius
thirteen = tredecim
thirty = triginta
thisle = carduus, tribulus
thisle-field = carduetum
this way = hinc, huc
thither = eo, illuc
thoughtfulness = cura
thousand = mille
thrash = cassare
thread = acia, filum, linum, padus
three = tres, tria
threshold = limen
throat = fauces, guttur
throb = palpitare
throw = iacere
thrush = turda, turdus
thurible = turibulum
thus = sic
Tiber = Tiber
tibia = tibia
tie = ligare
tie up = ligare
tiger = tigris
till = fiscus, ad, adusque, donec
tillage = agricultura, agricultio
timber = lignum
timbrel = tympanum
time = hora, tempestas, tempus
timidity = aporia, aporiatio
tired = fessus, lassus
title = titulus
titmouse = parus
to = ad
toad = bufo, rana
today = hodie
toga = toga
toilet = latrina
token = signum
tolerate = tolerare
tomb = tumba
tomorrow = cras
tone = tonus
tongue = lingua
tool = machina, machinamentum, machinatio
tooth = dens
top = culmen
topaz = chrysolithus
torch = fax
tortoise = chelys
torture = carnificina
torturer = carnifex
to some place = quo
to thee = tibi
touch = tangere
toward = ad
towards = ad, circa
tower = turris
town = oppidum, urbs
to you = tibi
transmit = mittere
trap = casses
travel = vehere
tread = gradi
tree = arboreus, arbor
tree- = arboreus
tree-trunk = caudex, codex, matrix
trefoil = trifolium
tremble = tremere
triangle = triangulum, trigonium
triangular = triangularis, triangulus, trigonicus, trigonus, triquetrus
tribune = tribunus
trick = vaframentum, ars, machina
trip = via
trite = abiectus
triumph = triumphare, adorea, adoria, triumphus
Trojan = Tros
trollop = cunnus
troop = caterva
troupe = caterva
trousers = bracæ
trousers wearing = bracatus
trout = tructa
Troy = Ilion, Ilium
true = verus
trumpet = tuba
trunk = caudex, codex, matrix
trust = fides
truth = veritas
try = attemptare
tube = canalis, fistula
tuberculosis = cachexia, phthisis
tufted lark = cassita
tummy = alvus, aqualiculus, costa, venter
tumulus = cinis
tuna = cybium, thynnus
tuna-fish = cybium, thynnus
tune = canor
tunic = tunica
tunny = cybium, thynnus
tup = aries
turf = cæspes
turn = tornare
turn around = tornare
turn away = ablegare, amandare, relegare, amoliri
turnip = rapum
turn round = tornare
turret = turricula
turtle-dove = turtur
twelve = duodecim
twenty = viginti
twice = bis
twig = virga
twilight = crepusculum
twine = plectere
two = duæ, duo
two-footed = bipes
two-year = bimus
two-year-old = bimus
tyranny = tyrannis
tyrant = tyrannus