#setName = words_en_pt_ff
#sideOneTitle = ENG
#sideTwoTitle = POR
fable = apólogo, fábula
fabric = tecido
fabricate = fabricar
façade = fachada, frontispício, frontaria, portada
face = atacar de frente, enfrentar, cara, rosto, semblante
facile = brando, fácil, suave
facilitate = aplainar, aquietar, facilitar
fact = facto, fato, ocorrência
faction = bandeira, facção, partida, partido
factory = fábrica, usina
factual = efectivo, real
faculty = faculdade
fade = definhar, engelhar, estiolar, fanar, murchar
fail = abortar, fracassar, malograr-se, ter mau êxito
failure = abortamento, falência, quebra, fiasco, malogro
faint = débil, fraco, desfalecer, desmaiar, esvanecer, chilique, desfalecimento, desmaio
fair = bazar, mercado, flavo, loiro, louro, feira, eqüitativo, justo, reto
fairy = feérico, fada, gênio
fairy tale = conto de fadas, estória, fábula, lenda
faith = fé
faithful = seguro, fiel, leal
falcon = falcão
fall = cair do alto, cair, desabar, tombar, ruir
fallacious = enganoso
fall backwards = cair de costas
fall in = enfileirar-se, incluir-se
fall into line = enfileirar-se, incluir-se
fall off = cair do alto
false = falsificado, falso, mentiroso
false step = passo em falso
falsify = adulterar, deturpar, falsear, falsificar
fame = notoriedade, rumor, boato, nomeada, glória, fama, renome
family = família
famine = grande fome geral
famous = famoso, célebre, ilustre, notório, glorioso
fan = excitar soprando, <dar mais animação a alguém>, abanar, joeirar, ventilar, abano, leque
fanatical = fanático
fancier = amador, curioso, diletanto, não profissional
fancy = imaginar, devanear, fantasiar, sonhar
fanfare = charanga, fanfarra
fantastic = fantástico, imaginário
fantasy = fantasia
far = afastado, distante
fare = passar, andar, estar
Far East = Extremo-Oriente
farewell = até logo, adeus, despedida
farm = bens de raiz, domínio, fazenda, granja, propriedade, roça, terras, arrendar, arrendamento
farmer = arrendatário, camponês, fazendeiro, agricultor
farming = agricultura
fart = peidar, peido
fascinate = fascinar
fascinating = fascinante, fascinador
fashion = costume, moda, mode
fashionable = na moda
fast = consistente, constante, firme, rápido, veloz, depressa
fasten = aprazar, cravar, determinar, fixar, aferrolhar
fast train = expresso, rápido
fat = encorpado, espesso, grosso, volumoso, barrigudo, gordo, banha, gordura
fate = fatalidade, destino, sina, sorte
fateful = fatal
father = pai
father-in-law = sogro
fatherland = pátria
fatty = gordo
faucet = bica, torneira
fault = culpa, delito, falta
favor = favorecer, favor, gentileza, obséquio
favorite = favorito
favour = favorecer, favor, gentileza, obséquio
favourable = favorável, propício
favourite = favorito
fear = aflição, angústia, ânsia, transe, recear, temer, ter medo de, acanhar-se, medo, receio
fearless = intrépido
feast = comer em banquete, ágape, banquete
feather = pena, pluma
feature = feição, linha, traço
February = Fevereiro
federal = federal
federation = federação
feed = comer, alimentar, nutrir, sustenar, apascentar, pastorear
feeding-bottle = mamadeira
feel = palpar, apalpar, tatear, experimentar, sentir, sentimento
feel dizzy = sentir vertigem
feel fine = <estar bem de saúde>
feeling = sentimento
feign = aparentar, fingir, simular
fellow = homem, varão, macho
fellow-thinker = coidealista, correligionário
female = fêmea, fêmeo, feminino
female admirer = admiradora
female cook = cozinheira
female hairdresser = cabeleireira
female journalist = jornalista
female relative = parente
female singer = cantora
female stenotypist = dactilógrafa, datilógrafa
female tailor = costureira
female teacher = mestra
feminine = fêmea, feminino
fence = barreira, obstáculo, estacada, paliçada
fence off = cercar em redor de
ferment = fermentar
fern = feto
ferry = barca
fertile = fértil, fecundo, frutífero
fertilize = estercar, fertilizar
fertilizer = esterco, estrume
fervor = ardor, fervor, zelo
fervour = ardor, fervor, zelo
festival = celebração, festa
fetch = trazer
fetter = acorrentar, algemar, cadeia, corrente, grilhão
feudal = feudal
fever = febre
feverish = febril
fewer = menos
fiancé = noivo
fiancée = noiva
fiasco = fiasco, malogro
fiber = fibra, filamento
fibre = fibra, filamento
fiction = ficção, invenção
fictional = fictício
fictitious = fictício
fief = feudo
field = agro, terra cultivável, campina, área, campina, campo, área, campina, campo
field hospital = ambulância, hospital militar móvel
fierce = cruel, feroz
fifteen = quinze
fifth = quinto
fifty = cinquenta
fig = figo
fight = batalhar, brigar, combater, guerrear, lidar, lutar, pelejar, lutar contra, opor
fight against = lutar contra, opor
fig-tree = figueira
figurative = da figura
figure = algarismo, cifra, número, figura, imagem, vulto configuração, calcular, computar, orçar
file = dossiê, limar, polir, lima, fichário, arquivo, pasta para papéis, teca, cauda, fila, fileira, linha, turno, vez, ala, fiada, forma
files = arquivo
filing card = ficha
fill = completar, encher
fill in = completar, encher
fill up = completar, encher
film = filme, película
filter = filtrar, filtro
filthy = sujo
fin = barbatana
final = final
finalize = passar a limpo
finally = em fim, finalmente, por fim
finance = financiar, finanças
financial = financeiro
find = achar, deparar, encontrar, asceitar
find oneself = sencontrar-se, achar-se, encontrar-se, estar
find out = informar-se
fine = belo, bonito, formoso, pulcro, excelente, ótimo, brando, delicado, fino, grácil, meigo, mimoso, sutil, multa, dinheiro da multa
finger = dedo, apalpar
finish = dar o acabamento, ultimar, <dar acabamento com esse verniz>, levar ao cabo, elaborar, acabar, encerrar, finalizar, terminar, aparelhar, aprontar, preparar
finished = disposto, prestes, pronto
Finland = Finlândia
Finn = finlandês
fir = abeto, pinheiro
fire = demitir, destituir, exonerar, fogo, lume, incêndio, despedir, atirar, disparar, <dar mais animação a alguém>
firebox = braseiro, fogão, fornalha, lar
fireplace = chaminé, lareira
fireworks = fogos de artifício
firing = tiroteio
firing-cap = cápsula
firm = consistente, constante, firme, firma, loja, forte, rijo, sólido
firm in one's principle = principal
firm in one's principles = principal
first = primeiro, ao princípio, em primeiro lugar, primeiramente
firstly = ao princípio, em primeiro lugar, primeiramente
first name = apelido
first of all = ao princípio, em primeiro lugar, primeiramente
fish = pescar, peixe
fisherman = pescador
fishing rod = cana
fist = punho
fit = acomodar, adaptar, ajeitar, ajustar, apoplexia, estar conforme a, convir, prestar-se, servir, valer
fit in = estar conforme a
fitness = aptidão, conveniência, capacidade
fit out = guarnecer, rechear, revestir
fitter = encanador, bombeiro
fitting = conveniente, decoroso, próprio, adequado, apropriado, conforme
fit together = estar em harmonia
five = cinco
fix = acomodar, adaptar, ajeitar, ajustar, definir, aprazar, cravar, determinar, fixar, consertar, reparar, restaurar
fixed = fixo
fix up = arranjar, arrumar, dispor, ordenar, preparar
fjord = fiorde
flag = pavilhão, bandeira, estandarte, pendão
flame = arder, chama, labareda, paixão
flammable = combustível, inflamável
flan = ovos e farinha, torta de nata
Flanders = Flandres
flannel = flanelado, flanela
flapper = adolescente
flare = chamejar, coruscar, flamejar
flare up = chamejar, coruscar, flamejar
flash = lançar brilho de súbito
flash on = começar a queimar
flask = cantil
flat = apartamento, aposentos, bemol, chão, raso, bastidor, chato, plano
flat-iron = ferro de engomar, ferro de passar roupa
flatter = gabar, lisonjear
flattery = lisonja
flavor = dar gosto a
flavour = aroma, fragrância, odor, dar gosto a
flax = linho
flea = pulga
flee = escapar de, escapar, evadir-se, fugir
flesh = carne
flexible = flexível
flicker = cintilar
flier = folha solta
flight = vôo
flighty = frívolo, leviano
fling = agitar, bater, mexer, vibrar
flirt = borboletear, esvoaçar, flutuar
flit = borboletear, esvoaçar, flutuar
float = boiar, flutuar, nadar, adejar, esvoaçar, librar-se, pairar
flock = gado, grei, rebanho
flog = vergastar
flood = preamar, dilúvio, fluxo, alagar, encharcar, inundar, inundação, submersão, cobrir com abundáncia, sobrecarregar
floor = andar, soalho, assoalho, pavimento
flounder = debater-se, espernear, estrebuchar
flour = farinha
flourish = charanga, fanfarra
flow = correr, fluir, corrente, fluxo
flower = flor
flu = gripe
fluent = corrente, fluido
fluff = lanugem, pêlo, penugem
fluid = fluido, líquido, líquido
flutter = excitação doentia, borboletear, esvoaçar, flutuar, <série de vibrações de um objecto ou de um órgão>
fly = balanceiro, voar, mosca
foam = espumejar, espuma
focus = foco
fog = bruma, neblina, névoa
fold = dobrar, fazer pregas, ferrar, vincar, dobra, prega
folder = caderno, fascículo
foliage = folhagem
folk = gente, povo, nação
folklore = folclore
follow = seguir, suceder
following = <grupo não organizado>, seguinte
fondle = acariciar, afagar, mimosear
food = alimento
fool = burlar, ludibriar, mistificar, imbecil
foolish = estúpido, imbecil, tolo
foot = <medida>, pé
football = futebol
fop = almofadinha, janota, dândi
for = durante, em troca de, pro causa de, pois que, porque, visto que
for a long time = há muito
force = constranger, força, intensidade, vigor, violentar, ditar, impor, obrigar, forçar
ford = atravessar a vau
fore = avanço, primeiro plano
forecast = predizer, adivinhar, agourar, augurar, profetizar, pressagiar, prognosticar, prognose, prognóstico
forefather = antepassado
foreground = anteprojeto
forehead = fronte, testa
foreign = extrangeiro, alienígena, estrangeiro, estranho
foreign country = país exterior, terra estrangeira
foreigner = estrangeiro
foresee = prever, antever
foreseeable = previsível
forest = floresta, mata
foretell = predizer, adivinhar, agourar, augurar, pressagiar, profetizar
forever = eternamente
for ever = eternamente
for every reason = por todos os motivos
foreward = adiante, avante, para frente
foreword = prefácio
for example = por exemplo
forget = esquecer
forget-me-not = as-de-mim, miosótis, não-te-esquece
forgive = desculpar, escusar, perdoar
for instance = por exemplo
form = formar, feitio, forma, jeito, formulário
form a group = agrupar-se, reunir-se
formal = ceremonioso, pomposo, solene, explícito, expresso, formal
form an embankment = deter, represar
former = antecedente, anterior, precedente, ex-, passado
formerly = anteriormente, antes, em lugar anterior
formidable = extraordinário
formula = fórmula
formulate = formular
form up = enfileirar-se, incluir-se
for no reason = por nenhum motivo, por nenhuma razão
for nothing = grátis
for rent = para alugar
forsake = abandonar
for sake of = em troca de, pro causa de
for sale = adquirível, comprável, vendável
for the first time = pela primeira vez
for the greater part = pela maior parte
for the most part = pela maior parte
for the reason that = por isso que, pois, pois que, porque
for the rest = aliás, além disso
for the time being = provisoriamente, temporiamente
fortification = fortaleza, fortificação
fortify = amplificar, fortalecer
fortunate = feliz
fortunately = felizmente
fortune = acaso, felicidade, destino, sina, sorte
fortune teller = adivinho, áugure, arúspice, profeta
forty = quarenta
forum = foro, fórum
forward = avante
found = estabelecer, fundar, instalar, basear, dar base
foundation = fundação, alicerce, base, fundamento, fundo
fountain = chafariz, fonte, manancial, nascente
fountain-pen = caneta tinteiro
fountain pen = caneta tinteiro
four = quatro
fourteen = catorze, quatorze
fourth = quarto, uma quarta parte
fowl = carne de ave, galinha, ave doméstica
fox = raposa
foxglove = dedaleira, digital, erva-dedal
fraction = fração
fragile = frágil, quebradiço
fragment = elemento, partícula, fragmento
fragmentary = fragmentário
fragrant = aromática, fragrante
frame = emoldurar, enquadrar, caixilho, moldura, quadro
framework = caixilho, moldura, quadro
France = França
frankly = abertamente, sem rodeios
freckle = lentigem, sarda
free = livre, grátis
free and easy = desembaraçado, íntima, sem-cerimônia
freedom = liberdade
freemason = maçom
freeway = auto-estrada, rodovia, autopista
freeze = gelar, congelar
freezer = freezer
freezing cold = geada, frio
French = francês
Frenchman = francês
frequent = freqüentar, ir ver, visitar, frequente, freqüente
frequently = amiúde, frequentemente, freqüentemente, muitas vezes
fresh = fresco, novo, recente
friction = fricção
Friday = sexta-feira
friend = amiga, amigo
friendly = afável, amável, bondoso, gentil, lhano, amigável
friendship = afeição, amizade
fright = pavor
frighten = aterrorizar, horripilar, amedrontar
frigid = frio
frindge = fímbria, franja
fringe = beira, margem, borda
frivolity = coisa fútil, coisa sem sentido, coisa vã
frivolous = emproado, fofo, frívolo, fútil, inane, vaidoso
frock coat = redingote, sobrecasaca
frog = rã
frolic = traquinas, fazer travessuras, garotar, traquinar
frolic about = dar cabriolas
frolicsome = traquinas
from = por, a partir de, desde, de, dentre
from where = donde
front = frente, fronte, vanguarda
frontage = frente, fronte, vanguarda
frontier = confins, fronteira, limite, raia
frost = frio, geada
froth = bater, fazer molinete, mexer, espumejar, espuma
fruit = fruta
fruitful = fecundo, frutífero
fruit-tree = árvore frutífera
frustrate = frustrar
fry = frigir, fritar
frying-pan = frigideira, sartã
frying pan = frigideira, sartã
fuel = combustível, material com que se aquece
ful = <terminacão do adjectivo>
full = cheio, completo, pleno, farto, saciado, satisfeito
full-grown = adulto, maior
full moon = lua cheia
full of holes = esburacado
full of zeal = fervoroso, zeloso
fully = completamente
fume = despender gases mefíticos, feder, exalação mefítica, fedor, gás deletério
fumy = infecto, pestilento
fun = distração, divertimento, recreio, deleite, delícia, prazer
function = estar em exercício, exercer funções, funcionar, função, cargo, emprego, lugar, ofício
functionary = funcionário
fund = fundo, caixa, cofre
fundamental = básico, fundamental
funeral = enterramento, funeral, sepultamento, enterro
fungus = cogumelo, fungo
funnel = funil
funny = divertido, recreativo, cómico, cômico
fur = <pele de animal com pélos>, pele, peliça
fur coat = pele, peliça
furious = fulo, furioso, raivoso
furlough = licença
furnace = fogão, forno
furnish = dar, entregar, fornecer, ministrar, mobiliar
furniture = mobília, mobiliário, movéis
fur piece = pele, peliça
furrow = encrespar, enrugar, franzir, sulcar, calha, rego, sulco
further = mais
furthermore = em continuação, mais, mais adiante
fuse = mecha, pavio
futile = estéril, fútil, improfícuo, inútil, vão
future = futuro