#setName = words_en_pt_tt
#sideOneTitle = ENG
#sideTwoTitle = POR
tabernacle = tabernáculo, sacrário
table = lista, tabela, tábua, tabuada, quadro, mesa, távola
table-cloth = toalha de mesa
tablet = lista, tabela, tábua, tabuada, quadro
tabulation = lista, tabela, tábua, tabuada, quadro
tact = andamento, compasso, tacto, tino
tactic = táctica
tactics = táctica
Tadzhik = tajíqui
Tadzhikistan = Tadjiquistão
Tagus = Tajo
tail = cauda, rabo, rabeira, abas, fila, bicha
tailor = <fazer veste para homem>, costureira, alfaiate
tails = casaca, fraque
take = aceitar, acolher, admitir, receber, topar, encher, ocupar, preencher, pegar, tirar, tomar
take a break = fazer uma pausa
take action = agir, obrar, proceder
take along = levar consigo, convocar, reunir
take an interest = interessar-se
take apart = desmontar
take a rest = fazer uma pausa
take a shower = tomar banho de chuveiro, tomar ducha
take a sunbath = expor ao sol
take a switch to = vergastar
take away = descontar, tirar, arrancar, tomar
take care = acurar, cuidar, preocupar-se, tutelar, zelar
take fire = começar a queimar
take in = assinar, aceitar, acolher, admitir, receber, topar, <receber dinheiro por uma mercadoria ou serviço prestado>, charlatanear, fazer charlatanismo
take into account = considerar, refletir
take leave = dar adeus, despedir-se, dizer adeus
take leave from = dar adeus, despedir-se, dizer adeus
taken aback = hesitante, perplexo
take note = achar, constatar, reconhecer, verificar
take off = depor, tirar
take offence = ofender-se
take offense = ofender-se
take over = comprar
take part = participar, tomar parte
take refuge = asilar-se, refugiar-se
take the place of = substituir
taking = compra
taking over = compra
tale = conto, narrativa
talent = talento, engenho
talented = dotado, talentoso
talisman = amuleto, figa, talismã, patuá
talk = falar
talkative = falador, loquaz
tall = alto, elevado, eminente
tallow = sebo
Talmud = Talmude
tamarisk = tamárice, tamariz
tame = adrestrar, amansar, domar, ensinar, educar, domesticado, manso
tampon = absorvente, tampão
tan = tanar, curtir
Tangier = Tânger
tangle = caos
tango = tango
tank = cisterna, tanque
tannin = tanino
Tantalus = Tântalo
Tanzania = Tanzânia
tap = bater de leve, bica, torneira
tape = enfaixar, coirela, faixa, fita, listrão
tape-recorder = gravador, magnetofone
tapestry = forro
tar = alcatroar, cobrir com alcatrão, alcatrão
tarantula = tarântula
tard = ovos e farinha, torta de nata
tardy = tardio
target = alvo, fim, ponto de mira
tart = acerbo, ácido, azedo, adstringente, torta
Tartar = tátaro
task = carga, empreitada, tarefa, gravame, encargo, incumbência
taskmaster = intendente, zelador, alcaide, bailio
Tasmania = Tasmânia
taste = ter o gosto de, gosto, sabor, provar, saborear, prova
tasteless = insípido
tasty = agradável ao paladar, saboroso
Tatar = tatárico
tattler = paroleiro, palrador, tagarela
tau = tau
tavern = taberna
tax = onerar com imposto, imposto
tax collector = colector, coletor
taxi = táxi
taxidriver = motorista de táxi
taxi-driver = motorista de táxi
tea = chá
teach = ensinar, instruir, lecionar
teacher = mestra, mestre, professor
teak tree = tectona
team = equipe, time
teapot = bule de chá
tea-pot = bule
tear = lágrima, fragmento, dilacerar, rasgar, romper
tear off = arrancar, colher, tirar
tease = contrariar, importunar
teat = mama, teta
technetium = tecnécio
technical = técnico
technics = técnica
technique = técnica
technology = tecnologia
teeth = dentadura, dentama
teetotalism = abstemia, abstenção, abstinência
telegram = telegrama
telegraph = telegrafar, telégrafo
telemetry = telemetria
telephone = telefonar, telefone
telephone booth = cabine telefônica, orelhão
telephone kiosk = cabine telefônica, orelhão
telescope = telescópio
television = televisão
television set = televisão
tell = dizer, proferir, comissionar, incumbir, dar ordem, mandar, ordenar, prescrever, contar, descrever, narrar
tell a lie = faltar à verdade, mentir
telltale = paroleiro, palrador, tagarela
tellurium = telúrio
temper = endurecer, enrijar, temperar, humor
temperament = temperamento, gênio, índole
temperate = comedido, parco, sério, sóbrio
temperature = temperatura
tempest = tempestade, tormenta, temporal
template = chapa, clichê, molde, padrão
temple = fontes, têmpora, templo
templet = chapa, clichê, molde, padrão
temporarily = provisoriamente, temporiamente
temporary = breve, curto, fugaz, passageiro, provisório, temporário
tempt = induzir em tentação, tentar
temptation = tentação
ten = dez
tenant = inquilino, locatário
tench = tenca, tainha-dos-rios
tendencious = tendencioso
tendency = disposição, afeição, inclinação, tendência
tendentious = tendencioso
tender = ameno, doce, meigo, suave, apresentar, oferecer, propor, oferta, proposta, cuidadoso, zeloso
tenderness = delicadeza, finura, subtileza, tacto, ternura
tendon = tendão
tend to = cuidar, tratar, zelar
tennis = tênis
tenor = tenor
tenor violin = viola
tension = esforço, tensão
tent = barraca, tenda, pavilhão
tented camp = acampamento, arraial
tenth = décimo
term = expressão, termo, vocábulo
terminate = acabar, encerrar, finalizar, terminar
terminology = terminologia
terms = cláusula, condição
terrace = plataforma, terraço
terrain = terreno
terrestrial = terrestre, terreno, terreal, terráqueo
terrible = horrível, terrível
terrify = aterrorizar, horripilar
territorial = territorial
territory = território
terror = terrorismo, horror, terror, pavor
terrorism = terrorismo
terrorist = terrorista
test = exame, prova, amostra, experiência, ensaiar, experimentar, provar, esforço, testar, teste
testament = testamento
testify = atestar, certificar, provar, testemunhar
testimony = atestado, certificado, depoimento, testemunho
Teuton = teutão
Texas = Texas
text = letra, teor, texto
textbook = livro didático
textile = tecido
Thai = tailandês
Thailand = Tailândia
thallium = tálio
Thames = Tâmisa
than = que, do que
thank = agradecer, dever, render graças a
thankful = agradecido, grato, reconhecido
thankless = ingrato
thanks = agradecimento, gratidão, obrigado
thanks to = graças a
thank you = obrigado
that = que, que coisa, o que, quem, qual, o qual, assim, daquela maneira, desta maneira, deste modo
that is = a saber
that kind of = tal, de tal espécie, de tal qualidade
that much = em tal quantidade, tanto, tão
that one = aquela, aquele, essa, esse
that one over there = aquela, aquele, essa, esse
that one's = desse, deste
that ... over there = de lá, daquele lugar, aquela, aquele, essa, esse
that over there = aquilo, isso
that's all right = não importa, pouco importa
that's okay = não importa, pouco importa
that's too bad = deploravelmente, lamentavelmente
that way = assim, daquela maneira, desta maneira, deste modo, para aí, para lá
thaw = degelar, derreter-se, degelo
the = tanto, a, as, o, os
the Arctic = Ártico
theatre = teatro
theatre play = peça para teatro
theatrical = teatral
theatrical tour = turnê
the day after tomorrow = depois de amanhã
the day before yesterday = anteontem
thee = o, os, a, as, vos, te
the Far East = Extremo-Oriente
theft = furto
The Hague = Haia, a Haia
their = delas, deles
theme = assunto, motivo, tema, matéria
then = por conseguinte, portanto, depois, em seguida, logo, então, nessa ocasião, neste tempo, naquele tempo
the Netherlands = Países Baixos
theocracy = teocracia
theologian = teólogo
theology = teologia
theorem = teorema
theory = teoria
the power of suggestion = sugestão
the proletariat = proletariado
therapy = terapia
there = eis, eis aí, eis ali, eis aqui, para aí, para lá, acolá, aí, além, ali, nesse, nesses, lugar, lugares, naquele
thereabout = à volta, em redor
thereabouts = à volta, em redor
thereafter = depois, em seguida, logo
there are = há
therefore = então, logo, por conseguinte, em vista disso, por este motivo, por isso, portanto
there is = há
thermometer = termômetro
thermos = garrafa térmica
thermos bottle = garrafa térmica
thermos flask = garrafa térmica
thermostat = termostato
these = estas, estes
these days = actualmente, atualmente, presentemente
thesis = tese
the ... the = quanto ... tanto
the Transvaal = Transval
the Ukraine = Ucrânia
the Vatican = Vaticano
they = elas, eles, a gente
thick = basto, cerrado, compacto, denso, encorpado, espesso, grosso, volumoso
thicken = avolumar
thickness = espessura, grossura
thief = ladrão
thigh = coxa
thimble = dedal
thin = magro, delgado, fino, delicado
thing = coisa, cousa, assunto, complemento, objecto, objeto, artigo
think = opinar, ser de opinião, achar, julgar, pensar, refletir
think about = pensar, refletir
think ahead = antecipar
think to oneself = pensar maduramente, refletir muito
think well of = apreciar, avaliar, estimar, gostar, prezar
third = terceiro, um terço
thirst = sede
thirteen = treze
thirty = trinta
this = esta, este
this evening = esta tarde
this morning = esta manhã
this way = de tal modo, cá
thither = para aí, para lá
Thor = Tor
thorium = tório
thorn = espinho, estrepe, pico
thoroughly = completamente
those = aquilo, isso
thou = vós, tu, você, vocês, vossemecê, vossemecês, o senhor, a senhora
though = ainda que, conquanto, posto que
thought = pensamento
thoughtfulness = precaução, providência, solicitude
thousand = mil
thread = fio, linha, enfiar
threat = ameaça
threaten = ameaçar, intimidar
three = três
three times = três vezes
thresh = bater, debulhar, esbordoar, espancar, malhar, sovar, trilhar
threshold = limiar, soleira
thrice = três vezes
thrifty = econômico
throat = garganta
throb = palpitar, pulsar
throne = trono, sólio
through = completamente, por intermédio de, por meio de, disposto, prestes, pronto, em troca de, pro causa de, através de, por, por entre
throw = arremessar, atirar, lançar
throw-back = atavismo
throw up = lançar, vomitar
thrush = turdo
thrust = empurrar, impelir
thrust out = expor empurrando
thulium = túlio
thumb = polegar
thunder = ribombar, trovejar, atroar, ribombo, trovão
Thuringia = Turíngia
Thursday = quinta-feira
thus = logo, por conseguinte, sendo assim, de tal modo, assim, daquela maneira, desta maneira, deste modo
thwart = dificultar
Tiber = Tibre
Tiberius = Tibério
Tibet = Tibete
Tibetan = tibetano
tibia = tíbia
tic = lona, tique, cotim
ticket = bilhete, cupom, ficha, passagem
ticket-window = bilheteira, bilheteria, guichê
tickle = fazer cócegas a, titilar
tidbit = acepipe, guloseima
tide = maré
tidy = arranjar, arrumar, ordenar
tie = gravata, amarrar, atar, ligar, laço, liga, ligamento, vínculo
tie up = amarrar, atar, ligar
tiger = tigre
Tigris = Tigre
tilde = til
till = caixa, cofre, até, até que
tillage = agricultura
timber = lenha, madeira, pau
time = feita, vez, hora, tempo
time off = férias
time-table = horário
timid = tímido, timorato, medonho
Timor = Timor
tin = folha, lata, folha de lata, lámina de metal, lâmina de metal, caixa de lata, de estanho
tin can = lata, caixa de lata
tinder = isca
tinkle = tilintar, tinir, retinir, tinido
tin plate = folha, lata, folha de lata, lámina de metal, lâmina de metal
tint = matiz, nuança, tingir, tintura
tiny = pequeno
tip = beira, fim, topo, ápice, extremidade, pico, ponta, gorjeta
tired = cansado, fatigado
tiresome = aborrecido, enfadonho, fastidioso
Titan = Titã, titânio
titanic = titânico
titanium = titânio
title = titular, cabeçalho, epígrafe, título, tratamento
titmouse = abelharuco, abelheiro, milharós
to = a, para
toad = sapo
toast = assar, torrar, tostar, beber à saúde de, brindar, saudar, brinde, saúde, toste
tobacco = tabaco, nicociana, fumo
today = hoje
toe = dedo do pé
toga = toga
together = a par, juntamente, junto, simulaneamente
together with = com, bem como, em companhia de, juntamente, junto com
toilet = privada, retrete, toalete, traje, vestimenta
token = prova, aceno, signo, sinal, marca, ponto
tolerant = tolerante
tolerate = agüentar, tolerar, suportar, aturar
tomato = tomate
tomb = tumba, túmulo, sepultura, jazigo
tomorrow = amanhã
tomorrow evening = amanhã de tarde
tomorrow morning = amanhã de manhã
ton = tonelada
tone = toada, tom, sonância, entonação
tongs = tenaz, alicate, torquês
tongue = idioma, língua, linguagem
tonsil = amígdala, tonsila
too = ainda, idem, outrossim, também, demais, demasiadamente, exageradamente, excessivamente
tool = ferramenta, instrumento
too much = demais, demasiadamente, exageradamente, excessivamente
tooth = dente
toothache = dentalgia, dor de dente
tooth-brush = escova de dentes
tooth-paste = dentifrício
top = superfície, cimo, cume, vértice
topaz = topázio
topgallant mast = joanete
topic = coisa actual, actualidade, assunto, motivo, tema, matéria
topical = actual, vigente
topicality = actualidade, vigência
top of the head = vértice
torch = archote, facho, tocha, brandão
torment = atormentar, supliciar, torturar, mortificar, martírio, suplício, tormento, mortificação, agonia
torpedo = torpedear, torpedo
torrent = caudal, torrente, enxurrada
tortoise = tartaruga
torture = atormentar, tortuar, tortura, suplício, tormento
torturer = torturador
to some extent = um pouco, um tanto
total = total, totalitário
total abstinence = abstemia, abstenção, abstinência
totalitarianism = totalitarismo
to tell the truth = na verdade
totem = totem, tutem, tóteme
to the left = para a esquerda
to the right = para a direita
to the side = para o lado
toucan = tucano
touch = bulir, mexer, tocar, toque
touching = comovente, enternecedor, tocante
touch lightly = tocar delicadamente
touch up = retocar
tour = turnê
tourism = turismo
tourist = turista
tournament = torneio
tousle = despentear, eriçar, arrepiar, desembaraçar, dilacerar, retorcer, revolver
tow = arrastar, levar de rastos, puxar
toward = a, para, em relação a, relativamente a
towards = a, para, em relação a, relativamente a, ao derredor de, cerca de, em redor de, em torno de, em volta de
towel = toalha
tower = roque, torre
towing-line = sirga
town = burgo, vila, cidade, município
town-hall = câmara municipal
town hall = prefeitura, municipalidade
township = lugarejo, vila
toy = brinquedo
track = pista
tractor = tractor
trade = arte, indústria, ofício, profissão, agenciar, negociar, comércio, tráfico, transação, transação comercial
trade-union = corporação, sindicato
tradition = hábito, tradição
traditional = tradicional
traffic = circulação, tráfego, tráfico
tragedy = de tragédia, trágico, tragédia
tragic = trágico, funesto
trailer = reboque
train = comitiva, cortejo, séquito, adrestrar, amansar, domar, ensinar, adestrar, exercitar, treinar, educar, comboio, trem
trait = feição, linha, traço
trajectory = trajetória
tram = bonde, carro eléctrico, trilho cavado
trample on = calcar, pisar
tranquil = calmo, sereno, tranqüilo, quedo
transaction = transacção
transact money = <fazer uma operação contábil, uma transferéncia de fundos>
transfer = transpor, ultrapassar
transform = dar outra forma, transformar
transformation = mudança
transgress = cometer pecado, pecar
transgression = pecado
transistor = transistor
transitive = transitivo
translate = traduzir, verter, trasladar
translation = tradução
transmit = enviar, mandar, remeter
transparant = transparente
transport = transportar, transporte
Transvaal = Transval
transverse = travesso, transversal
Transylvania = Transilvânia
trap = alçapão, armadilha
travel = andar, ir, rodar, viajar
traveller = viajante
travesty = paródia
treacherous = pérfido
treachery = traição
tread = andar, caminhar, dar um passo, calcar, pisar
treasure = tesouro
treat = curar, medicar, tratar de, negociar, mimosear, obsequiar, regalar, bom tratamento, regalo, agenciar, tratar
treatise = tratado
treatment = tratamento, negociação
treaty = tratado
tree = arbóreo, árvore
tree- = arbóreo
tree-trunk = tronco
trefoil = trevo
tremble = tiritar, tremer
trench = trincheira
tressle = banco, bastidor, cavalete, mesa
trial = aflição, agonia, pesar, amostra, experiência
triangle = triângulo
Triassic = triásico
tribal = tribal
tribe = gênero, raça, tribo
tribunal = foro, tribunal, juízo
tribune = tribuno
tribute = tributo
trick = artifício, artimanha, estratagema, subterfúgio, tramóia, burlar, ludibriar, mistificar, astúcia, trucagem
trickery = artifício, artimanha, estratagema, subterfúgio, tramóia
tricycle = triciclo
trifle = bagatela, bugiganga, futilidade, minúncia, nuga
trifling = insignificante
trigger = cão
trigonometry = trigonometria
trill = trilar, trinar, trilo, trinado
trillion = trilhão, trilião, quintilhão
trilogy = trilogia
trim = guarnecer, rechear, revestir
Trinity = Trindade
trip = viagem
triple = triplo, tríplice
Tripoli = Trípoli
trite = banal, comun, trivial, vulgar
triteness = banalidade
Triton = Tritão
triumph = triunfar, alcançar vitória, cantar vitória, vitória, triunfo
triviality = banalidade
Trojan = troiano
trolley = trole
trolley-bus = ônibus eléctrico, trólebus
trombone = trombone
troop = companhia, elenco, tropa
tropical = tropical
tropics = trópico
trot = andar a trote, trotar, trotear
trouble = dificuldade, problema, importunar, incomodar, molestar
trough = cocho, gamela, tina
troupe = companhia, elenco, tropa
trousers = calças
trout = truta
Troy = Tróia
truck = caminhão
truculent = batalhador, lutador
true = justo, que tem razão, verdadeiro, verídico, vero
truly = deveras, na realidade, na verdade, verdadeiramente
trump = jogar trunfo, trunfar
trumpet = buzinar, tocar trombeta, trombetear, trompa, tuba, buzina
trunk = baú, focinho, rosto, tromba, torso, tronco, caule
trust = ter fé, ter fé em, fé, confiar, contar com, crer, ter confiança em
trustworthy = fidedigno, seguro
truth = veracidade, verdade
try = dar-se ao trabalho de, empenhar-se em, esforçar-se, ensaiar, experimentar, provar
T-square = esquadro
tub = cuba, tina
tube = câmara de ar, cano, canudo, tubo, valva, válvula
tuberculosis = tuberculose
Tuesday = terça-feira
tuft = tufo
tug = sacar, puxar, tirar, rebocador
tugboat = rebocador
tulip = tulipa
tumble down = cair do alto
tummy = abdômen, barriga, pança, ventre
tummy ache = dor de barriga
tumor = tumor
tumour = tumor
tumult = tumulto, agitação, bulício, arruaça, bulha, distúrbio, motim
tuna = atum
tuna-fish = atum
tune = acomodar, adaptar, ajeitar, ajustar, afinar, sintonizar, melodia, toada
tuneful = melódico, melodioso
tungsten = tungstênio, volfrâmio
tunic = membrana, túnica
Tunis = Tunis
Tunisia = Tunísia
tunnel = túnel
tunny = atum
Turin = Turim
Turk = turco
turkey = meleagro
Turkish = turco
Turkmenistan = Turcomênia
turn = desencaminhar-se, desviar-se, extraviar-se, deitar por terra, derribar, entornar, revirar, tornear, virar, voltar, volver, rodar, voltear, transformar, volta, girar, dar voltas, voltar-se, cauda, fila, fileira, linha, turno, vez, ala, fiada, forma
turn around = virar, voltar, volver, rodar, voltear, transformar, girar, dar voltas, voltar-se
turn away = desviar
turn back = girar, dar voltas, voltar-se
turnip = nabo
turn off = desligar
turn on = activar, ligar
turn over = deitar por terra, derribar, entornar, revirar
turn round = virar, voltar, volver, rodar, voltear, transformar, girar, dar voltas, voltar-se
turn to good account = utilizar
turtle-dove = rola, juriti
tussle = batalhar uns contra os outros
tutor = educar, instruir, preceptor
TV = televisão
TV set = televisão
Twelfth-night = Epifania
twelve = doze
twenty = vinte
twenty-one = vinte e um
twice = duas vezes
twich = lona, tique, cotim
twilight = anoitecer, crepúsculo
twin = gemelar, gêmeo
twine = trançar, entrançar
twins = gémeos, gêmeos
twist = torcer, retorcer, contorcer, enrolar-se
twitter = gorjear, piar, pipilar
two = dois, duas
two hundred = duzentos
type = datilografar, digitar, escrever à máquina, modelo, padrão, tipo
typeset = compor
typewriter = máquina de escrever
typewriter carriage = carreta, carrinho
typhoon = tufão
typhus = tifo
typical = modelar, típico
typist = datilógrafa
tyrannize = tiranizar
tyranny = tirania
tyrant = déspota, tirano
tyre = pneumático
Tyrrhenian Sea = Mar Tirreno