#setName = words_en_la_qs
#sideOneTitle = ENG
#sideTwoTitle = LAT
quadrangle = tetragonum
quail = coturnix, ortigometra
quarter = vicus
quash = annihilare, annullare
queen = regina
quite = satis, admodum, antigerio, apprime
quiver = tremere, tremor
quivering = tremor
rabbit = cuniculus
race = currere, volare, gens, genus, natio
radish = radix, raphanum, rapulum, raphanus
rain = imber, pluvia
raincoat = pænula
raise = levare
ram = aries
ranch = vicus, villa
rand = labrum, limbus, ora
rare = rarus
rate = æstimare, appretiare, censere, taxare
rather = satis
rave = morari
raven = corax, corvus
ravine = barathrum, crater
raw = crudus
re- = re-, red-
reach = pervenire
read = legere
reality = veritas
realize = intellegere
reason = causa
receive = accipere
reception room = atrium
reciter = acroama
recognize = agnoscere, accognoscere
recollection = memoria
record = matrix
red = ruber, russus
reed = arundo, calamus, canna
referee = arbiter
regain = reparare
regal = basilicus, regalis, regificus, regillus, regius
regard = spectare
region = regio
register = matrix
regularly = sæpe
relate = narrare
release = liberare
religion = religio
remain = manere
remaining = ceterus
remove = relegare
renew = renovare, reparare
renown = fama, gloria
rented house = meritorium
rent out = ablocare
repair = reparare
reply = respondere, responsum
repose = requiescere
representation = figura
reproach = crimen
repute = fama
request = petere, rogare
require = requirere, exigere, postulare
reservoir = alveus, crater
residence = atrium
resign = abdicare, abire
resist = resistere
respect = cæremonia, cærimonia
respectability = cæremonia, cærimonia
respond = respondere
rest = requiescere
rest of = ceterus
restrain = gubernare, regere, regnare
resumé = breviarium
reward = præmium
rhino = rhinoceros
rhinoceros = rhinoceros
Rhone = Rhodanus
rib = costa
rice = oryza
riddle = ænigma, griphus
ride = vehere
rigour = acerbitas
rim = labrum, limbus, ora
ring = anulus, circulus
ripe = maturus
rite = ritus
river = flumen, fluvius
road = via
roam = migrare, vagari
roar = bovinari
roar with laughter = cachinnare
rob = harpagare
rock = petra, saxum
rod = asser, contus, hasta, trudis
roe = caprea
roller = cylindrus
rolling in money = zaplutus
Roman = Romanus
Rome = Roma
room = capacitas, cella
rooster = gallus
root = radix
rope = ceruchus, funis
rose = rosa
rostrum = tribunal
rotten = cariosus
rottenness = caries
rough = crudus
round = circa
round dance = chorea, chorus
rouse = stimulare
route = via
row = remigare
rowan = sorbus
rowan berry = sorbum
rower = remex
royal = basilicus, regalis, regificus, regillus, regius
royalty = regnum
rub = fricare
rubbish = alogia
rudiments = abecedarium
ruff = cicirrus
ruin = pervertere
rule = gubernare, regere, regnare
ruler = dominus
rumour = fama
run = fuga, currere, volare
run away = profugere
runner = cursor
rural = rusticus
ruse = vaframentum, ars, machina
rush towards = affluere
Russia = Ruthenia
Sabbath = sabbata, sabbatum
sack = coleus
sacred = sacer, sacratus, sanctus
sacred object = sacrum
sadness = ægrimonia, mæstitia
safety = salus
sagacious = sapiens, sophus
sage = sapiens, sophus
sail = velum
sailor = nauta
salamander = salamandra
salary = æs, merces
saliva = saliva
salmon = salmo
salt = sal
salty = salsus
salute = salutare
sanctify = sacrare, sancire, sanctificare
sanctuary = delubrum, fanum
sanctum = delubrum, fanum
sand = arenaceus, arenarius, arenosus, arena, harena
sand- = arenaceus, arenarius, arenosus
sandal = sandalium
Satan = Satanas, Zabulus
Saturday = sabbata, sabbatum
savage = sævus
say = dicere, heu
scaffold = catasta
scale = squama
scandal = calumnia, scandalum
Scandinavia = Scandia
scar = cicatrix
scene = scæna
scent = odor
sceptre = sceptrum
school = schola
scissors = axicia, bracchium
scold = admonere
scorpion = scorpio
scratch = scabere
scream = boare
scuffle = proelium, pugna
scythe = falx
sea = æquoreus, maritimus, thalassicus, æquor, mare, pontus
sea- = æquoreus, maritimus, thalassicus
sea-dog = phoca
seagull = gavia, larus
seal = phoca
sea-monster = cetus
seaside = acta, litus, ora
seaweed = alga
second = secundus
secret = arcanus
secretly = absconse, arcano, celatim
see = videre
seed = semen
seizure = apoplexia
seldom = raro
sell = vendere
send = mittere
sense = sentire
separate = abiungere, abrumpere, segregare, seiungere
sepia = sepia
serf = ambactus, cliens
serious = gravis
serpent = anguis, serpens
servant = ancilla, ancula, ambactus, anculus, calo, cliens, minister
serve = anculare, ministrare, servire
set = caterva, grex
settlement = colonia
seven = septem
seventeen = septendecim
seventh = septimus
seventy = septuaginta
severe = acerbus, austerus, severus
severity = acerbitas
sewer = cloaca
sex = sexus
sexual love = ætaluta, amor
sexual pleasure = libido
shack = canaba, casa
shade = umbra
shadow = umbra
shake one's head = abnutare, abnuere
shallop = actuariola
shallow = brevis
shame = phui
shamrock = trifolium
shape = facies, forma
share = pars, portio
sharp = acer, acutus
sharpen = acurere
sharpness = acies, acritas, acror, acumen
sheaf = fascis
she-ass = asella
she-bear = ursa
sheep = ovis
sheet = folium
she-goat = capra
shepherd = pastor, opilio, upilio
she-wolf = lupa
shin-bone = tibia
ship = abies, carina, navis
ship's boat = actuariola
shiver = tremere
shoe = calceus
shoemaker = calceolarius
shore = limbus, ora, acta, litus
short = brevis
shorten = abbreviare, curtare, breviare
shoulderblade = armus
shout = boare
show = monstrare
shuffle = miscere
shut = claudere
shyness = aporia, aporiatio
Sicily = Sicilia, Trinacria
sick = æger, ægrotus
sickle = falx
side = costa, latus
sideboard = armarium
side-branch = bracchium
sideral = astralis
sieve = cribrum
sift = cernere, cribrare, cribellare
sight = aspectamen, facies
sign = ales, avis, omen, signum
signal = signum
signature = subnotatio
silent = silens
silk = bombycinus
silk- = bombycinus
silken = bombycinus
silkworm = bombyx
sill = limen
silver = argenteus, argentum
since = a, ab, abs, quia, quod
sinew = nervus
sinful = nefas
sing = canere, cantare, canturire
singer = cantrix, cantor
singing = cantus, carmen
single = agamus, cælebs
sir = dominus
sirocco = atabulus
sit = incubare
sit down = assidere
sitting-room = atrium
six = sex
sixteen = sedecim
sixth = sextus
sixty = sexaginta
skimpy = petilus
skin = cutis, pellis
skinflint = avarus
skinny = petilus
sky = æther, æthra, axis, cælum
slander = calumnia
slaughter = cædere, mactare
slave = ancilla, serva, chrestus, servus
slay = mortificare, necare, occidere
sleep = somnus, sopor
slender = petilus
slice = scalpere, secare
slime = cænum, limus, lutum
sloop = actuariola
slope = clinamen
slowly = lente
slug = limax
sluice = cataracta
slut = cunnus
sly = captiosus, trebax, vafer
slyness = versutia
small = parvus
small basket = canistrum
smart = captiosus, trebax, vafer
smell = odor
smoke = fumus
smooth = æquus, planus
snail = cochlea
snail-shell = helica
snake = anguis, serpens
snare = casses
snow = nix
snowball = viburnum
so = sic
soap = sapo
sobriquet = agnomen, cognomen, cognomentum
sod = cæspes
sod of grass = cæspes
soft = suavis, lenis, malacus, mitis, mollis
soil = humus, tellus, terra
solair = solaris
soldier = miles
sole = solus
solely = modo, solum, tantum
solemnity = cæremonia, cærimonia
solicitor = advocatus, causidicus
solid = solidus
solitary = solus
soloist = acroama
some = aliquis
somebody = aliquis
somehow = aliqua
someone = aliquis
some one = aliquis
somewhere = quo
son = filius, natus
song = cantus, carmen
son-of-a-bitch = cimex, mæna
soon = mox
sorcerer = magus
sorcery = magia
sore = ulcus
sorrel = lapathum, rumex
sorrow = ægrimonia, mæstitia
soul = anima, animus, cor
sound = accentus, canor
sour = acescere, acerbus, austerus
south = antarcticus, australis
southern = antarcticus, australis
south wind = auster
sow = porca, scrofa
spa = aquæ
space = capacitas
spacious = amplus, latus
spade = fodere
Spain = Hispania
Spanish fly = cantharis
sparrow = passer
speak = loquere, loqui, orare
speaker's platform = tribunal
spear = abies, framea, phalarica
specialist = artifex
speed up = accelerare
spelt = ador
spider = aranea
spiderweb = aranea, araneum, casses, tela
spiral = helica
spirit = spiritus
splinter = assula
spot = locus, macula
spread = propagare
spring = salire
spy = otacustes
square decametre = caterva, grex
squash = cucurbita
squeeze = premere
squirrel = sciurus
stable = firmus
stableman = agaso
stake = palus, vacerra
stalk = gradi, calamus, caulis
stalk of cabbage = caulis
stammer = balbutire
stanchion = palus, vacerra
stand = stare
star = astralis, aster, astrum, sidus, stella
star- = astralis
state = autumare, respublica
statue = statua
stay = manere
stay over = manere
steal = chalybæus, abigere, clepere, clepsere
steam = vapor, vapos
steel = adamas, chalybs
steep = arduus
steepness = arduitas
stem = caudex, codex, matrix, calamus, caulis
step = gradi, gradus, passus
sterile = sterilis
stern = puppis
sterness = acerbitas
stick = bacillum, arundo, baculum, baculus
stimulate = stimulare
sting = aculeus, cuspis
stinginess = avaritia, avarities
stingy = avarus
stir up = concitare, stimulare
Stockholm = Holmia
stomach = alvus, aqualiculus, venter
stomach ache = cardimona
stone = lapis
stone-cutter = cæmentarius
stonemason = cæmentarius
stork = ciconia
storm = auster, tempestas
stove = caminus
straight = rectus
straight past = præter
strait = fauces
strange = advena, allophylus, hospitus
stranger = hospita, hospes
strangle = astrangulare
stratagem = vaframentum
strawberry = fragum
strawberry tree = arbutus
stream = amnis
stream towards = affluere
street = via, vicus
strength = cervix, ops, vis
stress = accentus
strict = acerbus, austerus, severus
stride = gradi, gradus, passus
strike = battuere, fligere, pellere, pulsare
string = chorda, nervus, ceruchus, funis
stroke = apoplexia, admulcere, adulare
stroke of apoplexy = apoplexia
stroll = ambulare
strong = fortis, robustus
struggle = battuere, dimicare, fendere, pugnare, proelium, pugna, colluctari
study = studium
stupid = brutus, bardus, blennus, stultus
stupidly = stulte
sturgeon = acipenser
stutter = balbutire
sty = hara
Styx = Styx
subtlety = versutia
success = successus
successor = proles
such = sic
sudden = repentinus
suddenly = repente, subito
suffer = patiri
sufficiently = satis
suitability = capacitas
sulphur = sulphur, sulpur
summer = æstas
summery = breviarium
summit = culmen
summon = vocare
sun = solaris, sol
sun- = solaris
superficial = brevis
superstition = religio, superstitio
supporting base = basis
suppose = putare
sure = cautus, certus
surface = culmen
surgery = chirurgia
surmise = putare
surname = cognomen
surpass = antepollere, antestare, antevenire, superare
swallow = hirundo
swamp = lama, lustrum, palus
swan = cycnus, olor
swathe = fascia
swear = blasphemare, iurare
sweet = suavis
sweet william = amaranthus
swim = nare, natare
swim away = abnatare
swimming-bath = baptisterium
swimming-pool = baptisterium
swindle = fraus
swine = maialis, porcus
sword = gladius
sycamore = acer, platanus
synagogue = synagoge
Syracuse = Syracusæ
Syria = Syria