#setName = words_en_sv_ef
#sideOneTitle = ENG
#sideTwoTitle = SWE
each = all, envar, varenda, varje
each other = varandra, varann, varannan
eager = begärlig, sniken, snål
eagerness = begär, begäran
eagle = örn
eagle owl = uv
ear = öra
earl = greve
early = bittida, tidig
earn = förtjäna
earnest = allvarlig
earth = jord
earthquake = jordbävning
east = orient, ost, östan, öster
Easter = påsk
eastern = orientalisk, ostlig, österländsk, östlig, östra
easy = lätt
eat = spisa, äta
echo = genljuda, eko, genklang, genljud
economy = ekonomi
ecstasy = extas
edge = strand, brädd, kant, marginal, remsa, ren
edging = brädd, kant, marginal, remsa, ren
edible = ätbar, ätlig
edition = utgift
editor = redaktör
educate = uppfostra
education = uppfostran
eel = ål
effect = effekt, resultat
effort = bemödande, möda, omak
egg = ägg
egg nog = äggtoddy
Egypt = Egypten
eight = åtta
eighteen = aderton, arton
eighteenth = adertonde, artonde
eighth = åttonde
eighty = åtti, åttio
elastic = elastisk
elbow = armbåge
elder = fläder
elect = kora
election = val, valakt
electric = elektrisk
electricity = elektricitet
element = element
elemental = elementär
elementary = elementär
elements = alfabet
elephant = elefant
elevator = hiss
eleven = elva
eleventh = elfte
elf = älva
elk = älg
elm = alm
else = annan, annorlunda
elsewhere = annanstans, annorstädes
embankment = damm, fördämning, vall
emblem = emblem
embrace = famna, krama, omfamna
emerald = smaragd
emergency = kris
emigrate = utvandra
emissary = sändebud
emmet = myra
emotion = känsla, sinnesrörelse
emperor = kejsare
empire = kejsardöme
employ = engagera, använda, begagna, bruka
employee = arbetstagare, löntagare
employer = arbetsgivare, löngivare
empress = kejsarinna
emptiness = tomhet
empty = tom
enchantment = trolleri
encounter = möta
encyclopaedia = encyklopedi
end = fullborda, sluta, slut, ända, ände
ending = slut, ända, ände
end up = ankomma, sluta
endure = lida, tåla
enemy = fiende, ovän
energy = energi, ork
engagement = förlovning
engine = lok, lokomotiv, maskin, motor
engineer = ingenjör
England = England
English = engelsk
Englishman = engelsman
enigma = gåta
enjoy = fröjda, njuta
enjoyable = angenäm, anslående, behaglig, trevlig
enlarge = förstora
enmity = fiendskap
enthusiasm = entusiasm, hänförelse
entice = förföra, förleda
entire = hel
entirely = alldeles
entomb = begrava
entrance = inträde
entrust = ha förtroende för
envious = avundsam, jalu
envoy = sändebud
envy = avundas, avund, jalusi
Epiphany = trettondag
episode = episod
epoch = epok
equal = lik, jämlik
equally = desslikes, samt
equator = ekvator
equilibrium = balans, jämvikt
era = epok, era, ära
erect = grunda, instifta
err = fela, mista sig, mistaga sig
error = fel, förvillelse, misstag
escape = rymma, undkomma, undflykt
escort = eskort
Eskimo = eskimå
establish = grunda, instifta
estate = bondgård, gård, säteri
esteem = betrakta
estimate = beräkna, taxera, uppskatta, värdera
Estonia = Estland
ethical = etisk
eunuch = eunuck, snöping
Europa = Europa
Europe = Europa
European = europeisk, europé
evade = kringgå, undfly
even = flack, jämn, lik, jämlik, jämna, regelmässig
evening = afton, kväll
evening meal = aftonmåltid
event = händelse, tillfälle
ever = någonsin, alltid, ständigt
everlasting = ändlös
every = all, envar, varenda, varje
everybody = all, envar, varenda, varje
every kind of = allehanda
every one = all, envar, varenda, varje
everything = allting
everywhere = allestädes, överallt
evident = synbarligen, uppenbar
exaggerate = förstora
examination = examen, undersökning
examine = bepröva, undersöka
example = exempel, förebild, föredöme
exceed = överstiga, överträffa
except = utom, utöver
except for = utöver
excise = accis
excise-duty = accis
exclusively = bara, blott, endast
excuse = urskulda, ursäkta
excuse me = förlåt, ursäkta
excuse oneself = be om ursäkt
executioner = bödel, mästerman
exercise = inöva, öva, övning
exercise-book = skrivbok
exhausted = genomtrött, uppgiven
exhibit = exponera, exponera, utställa
exhibition = exposition, utställning
exhortation = maning
existence = existens, tillvaro
exit = utgång
expect = forvänta, vänta, vänta sig
expectation = förväntan
expel = förjaga
expensive = dyr, dyrbar
experiment = försök
expire = sluta, avlida, dö
explain = förklara, utlägga
explanation = explikation
explode = explodera
expose = exponera
exposition = exposition, utställning
express = uttrycka
expression = uttryck
extend = omfång, storhet, storlek
extensive = omfångsrik, rymlig, vid
exterminate = utplåna
extra = extra
extraordinary = synnerlig, utomordentlig
eye = öga
eyebrow = ögonbryn
eyelid = ögonlock
fabric = väv
façade = fasad
face = anlete, ansikte, min
facile = lätt
facilitate = lätta
fact = faktum
faction = part, parti
factory = fabrik
factual = faktisk
faculty = fakultet
fail = klicka
failure = abort, missfall, bankrutt, cession, fallissemang, konkurs
faint = klen, svag, svimma
fair = krambod, blond, ljus, riktig
fairy tale = saga
faith = förtroende, tillit
faithful = lojal
falcon = falk
fall = falla, ramla
fall ill = insjukna
fall in love with = bli kär i, bli förälskad i, förälska sig i
false = dolsk, falsk, osann
family = familj
famine = hungersnöd
famous = beryktad, berömd, frejdad, renommerad
fanatical = fanatisk
fancier = amatör
fantasy = fantasi
Far East = Yttersta östern
farewell = adjö, hej då, avsked
farm = bondgård, gård, säteri, arrende
farmer = lantbrukare, arrendator, bonde, jordbrukare, lantbrukare
farming = jordbruk, lantbruk, åkerbruk
farm out = förpakta
fashion = mod
fasten = befästa, fästa, regla
fast train = blixttåg, snälltåg
fat = diger, fet, tjock, fett
father = fader, far, pater
father-in-law = svärfader, svärfar
fatherland = fädernesland, hemland
fatherless = faderlös
fault = skuld
favour = befrämja, gunst, nåd, ynnest
favourable = blid, gunstig, gynnsam
fear = fruktan, rädsla, vara rädd, vara rädd för
feather = bläckpenna, plym, fjäder, penna
February = februar
fee = honorar
feed = spisa, äta
feeding-bottle = nappflaska
feign = låtsas som om
fellow = karl, man
felt = filt
female = kvinnlig
female cook = kokerska, köksa
female hairdresser = hårfrisörska
female laborer = arbeterska
female singer = sångerska
female teacher = lärarinna
femal labourer = arbeterska
femal worker = arbeterska
feminine = kvinnlig
fence = bom, slagbom, tjuvgömmare
fence off = hägna
ferry = färja
fertile = fruktbar, givande
fertilizer = dynga
festival = fest, kalas
fetch = avhämta, hala
fever = feber
fiancé = fästman
fiancée = fästmö
fiber = fiber, tåga
fibre = fiber, tåga
fief = län
field = åker, fält
field hospital = ambulansbil, sjukbil
fifteen = femton
fifteenth = femtonde
fifth = femte
fifty = femti, femtio
fig = fikon
fight = kämpa, slåss, strida
figure = figur, gestalt, beräkna, uträkna
file = fila, rasp, fil, kö, rad, räcka
files = arkiv
fill = fylla, ifylla, uppfylla
fill in = fylla, ifylla, uppfylla
filling station = bensinstation
fill up = fylla, ifylla, uppfylla
filter = filtrera, sila, sil
filthy = smutsig
fin = fena
final = ändlig
financial = finansiell
find = finna, hitta, upphitta
find oneself = befinna sig, må
fine = skön, vacker, böter, dagsböter, plikt, straffavgift, vite
finger = finger
finish = fullborda, ända
finished = färdig, redo, tillreds
Finland = Finland
Finn = finne
fir = gran
fire = eld
firewood = ved
firing-cap = kapsyl
firm = affärshus
first = första
first name = förnamn
fish = fiska, fisk
fisherman = fiskare
fishing rod = metspö
fist = näve
fit together = harmoniera
five = fem
fix = befästa, fästa, reparera, rätta
fixed = stadig
fix up = arrangera, inreda
fjord = fjord
flag = flagg, flagga, standar
flame = flamma, låga
Flanders = Flandern
flannel = flanell
flat = lägenhet, flack, jämn
flat-iron = strykjärn
flatter = lisma, smickra
flattery = smicker
flax = lin
flea = loppa
flee = undkomma, fly, rymma
fleet = flotta
Flemming = flamländare
flesh = kött
flexible = smidig
flight = flykt
fling = svinga
flint = kisel
float = flyta, simma, sväva
flood = högvatten, flod, högvatten
floor = våning, golv, tilja
flour = mjöl
flow = rinna, strömma, ström
flower = blomma, blomster
fluent = flytande
fluid = vätska
flute = flöjt
fly = flyga, fluga
foam = fradga, lödder, skum
fog = dimma, mist, tjocka, töcken
fold = vecka, veck
folder = skrivbok
foliage = löv
folk = folk
follow = följa
following = anhang
fondle = smeka
food = mat, maträtt
fool = narr, dumbom, dumhuvud
foolish = befängd, vettlös, dum
foot = tass, fot, tass
for = på
for a long time = länge
force = förplikta, tvinga, kraft, styrka
forecast = varsla
forehead = panna
foreign = utländsk, främmande
foreign country = utland
foreigner = främmande, utlänning, främling, utbörding
forest = skog
foretell = varsla
for example = till exempel
forge = smida
forget = glömma, uteglömma
forgetful = glömsk, minesslö
forget-me-not = förgätmigej
forgive = benåda, förlåta
for instance = till exempel
form = bilda, dana, forma, formera, formulär
formal = ceremoniell, formell
formidable = synnerlig, utomordentlig
formula = formel
for rent = till uthyrning
forsake = lämna
for sake of = på
for sale = till salu
fortunate = lycklig
forty = fyrti, fyrtio
foul weather = oväder
found = grunda, instifta
foundation = botten, grund
fountain = fontän, springvatten, brunn
four = fyra
fourteen = fjorton
fourteenth = fjortonde
fourth = fjärde
fowl = höna, höns
fox = mickel, räv
fragile = brytbar, bräcklig
France = Frankrike
free = fri, avgiftsfri, gratis, kostnadsfri
freedom = frihet
freemason = frimurare
free-standing = fristående
freeze = frysa
freezing cold = frost
French = fransk, franska
French language = franska
Frenchman = fransman
Frenchwoman = fransyska
frequently = ofta
fresh water = sötvatten
Friday = fredag
friend = väninna, buss, kompis, vän
friendly = snäll, vänlig, vänskaplig
friendship = vänskap
frieze = fris
fright = fruktan, rädsla, ångest
frindge = frans
fringe = brädd, kant, marginal, remsa, ren
Frisian = fris
frog = groda
from = av, av, alltifrån, efter, från, ifrån, ut, utav
from where = varifrån
frontier = gräns
frost = frost
froth = fradga, lödder, skum
fruit = frukt
fruit-tree = fruktträd
fuel = brännmaterial, bränsle
full = full, mätt
full-grown = myndig, fullvuxen, vuxen
full payment = avbetalning
fun = fröjd
function = ämbete
fund = fond, kassa
funeral = begravning
fungus = svamp
funnel = tratt
funny = komisk
fur = päls
furious = rasande, ursinnig
furnace = kamin, spis
furnish = avleverera, leverera, möblera
furnished = möblerad
furniture = bohag, möblemang
furniture van = flyttbil
future = tillkommande, framtid
fuzzy = dimmig, disig, töcknig