#setName = words_en_sv_lm
#sideOneTitle = ENG
#sideTwoTitle = SWE
laboratory = laboratorium
laborer = arbetare
labourer = arbetare
lace = pund
lack = brist, lyte, saknad
lad = gosse, pilt, pojke
ladder = stege
laddie = gosse, pilt, pojke
ladies and gentlemen = herrskap
lady = dam, fru, dam
Lady Day = bebådelsedag
lake = insjö, sjö
lamb = lamm
lame = lam
lamp = lampa
lance = lans, spjut
land = land, jord
landlady = värdinna
landlord = värd
landscape = landskap
landslide = skred
lane = gränd
language = språk, tungomål
Lapland = Lappland
Laplander = lapp
Lapp = lappländsk, lapsk, lapp
Lappish = lappländsk, lapsk
larch = lärkträd
large = stor
lark = lärka
larva = larv
lass = flicka, jänta, mö, tös
last = siska, förgången
lasting = oupphörlig
last night = i afse, i går
Latvia = Lettland
laud = berömma, lova, prisa
laugh = skratta
laughter = skratt, åtlöje
laundress = tvätterska
lava = lava
lavatory = tvättrum
law = lag
lawn = gräsmatta
lawsuit = rättegång
lawyer = advokat, sakförare
laxative = laxativ
lay = lägga
lay down = lägga, ställa, sätta
lay hold of = fatta, ta, taga
layman = lekman
lazy = lat
lead = föra, bly
leader = anförare, chef
leaf = blad
leaflet = broschyr
lean = stödja, smal, tunn
leap = hoppa, skutta, hopp, skutt
leap-year = skottår
learn = lära
lease = hyreskontrakt
leather = läder
leave = ge sig iväg, lämna
lector = lektor
lecturer = lektor
leech = blodigel
leek = vitlök
left = vänster
leg = ben
legal = rättslig
legation = legation
legend = legend, saga, sägen, sägn
legible = läslig
legitimize = legitimera
lemon = citron
lemonade = limonad, saft
lend = låna, låna av
length = längd
lengthen = förlänga
lens = lins
lentil = lins
less = -lös
lesson = lektion, läxa
let = uthyra
let know = tillkännagiva
letter = brev, bokstav
letterbox = brevlåda
lettuce = salad, sallat
level = flack, jämn, lik, jämlik, jämna, horisontal, nivå
lever = hissa, upphisa, upphäva, upphöja
lewd = okysk, osedlig, sedeslös
liberal = liberal
librarian = bibliotekarie
library = bibliotek
lie = ligga, ljuga, lögn
lieutenant = löjtnant
life = levnad, liv
life-boat = livbåt, livräddningsbåt, räddningsbåt, skeppsbåt
lift = hissa, upphisa, upphäva, upphöja, hiss
light = antända, belysa, ljus, klen, svag
lighthouse = fyr, fyrtorn
lighting = belysning
lightning = blixt
like = hur, huru, liksom, såsom, liknande, tycka om, uppskatta
likely = antaglig, sannolik, trolig
likewise = också, desslikes, samt
lilac = syren
lily = lilja
lily-of-the-valley = konvalje, liljekonvalje
limb = lem
lime = kalk
lime-tree = lind
limit = avgränsa, begränsa, gräns
limp = halta
linden-tree = lind
line = linje, fil, kö, rad, räcka
lineage = tillkomst, upphov, uppkomst, ursprung
link = montera
lion = lejon
lip = läpp
liqueur = likör
liquid = vätska
liquidate = avliva, avrätta, dräpa
lira = lyra
listen = höra, lyssna, åhöra
listener = hörare, åhorare
liter = liter
literature = litteratur
litre = liter
little = liten
Little Red Ridinghood = Rödluva
Little Snow White = Snövit
live = bo, bygga, leva
live in lodgings = hyra ett rum
lively = spirituell
liver = lever
liver sausage = leverkorv
live together = bo ihop
live to see = uppleva
living alone = ensamstående
lizard = ödla
load = ladda, lasta, frakt
loaf = bröd
loan = låna
loathe = avsky
lobster = hummer
local = lokal, ortlig
location = ort
loch = fjord, insjö, sjö
lock = lås, låsa
locust = gräshoppa
logic = logik
long = lång, länge
long for = längta efter, smäkta
longing = begär
longitude = longitud
look = anblick, anseende, vy, beskåda, kika, skåda, titta
look after = vakta
look at = beskåda, kika, skåda, titta
look for = leta, söka
looking-glass = spegel
lord = herr, herre
lorry = lastbil
lose = förlora, mista
loss = förlust
lottery = lotteri
loud = ljudelig, ljudlig
lounge = salong
louse = lus
love = älska, kärlek, vara tokig i
lovely = angenäm, anslående, behaglig, trevlig, skön, vacker, kär, rar, söt, behagfull
lover = älskarinna, älskare
low = låg, nedrig
low tide = ebb
loyal = lojal
luck = tur
luggage = bagage, resgods
luggage-van = bagagevagn
lukewarm = ljum
lump = bit
lunacy = galenskap, vansinne, vanvett
lunatic = dåre, galning, stolle
lung = lunga
lupine = varghona, varginna, lupin, vargböna
lurid = amper, egg, gräll, gäll, skarp
lust = passion
lyceum = lyceum
lying-in woman = barnsängskvinna
lynx = lo, lodjur
lyre = lyra
lyric = text
machine = maskin
mackerel = makrill
mad = dåraktig, förryckt, galen, stollig, tok, tokig, vansinnig, vriden
madam = dam, fru
madness = galenskap, vansinne, vanvett
magazine = magasin
magic = trolleri
magical = magisk
magnet = magnet
magnetic = magnetisk
magpie = skata
maid = städerska, städhjälp, tjänarinna, tjänstflicka
mail = post
mailbox = brevlåda
mailman = posttjänsteman
mainland = fastland, världsdel
maintain = behålla, förvara, konservera
maize = majs
major = major
major road = huvudled
make = göra
make ... acquaintance = göra bekantskap med
make a mistake = fela, mista sig, mistaga sig
make a noise = bullra, larma, ramla
make a note = annotera, anteckna, notera
make clean = luttra, rena, rengöra, rensa, sovra
make fast = befästa, fästa
make fun of = håna
make-up = smink
make up = smink
make use of = nyttja, använda, begagna, bruka
make war = kriga
Malay = malajisk
male = manlig
male cook = kock
malt = malt
mam = mamma
mammy = mamma
man = människa, karl, man
manage = förvalta
manager = förvaltare, administratör, direktör
maneuver = manöver
mankind = mänsklighet
manner = maner, sätt
manoeuvre = manöver
mantle = kappa
manure = dynga
many = många
map = karta, kort, landkarta
maple = lönn
marble = marmor
march = gå, löpa
margarine = margarin
mark = märke, signal, tecken
market = krambod, marknad, torg
marketplace = marknad, torg
marmelade = marmelad
marriage = äktenskap
married = gift
married people = äkta par, gift par
marry = gifta sig, gifta sig med
marsh = kärr, moras, sump, träsk
marten = mård
marter = mård, vessla
martial = krigisk
martyr = martyr
marvel = förvåna sig, undra
marvel at = förvåna sig, undra
masculine = manlig
mask = mask
mason = murare
mass = mängd, hop
massive = massiv
mast = mast
master = mästare
master builder = byggmästare
match = sticka, tändsticka
material = materiell, material
maternal aunt = moster
maternal grandfather = morfar
maternal grandmother = mormor
maternal grandparents = morföräldrar
maternal uncle = morbroder, morbror
mathematics = matematik
matter = affär, sak, fall, materia
mattress = madrass
mature = mogen
Mauretanian = mor
maximum = maxiumum
maybe = kanhände, kanske, måhände, törhända
mayhap = kanhände, kanske, måhände, törhända
mayor = borgmästare
meadow = äng
meal = mjöl, måltid
mealies = majs
mean = beteckna, betyda, teckna, mena
meaning = bemärkelsedag, betydelse
means = instrument, tyg, verktyg
measles = mässling
measured = ceremoniell
medal = medalj
medicine = läkemedel, medicin
Mediterranean = Medehavet, Medelhavet
meet = mötas, träffas, möta
meeting = församling, möte, sammankomst, sammanträde
mellowness = vekhet
melody = låt, melodi, trall
melon = melon
melt = smälta
melting = töväder
member = lem, partigängare
memory = minne
menace = hota, hot, hotelse
mend = flicka
mental = andlig
menu = karta, kort, matsedel
merchandise = vara
merchant = affärsman, handelsman
mercury = kvicksilver
merry = glad, kry, gladlynt
message = bekantgörande, tillkännagivande
messenger = sändebud
metal = metall
metalled = sten-, stenig
method = metod
metre = meter
metropolis = världsstad, huvudstad
Mexican = mexikan
microscope = mikroskop
Middle Ages = medeltida
midget = dvärg
midwife = ackuschörska, barnmorska
mild = blid, mild
mile = mil
milk = mjölk, mjölka
miller = mjölnare
million = miljon, million
mind = ande, själ, observera
mine = gruva, gruva, mina
miner = gruvarbetare
mineral = mineral
mingle = blanda, sammanblanda
minister = departementschef, minister
ministry = ministär
minority = mindretal
mint = mynta
minute = minut
miracle = under, vidunder
miraculous = underbar, vidunderlig
mirror = spegel
miscarriage = missfall, abort, missfall
miscarry = klicka
miscellaneous = varjehanda
miser = gnidare, knusslare
miserable = arg, dålig, ful, illa, ond, slätt, stygg, arm, behövande, fattig, ledsen, sorgsen
miserly = girig, njugg
miss = missa, sakna
mist = dimma, mist, tjocka, töcken
mistake = fel, förvillelse, misstag
Mister = herr
mistress = mästarinna
misty = dimmig, disig, töcknig
misunderstanding = missförstånd
mitten = handske
mix = blanda, sammanblanda
mixture = röra
moan = stöna
mock = håna
mockery = hån, spe
mode = maner, sätt, mod
model = modell, schema
modern = modern
modest = blygsam
Mohammedan = mohammedan
moist = fuktig
mold = mögel
mole = mullvad
molecule = molekyl
mom = mamma
moment = momang, moment, ögonblick
mommy = mamma
monarch = furste, monark, suverän
monastery = kloster
Monday = måndag
money = mynt, pengar
money-box = kassa
money box = kassa
Mongolia = Mongoliet
Mongolian = mongolisk
monk = munk, pater
monkey = apa
monopoly = monopol
monotonous = entonig
monster = monster, odjur, vidunder
month = månad
monument = minnesmärke, minnesvård, monument, vård
mood = mod, humor, humör
moon = måne
moor = stepp
moorage = redd
mooring = redd
moose = älg
moped = moped
more = mer, mera
Mormon = mormon
morning = morgon
morphia = morfin
morphine = morfin
mortgage = gravitation, hypotek, inteckning
Moscow = Moskva
Moslem = mohammedan
mosque = moské
moss = lav, mossa
most = mest
moth = nattfjäril
mother = moder, mor
mother-in-law = svärmor
motive = motiv
motor = motor
motor car = bil
motorcycle = motorcykel
motorist = bilist
motto = devis
mould = mögel
mount = montera
mountain = berg
mountain-ash berry = rönnbär
mountain chain = berg
mourning = likfärd
mouse = mus, råtta
mousetrap = råttfälla
moustache = mustasch
mouth = gap, käft, mun, mun
move = flytta, flyttning
movie theatre = biograf
mow = meja
Mr. = herre, herr
Mr. and Mrs. = herrskap
Mrs. = dam, fru
mucus = slem
mud = dy, mudder, gyttja, slam, sörja
mule = mula
multiply = multiplicera
multitude = mängd, hop
mummy = mumie
munition = ammunition
murder = mörda, dråp, mandråp, mord
murderer = dråpare, baneman, mördare
murk = dunkelhet, mörker
muscle = muskel, sena
muse = musa, sångmö
museum = museum
mushroom = svamp, champinjon, champignon
music = musik
musical = musikalisk
musician = musikant, musiker
Muslim = mohammedan
mussel = mussla
Mussulman = mohammedan
must = böra, må, måste
mustard = senap
mute = stum
mutton = fårkött
muzzle = gap, käft
my = min, mitt
mysterious = mysteriös
mystery = mysterium
mystic = mystisk
mystical = mystisk
myth = myt