#setName = words_en_fr_tt
#sideOneTitle = ENG
#sideTwoTitle = FRE
table = liste, tableau, table
table-cloth = nappe, nappe de table
tablet = liste, tableau
tabulation = liste, tableau
tackle = aborder, s'avancer
tact = mesure, tact
tactic = tactique
tactics = tactique
Tagus = Tage
tail = queue
tailor = couturière, tailleur
tails = habit
take = accepter, accueillir, admettre, agréer, recevoir, recueiller, occuper, prendre
take account of = faire attention à, prêter attention à
take action = agir, opérer
take along = assembler, rassembler
take an interest = s'intéresser
take away = prélever, ôter, retrancher
take care = avoir soin de, se soucier de, s'occuper, veiller à
take care of = se soucier de, s'occuper de
take down = abattre, démolir
take exception to = s'indigner de
take fire = s'allumer
take in = s'abonner, s'abonner à, accepter, accueillir, admettre, agréer, recevoir, recueiller, mystifier, rouler
take into account = faire attention à, prêter attention à, considérer
take leave = faire ses adieux, dire adieu
take leave from = faire ses adieux, dire adieu
taken aback = stupéfait
take note = constater
take off = enlever
take offence at = s'indigner de
take over = acheter, acquérir
take part = participer, prendre part
take refuge = se réfugier
take steps = se démener
take the place of = remplacer, tenir place de
taking = achat
taking over = achat
tale = récit, relation
talent = aptitude, don, talent
talisman = amulette
talk = parler
tall = haut
Talmud = Talmud
tame = dresser, apprivoisé, apprivoiser
tangerine = mandarine
Tangier = Tanger
tangle = imbroglio, chaos
tank = citerne, char, tank
Tantalus = Tantale
Tanzania = Tanzanie
Tanzanian = Tanzanien
tap = forer, rencontrer, toucher, taper, robinet
tape = bande, bandeau
tape-recorder = magnétophone
tapestry = tapisserie
tar = goudron
tard = perçant
target = but, dessein
tart = acerbe, acide, aigre, astringent, agaçant, tarte
Tartar = Tatare
tartness = aigreur, ton aigre
task = devoir, tâche
taskmaster = bailli
taste = goût, goûter
tasty = savoureux, succulent
Tatar = tatare
tattler = babillard, bavard
tax = imposer, impôt, taxe
tax form = feuille de déclaration
taxi = taxi
tea = thé
teach = instruire, apprendre, enseigner
teacher = institutrice, instituteur
team = équipe
teapot = théière
tea-pot = théière
tear = larme, pleur, déchirer
tear off = cueillir
tease = agacer, taquiner
teat = mamelle
technics = technique
technique = technique
teetotalism = abstension totale d'alcool, abstinence
teetotaller = personne qui ne boit jamais d'alcool
telegram = télégramme
telegraph = télégraphe
telephone = téléphoner, téléphone
telephone booth = cabine téléphonique
telephone kiosk = cabine téléphonique
television = télévision
tell = dire, charger, confier une tâche, commander, enjoindre, ordonner, sommer, conter, raconter
tell a lie = mentir
telltale = babillard, bavard
temper = durcir, tremper, humeur
temperate = sobre
temperature = température
tempest = tempête
template = modèle, patron
temple = tempe, temple
templet = modèle, patron
temporary = provisoire, temporaire
tempt = tenter
temptation = tentation
ten = dix
tenant = locataire
tendency = aptitude, disposition, tendance
tender = doux, gentil, suave, sucré, présenter, adjudication, adjudication, offrir, proposition, offre, proposition
tenderness = tendresse
tend to = soigner
tension = tension
tent = tente
tented camp = camp
term = terme
terminate = cesser, finir, terminer
terms = condition
terrace = terrasse
terrain = terrain
terrestrial = terrestre
terrible = affreux, terrible
territory = territoire
terror = effroi, terreur
test = examen, essayer, essai
testament = testament
testicle = testicule
testify = attester, démontrer, témoigner
testimony = témoignage
Teuton = Germain
Teutonic = germain, germanique
Texan = Texan
Texan woman = Texane
Texas = Texas
text = texte
textile = textile
th = -ième
Thai = siamois, taïs, taïlandais, Thaï, Thaïlandais
Thailand = Siam, Thaïlande
Thai woman = Thaïlandaise
Thames = Tamise
than = que
thank = remercier
thankful = reconnaissant
thankless = ingrat
thanks = remerciement, merci
thanks to = grâce à
thank you = merci
that = quoi, que, qu', que, qu', qui, si, aussi
that is = c'est-à-dire, soit
that kind of = autant, tel
that much = tant, autant
that one = celui
that one's = de celle-là, de cellui-là, dont
that's all right = cela ne fait rien
that's okay = cela ne fait rien
that way = ainsi, comme cela, de cette manière
thaw = dégeler, fondre
the = à l', à la, au, aux, lui, la, le, les, l'
theatre = théâtre
theatre play = pièce de théâtre
the day after tomorrow = après-demain
the day before yesterday = avant-hier
thee = à vous, à toi, t', toi, t', te, t', vous
thee and thou = tutoyer
The Hague = La Haye
their = leur
them = à eux, à eux, à elles, leur, les
theme = composition, sujet, thème
then = donc, après, ensuite, alors
the Netherlands = Pays-Bas
theocracy = théocratie
theory = théorie
there = voici, voilà, là, y
thereabout = alentour, autour
thereabouts = alentour, autour
thereafter = après, ensuite
there are = il y a
therefore = donc, aussi, c'est pourquoi
there is = il y a
thermometer = thermomètre
these = ceci
these days = actuellement
thesis = thèse
the Ukraine = Ukraine
the Vatican = Vatican
they = ils, elles, on
thick = dense, épais, gros
thicken = grossir
thigh = cuisse
thimble = dé à coudre
thin = mince, maigre
thing = produit, chose, objet
things = affaires, choses, trucs
think = être d'avis, penser que, penser, réfléchir
think about = réfléchir
think ahead = anticiper
think to oneself = méditer, songer
think well of = apprécier, estimer
third = tiers
thirst = soif
thirteen = treize
thirteenth = treizième
thirty = trente
this = ceci, celle-ci, celui-ci
this evening = ce soir
this here = ceci
thisle = chardon
this morning = ce matin
thorn = épine
thoroughgoing = radical
thou = vous, tu
though = quoique
thought = pensée
thoughtfulness = précaution, préparatif
thousand = mille
Thrace = Thrace
Thracia = Thrace
thread = fil
threat = menace
threaten = gronder, menacer
threatening = sinistre
three = trois
thresh = battre, passer à tabac, rosser
threshold = seuil
throat = gorge
through = complètement, entièrement, au moyen de, prêt, à cause de, de, à travers, par
throw = jeter, projeter
throw away = rejeter
throw-back = atavisme
throw off = précipiter
throw up = rejeter, rejeter de la nourriture, rendre, vomir
thrush = grive
thrust = pousser
thumb = pouce
thunder = retenir, tonner, tonnerre
Thursday = jeudi
thus = ensuite, comme, tellement, ainsi, comme cela, de cette manière
Tiber = Tibre
Tiberius = Tibère
Tibet = Tibet
Tibetan = Tibétain
tic douloureux = névralgie faciale
tick = tique
ticket = billet, ticket
ticket-window = guichet
tickle = chatouiller
tidbit = friandise
tide = marée
tidy = ordonner, ranger, régler
tie = lier, lier, cravate, attacher, nouer, relier, lien
tie on = lier, attacher, lier, lier, nouer
tie up = attacher, nouer, relier
tiger = tigre
tight = strict
tighten = serrer
tightness of the chest = oppression
Tigris = Tigre
tile = carreau
till = caisse, à, jusqu'à
tillage = agriculture, culture
tilt = incliner
timber = bois
time = fois, heure, durée, temps
time off = congé, loisirs, vacances
timid = timide, peureux
tin = fer-blanc, tôle, étain
tinkle = tinter
tin plate = fer-blanc, tôle
tint = nuance, teinte, teindre
tiny = miniscule
tip = bout, cime, pointe, sommet, pourboire
tipsy = gris, pompette
tired = fatigué, las
tiresome = ennuyeux
titanium = titane
title = intitulé, titre
titmouse = mésange
to = à, en, vers
.. to = ... à
toad = crapaud
toast = griller, rôtir
tobacco = tabac
today = aujourd'hui
toe = doigt du pied, orteil
together = ensemble
together with = d'ailleurs, en prime, et puis
Togo = Togo
Togoland = Togo
to her = à lui, lui
to him = à lui, lui
toilet = cabinet, WC, toilette
to it = à lui, lui
token = preuve, signal, signe, témoignage
Tokyo = Tokyo
tolerate = tolérer
tomato = tomate
tomb = tombe
to me = à moi, me, m', moi
tomorrow = demain
tomorrow evening = demain soir
tomorrow morning = demain matin
Tom Thumb = Petit Poucet
ton = tonne
tone = ton
tongs = pinces
tongue = langue
tonsil = amygdale
too = aussi, trop
tool = instrument, outil, produit, ustensile
too much = trop
tooth = dent
tooth-brush = brosse à dents
top = mutiler, comble, faîte, haut, sommet, summon
topic = actualité, composition, sujet, thème
topical = actuel
topicality = actualité
torch = torche
torment = tourmenter, torture
torpedo = torpiller
torrent = flot, torrent
tortoise = tortue
torture = torture
to some extent = une certaine quantité
total = total
total abstainer = personne qui ne boit jamais d'alcool
total abstinence = abstension totale d'alcool, abstinence
to tell the truth = à proprement parler
to the = à l', à la, au, aux, lui
to thee = t', te, à toi, à vous, vous
to them = à elles, à eux, les, leur
touch = toucher
touching = attendrissant
touch lightly = effleurer
tourism = tourisme
tourist agency = agence de voyage
to us = à nous, nous
tousle = hérisser, ébouriffer
tow = traîner
toward = à, en, vers, en relation avec, vis-à-vis
towards = à, en, vers, en relation avec, vis-à-vis, autour de, parages
towel = serviette
tower = tour
town = localité, cité, ville
town-hall = hôtel de ville
town hall = hôtel de ville
township = hameau
to you = te, t', à toi, à vous
trace = empreinte, impression, trace
track = piste, empreinte, impression, trace, route, voie
tractability = docilité, obéissance, souplesse
tractable = conciliant
tractor = tracteur
trade = commerce, métier
trade-union = syndicat
tradition = tradition
traffic = circulation, trafic
tragedy = tragédie
tragic = tragique
trailer = baladeuse, remorque
train = clique, cortège, escorte, suite, dresser, entraîner, rame, train
trait = trait
trajectory = trajectoire
tram = tramway
trample on = fouler aux pieds, marcher sur, piétiner
tranquil = calme, paisible, tranquille
transfer = passer, dépasser, remuer
transform = résoudre, transformer
transformation = métamorphose, transformation, transformation, transformation, transformation
transgress = commetre yne faute, pécher
transgression = péché
transitive = transitif
translate = traduire
transmit = adresser, envoyer
transparant = limpide
transport = reporter, transporter
Transylvania = Transylvanie
trap = piège
travel = aller, aller en véhicule, se déplacer, voyager
travel agency = agence de voyage
traveller = voyageur
tray = plateau
treacherous = traître
tread = faire les cent pas, fouler aux pieds, marcher sur, piétiner
treasure = cassette, trésor
treat = guérir, soigner, régaler, traiter
tree = arbre
tremble = trembler
tressle = établi
Treves = Trèves
trial = désolation, jugement
triangle = triangle
triangular = triangulaire
tribe = tribu
tribunal = tribunal
tribute = tribut
trick = artifice, mystifier
trickery = artifice
trifle = babiole, bagatelle
trifling = mineur
trim = garnir
trip = voyage
trite = banal
triumph = triomphe
Trojan = Troyen
trollop = roulure
trombone = trombone
troop = troupe
tropical = tropical
trot = trotter
trouble = problème, déranger, gêner
trough = auge
troupe = troupe
trousers = pantalon
trout = truite
Troy = Troie
truce = trêve
truck = camion, poids lourd
truculent = bagarreur, batailleur
true = qui a raison, réel, véritable, vrai
truly = en réalité, réellement, en fait, en vérité, vraiment
trump = atout
trumpet = trompette
truncate = mutiler
trunk = coffre, malle, trompe, torse, tronc
trust = se fier, foi, confier, se fier à
trustworthy = sûr
try = peiner, essayer
tub = baquet, bassine, cuve
tube = chambre à air, tube, tuyau
Tuesday = mardi
tug = tirer
tummy = ventre
tumult = bagarre, barouf, baroufle
tuna = thon
tuna-fish = thon
tune = adapter, accorder, mélodie
tungsten = tungstène
Tunis = Tunis
Tunisia = Tunesie
tunnel = tunnel
tunny = thon
tup = bélier
Turin = Turin
Turk = Turc
turkey = dindon
Turkish lady = Turque
Turkish woman = Turque
Turkmenistan = Turkménistan
turn = dévier, renverser, tourner, retourner, serrer, file, rang, rangée, tour
turn around = tourner, retourner
turn away = détourner
turnip = navet
turn on = activer, serrer, allumer, tourner
turnover = opération de caisse
turn over = renverser
turn round = tourner, retourner
turtle-dove = tourterelle
tussle = se bagarrer, se battre
TV = télévision
twelfth = douzième
Twelfth-night = Epiphanie
twelve = douze
twentieth = vingtième
twenty = vingt
twig = rameau
twilight = crépuscule
twin = jumeau
twine = natter, tisser, tresser
twins = jumeaux
twist = tordre
twitter = gazouiller, pépier
two = deux
two hundred = deux cents
type = dactylographier, taper, modèle, type
typeset = composer
typewriter = machine à écrire
typhus = typhus
typical = représentatif
typist = dactylographe
tyrant = tyran
Tyrrhenian Sea = mer Tyrrhénienne