#setName = words_en_fr_ii
#sideOneTitle = ENG
#sideTwoTitle = FRE
Iberian = ibère, ibérien, ibérique
ible = -able
ice = crème glacée, glace
icecream = crème glacée, glace
Iceland = Islande
Icelander = Islandais
Icelandic = d'Islande, islandais
idea = idée
ideal = idéal
identical = identique
identify = identifier, situer
idiot = idiot
idiotic = stupide
if = à condition que, si
ignore = bouder, ignorer, méconnaître
Iliad = Iliade
ill = malade, malsain
ill fate = fatalité
illiterate = analphabète, illettré
illness = infirmité, maladie
illuminate = illuminer
illusion = illusion
illustrate = illustrer
image = image, figure
imagine = imaginer
imitate = copier, imiter
immaterial = indifférent
immediate = immédiat
immediately = directement, tout d'abord, aussitôt, d'abord, immédiatement, sitôt, tout de suite
immense = énorme, formidable, immense
immerse = immerger, tremper
imp = lutin
impartial = neutre
impel = inciter, pousser à, amener à, faire avancer, pourchasser, poursuivre, pousser
impenetrable = imperméable
imperialism = impérialisme
impertinent = hardi
impetus = transport, impulsion, incitation
implicate = empêtrer, entortiller
imply = impliquer, signifier
import = importer
important = considérable, grave, important, majeur
impose = contraindre, imposer, obliger
impose upon = imposer
imposing = imposant
impossible = impossible
imposter = charlatan
impress = en imposer à
impressible = sensible
impression = effet, impression
imprint = impression
improve = améliorer, amender, réformer
impulse = impulsion, incitation
in = à, au milie de, en, dans, parmi
in accordance with = conforme à, en accord avec, conformément
in action = actif
in addition = en prime, en outre, d'ailleurs, en outre
in a hurry = à la hâte
inaugurate = inaugurer
inauguration = inauguration
in a way = comme, presque
inborn = inné, naturel
inbred = inné, naturel
incendiary bomb = bombe à incendie
inception = début
incest = inceste
incidental = auxiliaire
incite = agiter, débattre, émouvoir, troubler, agacer, irriter, provoquer, inciter
incitement = incitation
incline = incliner
inclined = enclin
include = contenir, renfermer
income = produit, recette, rente, revenu
inconceivable = abracadabrant
inconvenient = difficile, dur, penible
increase = agrander, amplifier, étendre, accroître, grossir, s'accoître, augmenter, redoubler, accroissement
increasingly = de plus en plus, toujours plus
incredible = invraisemblable
incubate = couver
incus = enclume
indeed = d'abord, certes, si, en réalité, réellement, en fait, en vérité, vraiment
independant = indépendant
in detail = abondamment
index = liste, tableau
India = Inde
Indian = Indienne, Indien
Indian corn = maïs
Indian woman = Indienne
indicate = indiquer, montrer, désigner, marquer
indication = augure, indication
indictment = accusation, plainte
indifferent = indifférent
indigenous = autochtone
indigestion = dyspepsie
indispensable = indispensable
indistinct = confu, touffu, trouble
individual = individu
Indo-China = Indochine
Indonesia = Indonésie
Indonesian = Indonésien
Indonesian woman = Indonésienne
induce = conclure
inducement = lieu, occasion
indulge = être indulgent
industrial = industriel
industrialist = industriel
industrious = appliqué, assidu, laborieux
industry = application, industrie
in easy circumstances = aisé
inebriety = ivresse
inert = inerte
in every way = de toute manière
in exchange for = contre, en face de
in fact = en réalité
infant = enfant
infantry = infanterie
infect = infecter
infected = septique
infer = conclure
infirm = infirme
inflammatory = séditieux
inflate = hausser
inflated = afecté
influence = influer, empire, influence
influenza = grippe
inform = informer, renseigner, apprendre à, faire part de
information = faire-part, renseignement
in front of = avant, devant
in good condition = intact
inhabitant = habitant
inhale = inspirer
inherit = hériter
inheritance = héritage
initial deposit = acompte, premier acompte, versement initial
initiate = prendre l'initiative
inject = injecter
injure = abîmer, détériorer
injury = blessure
ink = encre
in-law = par alliance
inlet = fiord
inn = auberge
innate = inné, naturel
inner = intérieur, interne
inner tube = chambre à air
innkeeper = aubergiste
innocent = innocent
in no way = en aucune façon, en aucune manière
in question = concerné
inquiry = enquête
inquisitive = curieux
insane = aberrant, agité, fou
insanity = aberration, affolement, aliénation
insect = insecte
insert = mettre, fourrer, introduire
in short supply = insuffisant
inside = à, au milie de, en, dans, parmi, intérieur, interne, milieu, dedans
insignia = insigne
insignificant = mineur
insist = insister, presser
insistence = impulsion, vive sollicitation, instance, instances
inspect = inspecter
inspector = inspecteur
inspiration = souffle
inspire = dicter, inspirer
in spite of = malgré, en dépit de
install = construire, installer, poser
installment payment = acompte
instalment = acompte, premier acompte, versement initial
instant = instant, moment
instantly = aussitôt, directement, d'abord, tout d'abord
instead of = au lieu de
instigate = inciter, pousser à
instinct = instinct
institute = institut
institution = fondation
instruction = instruction, enseignement
instructor = instituteur
insubordinate = désobéissant, rebelle
insulate = isoler
insult = insulter, affront, injure, offenser
insurance = assurance
insure = assurer
insurer = assureur
integer = entier
intellectual = intellectuel
intelligence = intelligence
intelligent = intelligent
intend = avoir pour but, viser
intense = intense
intensive = intense
intention = dessein, intention, propos
intercessor = défenseur, avocat, avocat conseil
interchange = échanger
interest = intéresser, intérêt
interesting = curieux, intéressant, singulier
interface = interface
interfere with = brouiller, déranger, perturber, rendre confus, rendre trouble
interjection = interjection
interment = enterrement, obsèques
intermission = pause, repos, trêve
internal = intérieur, interne
international = international
interpret = interpréter
interpreter = interprète
interpunction = ponctuation
interrogate = interroger
interrupt = interrompre
interruption = interruption, rupture
interval = intervalle
intervene = intervenir
interview = entrevue, interview
intestine = intestin
in the beginning = d'abord
in the evening = le soir
in the meantime = dans l'intervalle
in the middle of = au milieu de, parmi
in the morning = le matin
in the presence of = devant, en présence de
intimate = intime
in time = à temps
into = à, au milie de, en, dans, parmi
intone = entonner
intoxicated = ivre
intrepid = audacieux
intrigue = intriguer
introduce = offrir, présenter
introduction = introduction
in turn = successivement
invade = envahir
in vain = en vain
invasion = invasion
invent = inventer
invention = invention, invention
inventory = recensement
inverted comma = guillemet
invest = investir, placer d'argent
investigate = examiner, explorer, fouiller, rechercher, reconnaître
investigation = examen, enquête, recherche, reconnaissance
invitation = invitation
invite = inviter
invite tenders for = mettre à l'entreprise, mettre en adjudication
invoice = facture
invoke = invoquer
in what way = comment, de quelle manière
iodine = iode
Iran = Iran, Perse
Iranian = Iranien
Iranian woman = Iranienne
Iraq = Irak
Iraqi = Irakien
Iraquian = Irakien
Ireland = Irlande
iris = iris
Irish = irlandais
Irishman = Irlandais
Irish Sea = mer d'Irlande
Iriswoman = Irlandaise
iron = fer, repasser], fer à repasser
iron clothes = repasser]
irony = ironie
irrigate = abreuver, arroser
ish = -al
Islam = islam
island = île
isn't it = hein, n'est-ce pas
isn't that so = hein, n'est-ce pas
isolate = isoler
isolation = abandon
Israel = Israël
issue = éditer, proclamer
ist = -iste
it = à lui, elle, il, lui, la, le, l'
Italian = Italien
Italian woman = Italienne
Italy = Italie
itch = démanger
it doesn't matter = cela ne fait rien
its = leur, sa, son
itself = même
ity = -té
ivory = ivoire
Ivory Coast = Côte d'Ivoire
ivy = lierre