#setName = longlist_en_pl
#sideOneTitle = ENG
#sideTwoTitle = POL
a = w, ktoś, po
abandon = opuściæ
abashed = zażenowany
abbreviate = skróciæ
aberration = błąd, pomyłka
abide = czekaæ, przebywaæ, cierpieæ, doczekaæ siê
abiding = trwały
abjure = odebraæ
able = zdolny
abode = mieszkanie
abortive = daremny
about = odnośnie, o, wokół, dookoła, około
above = na górze, u góry, do góry, w górê
above all = zwłaszcza, szczególnie
above-board = uczciwy, szczery
abrasive = ostry
abridge = skróciæ
abroad = za granicą
absence = brak
absent = nieobecny
absent onself = usunąæ
absolute = absolutny, bezwzglêdny
absolutely = rzeczywiście, koniecznie
absorb = dysponowaæ
abstract = powstrzymywaæ, zabraæ
abstruse = tajemniczy
abuse = obrażaæ, zamêczaæ
abysmal = okropny, straszny
academic = student
academy = uczelnia, szkoła wyższa
accede = zgadzaæ siê
accept = przyjmowaæ
accidence = przypadek
accident = wypadek
accidental = dodatkowy
accommodation = urządzenie, impreza, mieszkanie
accomodate = koñczyæ, pomagaæ
accompany = towarzyszyæ, odprowadzaæ
accomplish = osiągaæ, uzyskaæ, urzeczywistniaæ, zrealizowaæ, wykonaæ, spełniæ
accomplished = doświadczony
accomplishment = wykonanie, spełnienie
accord = pozwalaæ
according as = według
accordingly = wiêc, przeto, to, przeto, wiêc, zatem
according to = według
accordion = harmonijka
account = konto, wierzyæ, mniemaæ, śadzieæ
account for = wyjaśniaæ
accredit = wierzyæ
accrue = rosnąæ, róśæ, zwiêkszyæ siê
accumulation = masa
accurate = akuratny, punktualny, dokładny, precyzyjny
accustom = mieæ zwyczaj, byæ w zwyczaju
acerbic = ostry
ache = boleæ, dolegaæ, ból
achievable = realizowalny
achieve = osiągaæ, uzyskaæ, urzeczywistniaæ, zrealizowaæ, robiæ, czyniæ, wykonaæ, spełniæ
achievement = sukces, powodzenie
acid = ostry
acknowledge = wyznawaæ, przyznawaæ siê
acknowledgement = wyznanie, przyznanie siê
acquaint = informowaæ, zawiadomiæ
acquaintance = znajomy
acquire = kupiæ
acquirement = osiągniêcie
acquisition = kupno, zakup
acquittal = wykonanie, spełnienie
acrid = ostry
acrimonious = ostry
across = po drugiej stronie, poprzez
across from = przeciw, naprzeciw, w zamian
act = robiæ, czyniæ, wpływaæ, przedstawiaæ
activate = powodowaæ, sprawiaæ
active = pracowity
activity = zajêcie
actor = aktor
act out = urzeczywistniaæ, zrealizowaæ
actual = realny, rzeczywisty
actually = rzeczywiście, faktycznie
actuate = ruszaæ
acute = ostry
ad = ogłoszenie
adage = przysłowie
Adam = Adam
add = dodawaæ
addition = dodawanie
additional = dodatkowy
addled = głupi
address = adres
add up = dodawaæ
adept = doświadczony
adieu = żegnaj
adjourn = odkładaæ, przesuwaæ
adjustment = urządzenie, impreza
administration = rząd
admiration = podziw
admire = podziwiaæ
admission = wyznanie, przyznanie siê
admit = dopuściæ, wyznawaæ, przyznawaæ siê, pozwalaæ
adorn = ozdabiaæ
advantage = zaleta, korzyśæ
adversary = przeciwnik, nieprzyjaciel
adverse = przeciwny
advert = uważaæ, zwracaæ uwagê
advertisement = ogłoszenie
aerodrome = lotnisko
aeroplane = samolot
a few = jacyś, kilka, kilkoro
affable = uprzejmy
affair = sprawa, afera
affect = wpływaæ
affection = miłośæ
affix = umocowaæ, ustaliæ
affluent = bogaty
afford = pozwalaæ
afoot = piechotą
afresh = znowu, ponownie, od nowa
after = potem, za
afternoon = popołudnie
afterwards = potem
again = znowu, ponownie, od nowa
against = przeciw, naprzeciw, w zamian
age = wiek
agent = narzêdzie, instrument, przyrząd
agitate = potrząsaæ
agitated = zdenerwowany
agog = zaciekawiony
agonize = zamêczaæ
agree = uzgodniæ, zgadzaæ siê
agreeable = miły, przyjemny
agreement = zgoda
ague = gorączka
ahead = przedtem, na przodzie
aid = pomagaæ, pomoc
ailment = choroba
aim = cel, staraæ siê
aimless = bezcelowy
air = powietrze
aircraft = samolot
airdrome = lotnisko
airfield = lotnisko
airplane = samolot
airport = lotnisko
ajar = otwarty
alacrity = entuzjazm
alas = niestety
album = album
ale = piwo
Algeria = Algieria
Algiers = Algier
alien = przeciwny
a little = trochê, ileś, troszeczkê
all = wszelki, wszelaki, wszystko, każda ilośæ, wszyscy
all about = wszêdzie
all of it = każda ilośæ
all over again = znowu, ponownie, od nowa
allow = zostawiæ, puściæ, pozwalaæ
all the = każdy
all the more = tym bardziej
all the time = tymczasem
almond = migdał
almost = prawie, niemal
alone = sam
a long time = długo
a lot = dużo
alphabet = alfabet, abecadło
already = już
also = także, też, również
altar = ołtarz
although = choæ
altitude = wysokośæ
altogether = wszystko
always = zawsze
amaze = zadziwiaæ
American = Amerykanin
among = miêdzy
amount = suma, ilośæ
amphitheatre = amfiteatr
amusing = zabawny
and = i, a, oraz, zaś
anew = znowu, ponownie, od nowa
angel = anioł
anger = pasja
angina = angina
angle = róg, kąt
angry = rozgniewany
animal = zwierzak, zwierzê
anniversary = rocznica
annotation = nuta, nota
another = inny
answer = odpowiadaæ, odpowiedź
anthem = pieśñ
antibiotic = antybiotyk
antidote = odtrutka
Antony = Antoni
any = ktoś, jacyś, kilka, kilkoro
anybody = ktoś
anything = coś
anyway = jakoś
anywhere = gdzieś
apart = osobno, oddzielnie, szczególnie
apart from = oprócz
apparently = oczywiście, pozornie
appear = pojawiaæ siê, wyglądaæ, mieæ wygląd, zdawaæ siê
appear to be = zdawaæ siê
appellation = nazwa, nazwisko, imiê
apple = jabłko
apple-tree = jabłoñ
appraise = oceniaæ
appreciate = lubiæ, ceniæ
approach = zbliżyæ siê
April = kwiecieñ
aptitude = talent
architect = architekt
architecture = architektura
archive = archiwum
archives = archiwum
argue = spieraæ siê
arise = urodziæ siê
arm = zbroiæ, uzbrajaæ, ramiê
army = armja, wojsko
around = wokół, dookoła, około
arrange = urządzaæ, organizowaæ, porządkowaæ
arrangement = urządzenie, impreza
arrival = przyjazd, wjazd
arrive = przyjechaæ, przyjśæ
art = sztuka
article = artykuł, przedmiot, obiekt
article of clothing = ubranie
artist = artysta
as = gdy, kiedy, jak, według, w ten sposób, ponieważ, bo
as a matter of fact = faktycznie
ascend = iśæ w górê
ascertain = stwierdzaæ, konstatowaæ
as for the rest = zresztą
ashtray = popielniczka
Asian = Azjata
as if = niby, jakby
ask = pytaæ, prosiæ
ask for = prosiæ
ask forgiveness = przepraszaæ
assemblage = zebranie, konwent
assigned job = praca
assist = pomagaæ
as though = niby, jakby
at = ku, do, obok, po
at all = zupełnie
at first = początkowo
at last = w koñcu, koniec koñców
at least = przynajmniej
at long last = koniec koñców
atmosphere = nastrój
at most = najbardziej
at once = zaraz, natychmiast
at present = teraz, obecnie
at some time = kiedyś
attach = umocowaæ, ustaliæ
attain = osiągaæ, uzyskaæ
attempt = staraæ siê, kłopot, staranie, zabiegi, próbowaæ
attend = pielêgnowaæ, byæ obecni
attentively = uważnie
at that place = tam
at the outset = początkowo
at the rate of = po
at the same time = jednocześnie
attract = przyciągnąæ
August = sierpieñ
aunt = ciocia
authentic = autentyczny
author = autor, pisarz
autobus = autobus
automobile = auto, samochód
autumn = jesieñ
average = środek
avoid = unikaæ
await = czekaæ, doczekaæ siê
away = precz
awfully = okropnie, strasznie
azalea = azalia
bachelor = kawaler
bad = zły
bad job = przykrośæ, nieuprzejmośæ
badly = źle
bag = worek, torba
bairn = dziecko
baker = piekarz
balcony = balkon
ball = bal
ballet = balet
ballpoint pen = długopis
banana = banan
bank = brzeg
banquet = bankiet, uczta, przyjêcie, biesiada
bar = przeszkoda
barber = fryzjer
barely = zaledwie
barracks = koszary
barrel = beczka
barrier = przeszkoda
bathe = kąpaæ
bathroom = łazienka
bazaar = dom handlowy
be = byæ
be able to = móc
be absent = byæ nieobecnym
be acquainted with = znaæ
be afraid of = baæ siê
be ailing = chorowaæ
be alive = żyæ
beam = promieñ, radio
be angry = gniewaæ siê
bear = cierpieæ
be ashamed = wstydziæ siê
be asleep = spaæ
beast = zwierzê
beat = biæ
beautiful = piêkny, ładny
beautiful woman = ślicznotka
beauty = piêknośæ, ślicznotka
be aware of = mieæ świadomośæ
be bold = ośmieliæ siê
be bored = nudziæ siê
be born = urodziæ siê
because = ponieważ, bo
be closed = zamykaæ siê
become = stawaæ siê, zostaæ
become accustomed = przyzwyczaiæ siê
be conscious of = mieæ świadomośæ
bed = łóżko
beef = wołowina
beefsteak = befsztyk
beer = piwo
beet = burak
before = przed
be found = znajdowaæ siê
beg = prosiæ
begin = zaczynaæ
beginner = początkujący
beginning = początek
be glad = cieszyæ siê, radowaæ siê
behave = zachowywaæ siê
behind = potem, za
behold = oto
be interested = interesowaæ siê
be in the habit of = mieæ zwyczaj, byæ w zwyczaju
be lacking = brakowaæ
be late = spóźniaæ siê
believe = wierzyæ
be located = znajdowaæ siê
beloved = kochany
below = pod spodem, na spodzie
be married = wyjśæ za mąż, ożeniæ siê
be missing = byæ nieobecnym, brakowaæ
beneath = pod
benefit = zaleta, korzyśæ
be painful = boleæ, dolegaæ
be present = byæ obecni
be right = mieæ słusznośæ
Berlin = Berlin, Barlin
beseech = błagaæ
beside = obok
besides = zresztą, oprócz, oprócz tego, dalej
best = najlepszy
be succesful = prosperowaæ, powodziæ siê
be suitable = byæ zdatnym
be taken ill = zachorowaæ
be thirsty = byæ spragnionym
be tired of something = nudziæ siê
better = lepszy
between = miêdzy
beverage = napój
be willing to = chcieæ
be worth = byæ wartym
be worthy of = byæ wartym
beyond = po drugiej stronie, poprzez
bicycle = rower
bid = prosiæ
bide = doczekaæ siê
big = duży
bike = rower
bill = bilet
bind = wiązaæ, łączyæ
binocular = lorneta
binoculars = lorneta
birch = brzoza
bird = ptak
birthday = urodziny
bishop = biskup
black = czarny
blame = przewinienie
blank = biały, formularz
bleak = smutny, zimny
blind = ślepy
block = blok
bloom = kwiat
blouse = bluzka
blueberry = borówka
blunt = tepy
blushing = czerwony
board of directors = zarząd
boat = łodź
body = ciało
bold = gruby
bomb = bomba
bonbon = cukierek
bon-bon = cukierek
bone = kośæ
book = książka, zamawiaæ
bookcase = szafa na książki
book-keeper = buhalter
bookshop = ksiêgarnia
bookstore = ksiêgarnia
border = brzeg
borrow = pożyczaæ
boss = szef, zwierzchnik, szefo
both = oba, obaj, oboje, obie
bother = krêpowaæ, przeszkadzaæ
bottle = butelka
bouquet = bukiet
boutique = sklep
bovine = byk, wół
bovine animal = byk, wół
box = słabo, pudełko, pojemnik, naczynie
boy = chłopiec
brave = dzielny, odważny, śmiały
bread = chleb
break = łamaæ, rwaæ
breakfast = śniadanie
bribe = przekupiæ
bridge = most
brief = krótki
bright = jasny
bring = przynieśæ
British = brytyjski
broad = szeroki
brother = brat
brown = brązowy, brunatny
brutal = nieuprzejmy
Budapest = Budapeszt
build = budowaæ
building = budowla, budynek
Bulgar = Bułgar
Bulgaria = Bułgaria
Bulgarian = Bułgar
bureau = biuro, urząd
burgomaster = sołtys
burn = paliæ siê, spalaæ
burn down = spaliæ
bus = autobus
bush = krzak
business = sprawa, afera, handel
business deal = sprawa, afera
busy = zajêty
but = ale, lecz, jednak
butcher = rzeźnik
butter = masło
button = guzik
buy = kupiæ, kupno, zakup
by = obok, przez, do, według, za pomocą
by accident = przypadkiem
by chance = przypadkiem, z okazji
bye = żegnaj, do widzenia
by fours = we czworo
by means of = za pomocą
by no means = w żaden sposób
by now = już
by twos = we dwoje
cabin = chata
cabinet = szafa
café = kawiarnia
cake = ciasto
calculate = liczyæ
call = nazwaæ, wynmieniæ, wołaæ
calm = spokój, spokojny
calm down = uspokoiæ siê
camp of tents = obozowisko
Canada = Kanada
candlestick = lichtarz
capable = zdolny
capital = stolica
capital city = stolica
capture = łapaæ, chwytaæ
car = auto, samochód
cardiac = serdeczny
care = troszczyæ siê, dbaæ
care for = leczyæ
carefully = troskliwie, starannie
carnation = goździk
carriage = wagon
carry = nieśæ, nosiæ
case = sprawa, afera
castle = zamek
cat = kot
catarrh = katar
catch = łapaæ, chwytaæ, trafiæ
cathedral = katedra
cause = czyniæ czymś, skłaniaæ do czegoś, powodowaæ, sprawiaæ
cease = przestaæ
celebrate = świêtowaæ, obchodziæ
centennial = wiek, stulecie
centre = środek, centrum
century = wiek, stulecie
ceremony = uroczystośæ
certain = pewny, przeświadczony
certainly = przecież, wszak
certainty = pewnośæ
chair = krzesło
chairman = prezes, przewodniczący
chalice = kieliszek
chamber = pokój
chance = okazja, przypadek, zdarzenie, szansa
change = zmieniaæ, zmieniaæ siê
chap = osobnik
character = natura
characterize = charakteryzowaæ
charming = uroczy
chase = prześladowaæ, goniæ, polowaæ
chat = gawêdziæ
chatter = gawêdziæ
cheap = tani
cheaply = tanio
cheat = łotr
check = czek
cheerful = wesoły
cheese = ser
cheque = czek
cherry = wiśnia, owoc wiśni
cherry-tree = wiśnia, drzewo wiśniowe
chest = słabo
chief = szef, zwierzchnik, główny, szefo
chiefly = zwłaszcza, szczególnie, głównie
child = dziecko
chilli = papryka
chilly = zimny
Chinaman = Chiñczyk
Chinese = Chiñczyk
chocolate = czekolada
choose = wybraæ, wybieraæ
Christ = Chrystus
Christian = chrześcijanin
Christmas = Boże Narodzenie
chunk = bryła
church = kościół
church-building = kościół
cigarette = papieros
cinema = kino, sztuka filmowa
circle = towarzystwo
city = miasto
civilization = cywilizacja
civilize = cywilizowaæ
civilized = cywilizowany
clarify = wyjaśniaæ
class = kurs
clean = czysty, czyściæ
cleanse = czyściæ
clear = jasny
clearly = jasno, wyraźnie
climb = iśæ w górê
clip = strzyc
cloak = płaszcz
clock = zegar
clod = bryła
close = zamykaæ, zamykaæ siê, bliski, blisko
closed = zamkniêty
closet = szafa
cloth = materiał
clothe = ubieraæ
cloud = chmura
club = klub, towarzystwo
club member = klubowicz
coach = wagon
coal = wêgiel
coast = wybrzeże
coat = płaszcz
cocktail = koktajl
coffee = kawa
coffee-house = kawiarnia
coin = moneta
cold = zimny, zimno
colonel = pułkownik
colony = osada, kolonia
colour = kolorowaæ, farbowaæ, kolor
comb = czesaæ, grzebieñ
combat = zwalczaæ
come = pójśæ, przychodziæ
come about = stawaæ siê, zdarzyæ siê, wydarzyæ siê
come across = spotykaæ
come back = powróciæ
come close = zbliżyæ siê
come closer = zbliżyæ siê
come on = zbliżyæ siê
come to a halt = zatrzymaæ siê
come true = realizowaæ siê
comma = przecinek
command = rozkazywaæ
commence = zaczynaæ
commencement = początek
commend = chwaliæ, poleciæ
commendable = chwalebny
commerce = handel
commodity = towar
common = wspólny, zwykły
communicate = powiadamiaæ, komunikowaæ
compare = porównywaæ
comparison = porównanie
compel = zmusiæ
complain = skarżyæ siê
complete = uzupełniaæ, pełen, pełny
completely = w pełni
complex = kompleks
compose = komponowaæ, tworzyæ dzieło, pisaæ
composer = kompozytor
composition = kompozycja
comprise = zawieraæ
computer = komputer
conceal = ukrywaæ, chowaæ
concern = dotyczyæ
concerning = odnośnie, o
concert = koncert
concert-room = sala koncertowa
concrete = konkretny
condition = warunek, stan
conduct = kierowaæ, prowadziæ, prowadziæ
conduct oneself = zachowywaæ siê
conference = konferencja
confess = wyznawaæ, przyznawaæ siê
confession = wyznanie, przyznanie siê
confidence = naiwnośæ
confront = przeciwstawiaæ siê
congenital = od urodzenia
Congo = rzeka Kongo
congratulate = gratulowaæ
connect = związaæ, wiązaæ, łączyæ
consent = zgadzaæ siê, zgoda
consequently = przeto, wiêc, zatem
consider = patrzeæ
consist = składaæ siê, polegaæ
construct = budowaæ
contact = kontakt
contain = zawieraæ
container = pojemnik, naczynie
contend with = zwalczaæ
contented = zadowolony
contents = zawartośæ, treśæ
continue = trwaæ
contrary = przeciwny
control = uruchamiaæ, panowaæ, rządziæ
conversation = rozmowa
converse = rozmawiaæ
convey = przekazaæ
cook = gotowaæ
cooperate = współpracowaæ
co-operate = współpracowaæ
copper = miedź
cord = sznur
cordial = serdeczny
corner = róg, kąt
corpulent = gruby
correct = poprawiaæ, właściwy
correspond = korespondowaæ
cost = kosztowaæ
costly = drogi, kosztowny
cottage = domek, chatka
cough = kaszleæ, kaszel
count = liczyæ
count in = dodawaæ
country = kraj
couple = małżonkowie, małżeñstwo
courage = odwaga
courageous = odważny, śmiały
course = kurs
courtesy = grzecznośæ
cow = krowa
Cracow = Kraków
cream = krem
create = tworzyæ, tworzyæ dzieło, pisaæ
crime = zbrodnia
Croat = Chorwat
crockery set = serwis, zastawa
crook = łotr
cross = rozgniewany, przejśæ
crowd = masa, tłum
cruel = okrulny
cry = płakaæ
cuff = mankiet
culture = kultura
cupboard = szafa
cure = leczyæ
curious = zaciekawiony
curl = fryzowaæ, układaæ włosy
current = obecny, współczesny
cushion = poduszka
custom = zwyczaj
cut = strzyc, ciąæ
cycle = rower
Czech = Czech
dad = tatuś
daddy = tatuś
daily = codziennie
daily paper = dziennik
daisy = stokrotka
damage = szkoda
dance = bal, tañczyæ, taniec
Dane = Duñczyk
danger = niebezpieczeñstwo
dangerous = niebezpieczny
dare = ośmieliæ siê
data = materiał
date = data
day = dzieñ
daydream = marzyæ, marzenie
dear = szanowany, szanowny, drogi, kosztowny
December = grudzieñ
decide = decydowaæ, postanowiæ
decision = decyzja
declaration of policy = program
decorate = ozdabiaæ
dedicate = dedykowaæ, poświêcaæ
deem = wierzyæ, mniemaæ, śadzieæ, patrzeæ
deer = jeleñ
defend = broniæ
defiantly = wbrew, na przekór
definitely = koniecznie
degree = stopieñ, tytuł
delay = spóźnienie, odkładaæ, przesuwaæ
delicacy = smakołyk
delight = oczarowaæ
demand = żądaæ, postulowaæ
dentist = dentysta
depart = usunąæ
depend = zależeæ
deprive = pozbawiæ
deprive ... of = pozbawiæ
descend = zejśæ
describe = opisaæ
descry = zobaczyæ, ujrzeæ
desert = opuściæ
deserving = godny
design = plan
desire = pragnąæ, życzyæ, życzenie, pragnienie
despite = pomimo, wbrew, na przekór
destine = przeznaczyæ
destroy = niszczyæ
destruction = zniszczenie
detail = szczegół, detal
determine = ustalaæ, determinowaæ, umocowaæ, ustaliæ
devote = dedykowaæ, poświêcaæ
diagram = plan
dial = płyta, dysk
dictionary = słownik
die = umieraæ
difference = różnica
different = odmienny, inny, różny
differently = inaczej, gdzie indziej
difficult = trudny
diligent = pilny
diminutive = mały
dining-room = jadalnia
dinner = obiad
direct = kierowaæ, prowadziæ
directly = wprost, prosto
director = dyrektor
disadvantage = wada
disappear = znikaæ
disarm = rozbroiæ
disc = płyta, dysk
discrete = dyskretny
discuss = dyskutowaæ, omówiæ
discussion = dyskusja
disease = choroba
dislike = nie lubieæ, pogardzaæ
dismal = smutny
dispose of = sprzedawaæ
disposition = dyspozycja, talent
dispute = spieraæ siê
dissolve = rozpuszczaæ, rozwiązywaæ
district = dzielnica
disturb = krêpowaæ, przeszkadzaæ
diverse = różny, rozmaity
divide = dzieliæ
do = robiæ, czyniæ, fryzowaæ, układaæ włosy
doctor = doktor, lekarz
dog = pies
don't mention it = nie ma za co
door = drzwi
dot = punkt, kropka
double = podwójny
doubt = wątpiæ
draw out = wydobyæ
dreadful = okropny, straszny
dream = marzyæ, marzenie, śniæ, sen
dreary = smutny
dress = suknia, ubieraæ
drink = piæ alkohol, napój, piæ
drink to excess = piæ alkohol
drive away = wyjechaæ
drive off = wyjechaæ
drive out = wydobyæ
droop = wisieæ
dry = suchy, suszyæ
dual = podwójny
during = podczas, gdy
dust = kurz, odkurzaæ
Dutchman = Holender
duty = obowiązek
dwell = mieszkaæ
dwelling = mieszkanie
dye = kolor
each = po, każdy
ear = ucho
early = wczesny, wcześnie
early in the morning = wcześnie rano
earmark = przeznaczyæ
earn = zarabiaæ
earnest = poważny
earth = ziemia
easily = łatwo
east = wschód
easy = łatwy
eat = jeśæ
eat up = zjeśæ
eavesdrop = podsłuchaæ
edge = brzeg
edit = redagowaæ
editor = redaktor
editorial office = redakcja
effort = kłopot, staranie, zabiegi
egg = jajko
eight = osiem
eighteen = osiemnaście
eighteenth = osiemnasty
eighth = ósmy
eight hundred = osiemset
eighty = osiemdziesiąt
elect = wybraæ, wybieraæ
elegant = elegancki
elephant = słoñ
elevator = winda
else = inny, inaczej, gdzie indziej, dalej, w dalszym ciągu
elsewhere = w innym miejscu
embody = wcieliæ
emerge = pojawiaæ siê
eminent = wybitny
employ = używaæ
encounter = spotykaæ, spotkanie
end = koñczyæ, koniec
endeavour = staraæ siê
ending = koniec
end up = przyjechaæ, przyjśæ
endure = trwaæ, cierpieæ
enemy = nieprzyjaciel
energetic = energiczny
engine = maszyna, silnik
engineer = inżynier
Englishman = Anglik
enigma = zagadka
enjoy = cieszyæ siê, radowaæ siê
enjoyable = miły, przyjemny
enjoy oneself = zabawiaæ siê, bawiæ siê
enormous = olbrzymi
enormously = ogromnie
enough = wystarczający
enter = wprowadzaæ do środka, wejśæ, wpisaæ
entertaining = zabawny
enthusiasm = entuzjazm
entice = kusiæ
entire = całkowity
entirely = zupełnie
envelope = koperta
environment = okolica
environs = okolica
equally = tak samo
erect = założyæ, ustanowiæ
err = myliæ siê, błądzieæ
error = błąd, pomyłka
especially = zwłaszcza, szczególnie
Esperantist = esperantysta
establish = założyæ, ustanowiæ, stwierdzaæ, konstatowaæ
estimate = oceniaæ
ethos = nastrój
Europa = Europa
Europe = Europa
European = Europejczyk
evade = unikaæ
even = nawet
evening = wieczór
evening meal = kolacja
event = okazja, przypadek, zdarzenie
ever = kiedyś, zawsze
every = każdy
everybody = każdy
every kind of = wszelki, wszelaki
every one = każdy
everyone's = każdego
everything = wszystko
everywhere = wszêdzie
exact = właściwy
exactly = dokładnie, właśnie, właściwie
exaggerate = przesadzaæ
examination = egzamin
examine = egzaminowaæ
exceed = przewyższaæ
exceedingly = nadzwyczajnie, niezwykle
except = oprócz
except for = oprócz
exclusively = tylko, dopiero
excursion = wycieczka
excuse = uniewinniaæ
excuse me = wybacz
excuse oneself = przepraszaæ
exercise = zadanie
exertion = wysiłek
exist = istnieæ
exit = wychodziæ, wyjśæ
expect = czekaæ
expectation = oczekiwanie
expensive = drogi, kosztowny
experience = doświadczenie, przeżycie, przeżyæ
experienced = doświadczony
expert = doświadczony
expire = umieraæ
explain = wyjaśniaæ
explode = wybuchnąæ
express = wydobyæ, wyraziæ, wyrażaæ
expression = mina
extension = przyrostek
external = zewnêtrzny
extraordinarily = nadzwyczajnie, niezwykle
extraordinary = nadzwyczajny, niezwykły
extremely = ogromnie, bardzo
eye = oko
face = twarz
facile = łatwy
faction = partia
factory = fabryka
fade = zblednąæ
faint = słaby
fair = sprawiedliwy
fairy tale = bajka
faithful = wierny
fall ill = zachorowaæ
family = rodzina
famous = sławny
fancy = wyobrażaæ, marzyæ
fantasy = fantazja
fare = czuæ siê
farewell = żegnaj, pożegnanie
fast = szybki, szybko
fasten = umocowaæ, ustaliæ
fat = gruby
father = ojciec
father-in-law = teśæ
fatherland = ojczyzna
fault = przewinienie
favor = przysługa
favour = przysługa
fear = baæ siê, strach
feast = uczta, przyjêcie, biesiada
feather = pióro
February = luty
feed = jeśæ
feel = odczuwaæ, uczucie
feeling = uczucie
fellow = osobnik, mąż, mêżczyzna
fellow-creature = bliźni
female = kobieta, samica
female teacher = nauczycielka
fervor = zapał, gorliwośæ
fervour = zapał, gorliwośæ
fetch = przynieśæ
fever = gorączka
fewer = mniej
fewest = najmniej
field = pole
fifteen = piêtnaście
fifteenth = piêtnasty
fifth = piąty
fifty = piêædziesiąt
fight = walczyæ, zwalczaæ
fight against = zwalczaæ
figure = liczyæ
files = archiwum
fill = wypełniæ
fill in = wypełniæ
fill up = wypełniæ
film = film
finally = w koñcu
find = znaleźæ
find oneself = znajdowaæ siê
fine = piêkny, ładny, znakomity, wyborny, świetny
finger = palec
finish = koñczyæ
finished = gotowy
Finn = Fin
fire = ogieñ, strzelaæ
firing = strzelanina
firmly = mocno, trwale, niezachwianie
first = pierwszy, najpierw, po pierwsze
firstly = najpierw, po pierwsze
first of all = najpierw, po pierwsze
fish = ryba
fisherman = rybak
fit = byæ zdatnym
five = piêæ
fix = ustalaæ, determinowaæ, umocowaæ, ustaliæ, naprawiaæ
fix up = urządzaæ, organizowaæ
flat-iron = żelazko
float = pływaæ
floor = piêtro, podłoga
flour = mąka
flower = kwiat
flu = grypa
fly = mucha
fog = mgła
food = potrawa
fool = głupiec
foolish = głupi
foot = stopa
for = podczas, gdy, ponieważ, bo
for a long time = długo
forbid = zabraniaæ
force = zmusiæ, siła, moc
forefather = praojciec
foresee = przewidywaæ
forest = las
for every reason = z każdego powodu
forget = zapominaæ
forget-me-not = niezapominajka
forgive = przebaczaæ
form = formowaæ, kształtowaæ, kształt, forma, formularz
former = poprzedni, przedni
formerly = przedtem, na przodzie
formidable = nadzwyczajny, niezwykły
for no reason = z żadnego powodu
forsake = opuściæ
for some reason = z jakiegoś powodu
for the rest = zresztą
fortress = warownia, twierdza
forty = czterdzieści
found = założyæ, ustanowiæ
four = cztery
fourth = czwarty, æwiartka
fraction = ułamek
France = Francja
free = wolny
freedom = wolnośæ
freezing cold = mróz
Frenchman = Francuz
frequent = uczêszczaæ, czêsty
frequently = czêsto
fresh = świeży
Friday = piątek
friend = przyjaciel
friendly = uprzejmy
friendship = przyjaźñ
from = przez, do, z
from where = skąd
frost = mróz
fruit = owoc
full = pełen, pełny, syty
full of zeal = gorliwy, zapalony
fully = w pełni
fun = przyjemnośæ
function = działaæ, funkcjonowaæ
funny = zabawny
further = dalej, w dalszym ciągu
furthermore = dalej
futile = daremny
gain = zarabiaæ
gallant = dzielny
gallery = galeria
gape at = gapiæ siê
garden = ogród
gardener = ogrodnik
garment = ubranie
gate = brama
gateway = brama
gathering = zebranie, konwent
gaunt = smutny
gay = wesoły
gazette = gazeta
general = generał
generally = ogólnie, generalnie
generation = generacja
gentle = słodki
gentleman = pan
genuine = autentyczny
genuinly = rzeczywiście
German = niemiecki, Niemiec
get = przyjechaæ, przyjśæ, osiągaæ, uzyskaæ, czyniæ czymś, skłaniaæ do czegoś, zostaæ, stawaæ siê, wziąæ, braæ, otrzymaæ
get married = wyjśæ za mąż, ożeniæ siê
get off = zejśæ
get tired = zmêczyæ siê
get wet = zmoknąæ
gift = podarunek
gin = jałowcówka, dżin
give = daæ, dawaæ, przedstawiaæ
give back = oddawaæ
give rise to = powodowaæ, sprawiaæ
give utterance to = wydobyæ
gladness = radośæ
glove = rêkawiczka
go = iśæ, pojechaæ, jechaæ
goal = cel
goat = koza
go away = usunąæ
go beyond = przejśæ
goblet = kieliszek
go down = zejśæ
go fast = śpieszyæ siê
go for a walk = spacerowaæ
go in = wejśæ
gold = złoto
good = dobrzy
goodbye = żegnaj, pożegnanie, do widzenia
good-bye = pożegnanie
good day = dzieñ dobry
good evening = dobry wieczór
good morning = dzieñ dobry
good-natured = uprzejmy
goodness = dobroæ
good night = dobranoc
go out = wychodziæ, wyjśæ
go through = doświadczyæ, dożyæ
go to bed = położyæ siê do łóżka
go to sleep = zasnąæ
go up = iśæ w górê
govern = panowaæ, rządziæ
government = rząd
gown = suknia
grade = stopieñ, nuta, nota
grandfather = dziadek
grandmother = babka
granny = babcia
grapple = łapaæ, chwytaæ
great = znakomity, wyborny, świetny, duży
great-grandfather = pradziadek
greatgrandson = prawnuk
Greek = Grek
green = zielony
greeting = pozdrowienie
grey = szary, siwy
grip = grypa
groschen = grosz
ground = teren
grounds = teren
group = grupa
grow = zostaæ, stawaæ siê, rosnąæ, róśæ
gruesome = okropny, straszny
gruff = nieuprzejmy
guarantee = gwarantowaæ
guard = gwardia, drużyna
guess = przypuszczaæ
guest = gośæ
guide = kierowaæ, prowadziæ, przewodnik, prowadziæ
guidebook = przewodnik
guilt = przewinienie
guiltless = niewinny
guy = osobnik
gypsy = Cygan
habit = zwyczaj
hail = grad
hair = włos
hairdresser = fryzjer
half = połowa
halt = zatrzymaæ siê, zatrzymaæ
ham = szynka
hand = podawaæ, wrêczaæ, robotnik, rêka, przekazaæ
handbook = przewodnik
hand over = podawaæ, wrêczaæ, przekazaæ
handsome = piêkny, ładny
hang = wisieæ, powiesiæ
happen = stawaæ siê, zdarzyæ siê, wydarzyæ siê
harbor = port
harbour = port
hard = trudny
hardly = zaledwie, trudno
hardworking = pilny, pracowity
hare = zając
harsh = nieuprzejmy
hat = kapelusz
hate = nienawidzieæ
have = mieæ, otrzymaæ
have a good time = zabawiaæ siê, bawiæ siê
have a tendency = byæ skłonnym
have at one's disposal = dysponowaæ
have compassion on = współczuæ
have got = mieæ
have the right to = mieæ prawo
have to = musieæ
hazard = przypadek
he = on
head = kierowaæ, prowadziæ, głowa
headache = ból głowy
heading = tytuł
health = zdrowie
healthy = zdrów, zdrowy
heap = masa
hear = słyszeæ
heart = serce
heart- = serdeczny
hearty = serdeczny
heaven = niebo
height = wysokośæ
hello = cześæ, czołem
helmet = kask
help = pomagaæ, pomoc
her = swój, swoje, swoja, swe, ona, jej
here = tu
here are = oto
here is = oto
heroin = bohaterka
heroine = bohaterka
herself = sam, osobiście
hesitate = wahaæ siê
hide = ukrywaæ, chowaæ
high = wysoki
him = on
himself = sam, osobiście
hinder = krêpowaæ, przeszkadzaæ
hip = biodro
his = jego, swój, swoje, swoja, swe
hit = biæ, uderzaæ, pukaæ, trafiæ
hobby = hobby
hog = świnia
holder = pochwa, futerał
Holland = Holandia
holy = świêty
home = dom
honest = uczciwy
honor = zaszczyt, honor
honour = zaszczyt, honor
hooter = róg
hope = mieæ nadziejê, nadzieja
horn = róg
horrible = okropny, straszny
horse = koñ
hospitable = gościnny
hot = gorący
hotel = hotel
hour = godzina
house = dom
housefly = mucha
house of worship = kościół
how = jak
however = jednak
how many = ile, który
how much = ile
huge = olbrzymi
human being = człowiek
human race = ludzkośæ
hundred = sto
Hungarian = Wêgier
hungry = głodny
hunt = polowaæ
hurry = śpieszyæ siê, ponaglaæ, byæ pilnym
hurt = boleæ, dolegaæ
husband = mąż
hut = chata
hymn = pieśñ
ice = lody, lód
icecream = lody
idea = pomysł, idea, myśl
if = jeżeli, o ile
ill = chory
illness = choroba
image = obraz
imagine = wyobrażaæ
immediately = zaraz, natychmiast
immense = olbrzymi
impartial = neutrala
imply = mieæ znaczenie, znaczyæ
important = poważny
impossible = niemożliwy
impress = robiæ wrażenie
impression = impresja, wrażenie
in = w
in addition = oprócz tego, dalej
in a way = niby, jakby
inborn = od urodzenia
inbred = od urodzenia
incendiary bomb = bomba zapalająca
include = zawieraæ
inconvenient = trudny
incorrect = niewłaściwy
increase = zwiêkszyæ siê
indeed = faktycznie, przecież, wszak, rzeczywiście
in detail = szczegółowo, detalicznie
indicate = pokazaæ
industrial = przemysłowy
industrious = pilny
industry = pilnośæ, przemysł
in every way = w każdy sposób
in exchange for = przeciw, naprzeciw, w zamian
inexpensive = tani
in fact = rzeczywiście, faktycznie
infant = dziecko
influence = wpływaæ
influenza = grypa
inform = informowaæ, zawiadomiæ
in front of = przed
ingenious = genialny
ink = atrament
inkpot = kałamarz
ink-well = kałamarz
innate = od urodzenia
innocent = niewinny
in no way = w żaden sposób
inquisitive = zaciekawiony
insert = wprowadzaæ do środka
inside = w
in spite of = pomimo, wbrew, na przekór
instant = chwila, moment
instruction = pouczenie, nauczka
instructor = nauczyciel
insult = obrażaæ
intend = zamierzaæ
interest = zaciekawiaæ
interesting = ciekawy
interrupt = przerwaæ
interview = wywiad
in that way = w ten sposób
in the beginning = początkowo
in the evening = wieczorem
in the meantime = tymczasem
in the morning = rano
into = w
introduce = przedstawiaæ
in vain = daremnie
investigation = egzamin
invitation = zaproszenie
invite = zaprosiæ
in what way = jak
iron = żelazo, prasowaæ, żelazko
iron clothes = prasowaæ
island = wyspa
issue = wydaæ
it = ono, to
Italian = Włoch
its = swój, swoje, swoja, swe
itself = sam, osobiście
jacket = marynarka
January = styczeñ
Japanese = Japoñczyk
jealous = zazdrosny
jeer at = szydziæ
jest = żatrowaæ
Jew = Żyd
jewel = klejnot
jeweller = jubiler
job = robota, praca
join = przyłączyæ siê, dołączyæ siê, połączyæ, związaæ, wiązaæ, łączyæ
joint = wspólny
joke = żatrowaæ
Joseph = Józef
journal = dziennik
journalist = dziennikarz
journey = podróż
joy = radośæ
jubilee = jubileusz
jug = dzban, pojemnik, naczynie
juice = sok
July = lipiec
jump = skakaæ
jungle = dżungla
just = sprawiedliwy, tylko, dopiero, zaraz, natychmiast, właśnie, właściwie, dopiero co, przed chwilą
just now = dopiero co, przed chwilą
keep = wykonaæ, spełniæ
keep on = trwaæ
keepsake = pamiątka
kilo = kilogram
kind = uprzejmy, usłużny, uczynny
kindness = uprzejmośæ
king = król
kiss = całowaæ, pocałunek
kitchen = kuchnia
klaxon = róg
knee = kolano
knife = nóż
knock = uderzaæ, pukaæ
knot = wiązaæ, wêzeł
know = znaæ, wiedzieæ
know how = wiedzieæ, potrafiæ
laborer = robotnik
labourer = robotnik
lack = brak
lad = chłopiec
laddie = chłopiec
ladies and gentlemen = pañstwo
lake = jezioro
lamp = lampa
land = wylądowaæ, kraj, ziemia
large = duży
last = poprzedni, przedni, trwaæ, ostatni
lasting = trwały
late = późny, późno
laud = chwaliæ
laugh = śmiaæ siê
lay down = kłaśæ
lay hold of = wziąæ, braæ
lazy = leniwy
lead = kierowaæ, prowadziæ
leader = szef, zwierzchnik
leaf = arkusz, kartka, liśæ
leap = skakaæ
learn = uczyæ siê
least = najmniej
leave = usunąæ, opuściæ, zostawiæ, puściæ
leave behind = pozostawiæ
lector = lektor
lecture = prelekcja
lecturer = lektor
left = lewy
leg = noga
legend = legenda
legible = czytelny
lemon = cytryna
lend = pożyczyæ
lengthwise = wzdłuż
less = mniej
lesson = lekcja
let = zostawiæ, puściæ
let know = zawiadomiæ
letter = list, litera
level = poziom
library = biblioteka
lie = leżeæ
lie down = położyæ siê
lieutenant = porucznik
life = życie
lift = winda
light = jasny, lekki, światło, słaby, lekki
lightly = słabo
like = jak, lubiæ, ceniæ
like this = w ten sposób
likewise = także, też, również, tak samo
lilac = bez, lilak
line = linia
linguistic = jêzykowy
lion = lew
listen = słuchaæ
listener = słuchacz
liter = litr
literal = dosłownie
literature = literatura
litre = litr
little = mały
live = mieszkaæ, żyæ
lively = sprytny, dowcipny
live through = przeżyæ
live to see = doświadczyæ, dożyæ
loaf = chleb
loan = pożyczaæ
location = miejsce, miejscowośæ
loch = jezioro
lofty = wysoki
London = Londyn
long = długi, długo
look = wyglądaæ, mieæ wygląd, oto, patrzeæ, spojrzenie
look after = zadbaæ
look at = patrzeæ
lord = pan
lose = gubiæ, traciæ
lounge = salon, sala
love = kochaæ, miłośæ
loved = kochany
lovely = miły, przyjemny, piêkny, ładny, przepiêkny, prześliczny, drogi, uroczy
lower-arm = przedramiê
luck = szczêście, traf, szansa
lump = bryła
lunatic = szaleniec
lung = płuco
lurid = ostry
lust = pasja
lyric = tekst
machine = maszyna
magazine = gazeta, czasopismo, rewia
mail = poczta
main = główny
mainly = zwłaszcza, szczególnie
major = główny
make = robiæ, czyniæ, czyniæ czymś, skłaniaæ do czegoś
make a mistake = myliæ siê, błądzieæ
make a noise = hałasowaæ
make clean = czyściæ
make fast = umocowaæ, ustaliæ
make fun of = szydziæ
make glad = uradowaæ, ucieszyæ
make use of = używaæ
male = mêski
malicious = złośliwy
mam = mama, mamusia
mammy = mama, mamusia
man = człowiek, mąż, mêżczyzna
manager = dyrektor
mankind = ludzkośæ
mansion = gmach
mantle = płaszcz
manuscript = rêkopis, manuskript
many = wielu, liczni
margarine = margaryna
maritime = morski
married people = małżonkowie, małżeñstwo
marry = ożeniæ, wydaæ za mąż, wyjśæ za mąż, ożeniæ siê
marvel = dziwiæ siê
marvel at = dziwiæ siê
masculine = mêski
mask = maska
mass = masa, tłum
master = nauczyæ siê, wyuczyæ siê
match = zapałka
material = materiał
maternal uncle = wuj
matter = sprawa, afera
may = mieæ prawo
maybe = może
mayhap = może
mayor = sołtys
meal = mąka
mean = zamierzaæ, środek, mieæ znaczenie, znaczyæ
means = narzêdzie, instrument, przyrząd
meanwhile = tymczasem
medical = leczniczy
medicine = medycyna
meet = spotykaæ
meeting = zebranie, konwent
memento = pamiątka
memory = pamiêæ
menu = jadłospis
merchandise = towar
merry = wesoły
metal = metal
metropolis = stolica
Mexico = Meksyk
Mexico City = miasto Meksyk
midday = południe
midday meal = obiad
middle = środek
milk = mleko
million = milion
mine = kopalnia
mineral = mineralny
minister = minister, górnik
minus = minus
minute = minuta
mischievous = złośliwy
miserable = zły, smutny, biedny
mist = mgła
mistake = błąd, pomyłka
Mister = pan
misunderstand = źle rozumieæ
misunderstanding = nieporozumienie
mitten = rêkawiczka
mock = szydziæ
model = wzorzec, model
modern = nowoczesny
modest = skromny
modesty = skromnośæ
mom = mama, mamusia
moment = chwila, moment
mommy = mama, mamusia
Monday = poniedziałek
money = pieniądze
month = miesiąc
monument = pomnik
mood = nastrój
moon = ksiêżyc
more = bardziej, wiêcej, dalej, w dalszym ciągu
moreover = zresztą, oprócz tego, dalej
morning = ranek
Moscow = Moskwa
most = najbardziej, najwiêcej
mother = matka
mother-in-law = teściowa
motion picture = film
motor = silnik
motor car = auto, samochód
motto = dewiza, zasada postêpowania, waluta
mountain = góra
mourn = opłakaæ
mouse = mysz
mouth = usta
move = ruszaæ, zmieniæ miejsce
movement = ruch
movie = film
movie theatre = kino
Mr. = pan
Mr. and Mrs. = pañstwo
multicoloured = wielobarwny
multitude = masa, tłum
murder = mordowaæ
museum = muzeum
music = muzyka
musical = muzyczny
must = musieæ
mutiny = bunt, powstanie
my = mój, moja, moje, moi
mysterious = tajemniczy
name = nazwa, nazwisko, imiê
namely = mianowicie
narrate = opowiadaæ
narrative = opowiadanie
nasty = brzydki, zły, złośliwy
nation = naród
national = narodowy
native = od urodzenia
nature = natura
naught = zero
near = obok, bliski, blisko
nearby = obok, bliski, blisko
nearly = prawie, niemal
nearness = bliskośæ
near to = obok
necessary = konieczny
neck = szyja
necklace = naszyjnik, kolia
necktie = krawat
need = potrzebowaæ
needle = szpilka
needlewoman = krawcowa
neglect = lekceważyæ
Negro = Murzyn
neighbour = sąsiad, bliźni
neighbourhood = dzielnica
neither = ani, nikt
nervous = zdenerwowany
neutral = neutrala
never = nigdy
nevertheless = jednak
new = nowy
news = nowina, rzecz nowa
newspaper = gazeta, dziennik
next = potem, bliski
next to = obok
nice = miły, przyjemny, dobrzy, smaczny
Nigeria = Nigeria
night = noc
nine = dziewiêæ
no = nie
nobody = nikt
node = wêzeł
no doubt = niewątpliwie
noisy = hałaśliwy
none = nikt
noon = południe
no-one = nikt
no-one's = niczyj, nikogo
nor = ani
north = północ
Norwegian = Norweg
nose = nos
not = nie
not an ace = żadna ilośæ
not at all = w żaden sposób, wcale nie, zupełnie nie
note = bilet, nuta, nota
not easily = trudno
nothing = nic
notice = zauważyæ, uwaga, spostrzeżenie
not on any account = w żaden sposób
notwithstanding = pomimo
nought = zero
novel = nowy, powieśæ
novelty = nowina, rzecz nowa
November = listopad
now = no, teraz, obecnie
nowhere = nigdzie
null = zero
number = numer
numeral = numer
nurse = pielêgnowaæ
obey = byæ posłusznym
object = przedmiot, obiekt
obligation = obowiązek
obliging = usłużny, uczynny
observation = uwaga, spostrzeżenie
observe = wykonaæ, spełniæ
obviously = oczywiście
occasion = raz
occupation = zajêcie
occupy = zajmowaæ
occur = zdarzyæ siê, wydarzyæ siê
occurence = okazja, przypadek, zdarzenie
o'clock = godzina
October = październik
Oder = Odra
of = przez, do
of course = oczywiście, rozumie siê
offend = obrażaæ
offer = przedstawiaæ, proponowaæ
office = biuro, urząd
officer = oficer, urzêdnik
official = urzêdowy, służbowy, urzêdnik
often = czêsto
of the sea = morski
of the winter = zimowy
of which = czyj, którego
oil = olej
oil of olives = oliwa
okay = dobrzy, dobrze, właśnie, właściwie
old = stary
old man = starzec
olive = oliwka
olive-oil = oliwa
omnibus = autobus
on = przez, do, w, za pomocą, dalej, w dalszym ciągu, o, na
once = pewnego razu
once more = znowu, ponownie
one = ktoś, jeden, pewien
one at a time = pojedynczo
one hundred = sto
one thousand = tysiąc
on foot = piechotą
only = tylko, dopiero, sam
only just = zaledwie
on occasion = pewnego razu, z okazji
on that account = dlatego
on the contrary = przeciwnie
on the left = po lewej
on the other hand = z drugiej strony
on the other side of = po drugiej stronie, poprzez
on the right = po prawej stronie, na prawo
on time = akuratny, punktualny
on top = na górze, u góry
open = otwieraæ, otwarty
open up = otwieraæ
opera = opera
operate = działaæ, funkcjonowaæ, uruchamiaæ
operative = robotnik
opine = mniemaæ, śadzieæ
opinion = opinia
opponent = przeciwnik
opportunity = okazja, przypadek, zdarzenie
opposed to = przeciw, naprzeciw, w zamian
opposite = przeciw, naprzeciw, w zamian, przeciwny
oppress = ściskaæ
or = albo, lub
orange = pomarañcza
orchestra = orkiesta
orchid = orchidea
ordain = przeznaczyæ
order = zamawiaæ, zamówienie, porządek, rozkazywaæ
ordinarily = zwykle
ordinary = zwykły
ornament = ozdabiaæ
ornamental = zdobniczy
other = inny
otherwise = przeciwnie
ought to = musieæ
our = nasz
outer = zewnêtrzny
outing = wycieczka
out of = z
outside = poza, na zewnątrz, zewnêtrzny
outside of = poza, na zewnątrz
overall = całkowity
overcoat = płaszcz
overhead = na górze, u góry
over there = tam
own = własny
owner = właściciel
pace = krok
packet = paczka
pad = blok
page = strona
pain = ból
paint = kolorowaæ, farbowaæ, malowaæ
painter = malarz
painting = obraz
pair = para
palace = pałac
pale = blady
pants = spodnie
paper = papier
paprika = papryka
paradise = raj
parcel = paczka
pardon = przebaczaæ
parents = rodzice
Paris = Paryż
parish = parafia
park = park
parlour = salon, sala
part = czêśæ
Parthian = czêśæ
partially = czêściowo
participate = uczetniczyæ
partly = czêściowo
party = partia
pass = spêdzaæ, przekazaæ
pass away = umieraæ
passion = pasja
passport = paszport
pass the night = przenocowaæ
pate = głowa
paternal uncle = stryj
patience = cierpliwośæ
patient = pacjent
pauper = biedak
paw = noga, stopa
pawn = żołnierz
pay = płaciæ
pay attention = uważaæ, zwracaæ uwagê
pay attention to = uważaæ, zwracaæ uwagê
pay out = wydawaæ
peace = pokój
peaceful = pokojowy
pear = gruszka
pear-tree = grusza
pen = pióro
pencil = ołówek
pepper = pieprz
per = w, po
perceive = zobaczyæ, ujrzeæ
percent = procent
percentage = procent
perchance = może
perfect = udoskonalaæ
perform = pojawiaæ siê, wejśæ, robiæ, czyniæ, wykonaæ, spełniæ, przedstawiaæ
perhaps = może
peril = niebezpieczeñstwo
period = punkt, kropka
periodical = gazeta, czasopismo, rewia
perish = ginąæ, umrzeæ
permission = zgoda
permit = pozwalaæ
persecute = prześladowaæ
person = osoba, osobnik
personal = własny
petticoat = halka
phonograph = gramofon
photograph = fotografia, zdjêcie, zdjêcie, fotografia
physician = lekarz
physics = fizyka
pianist = pianista
pianoforte = fortepian
pick out = wybraæ, wybieraæ
pick up = wziąæ, braæ
picture = obraz
picture postcard = widokówka, pocztówka
pie = tort
piece = czêśæ
piece of furniture = mebel
pig = świnia
pile = masa
pill = pigułka
pin = szpilka
pink = goździk
pitcher = dzban
pity = współczuæ
place = miejsce, lokal, miejscowośæ, kłaśæ
place of worship = kościół
plan = planowaæ, plan
plane = samolot, plan
platform = peron, program
plausible = wiarygodny
play = graæ, bawiæ siê, sztuka teatralna
plaza = plac
pleasant = miły, przyjemny
please = proszê, zachciej, racz, podobaæ siê
pleased = zadowolony
pleasing = przyjemny, ładny
pleasure = przyjemnośæ
plume = pióro
plus = plus
pocket = kieszeñ
poet = poeta
poetry = poezja
point = punkt, kropka
point out = pokazaæ
poison = trucizna
Poland = Polska
politeness = grzecznośæ
Pomerania = Pomorze
poor = zły, biedny
poor man = biedak
poppy = mak
pork = wieprzowina
port = port
portal = brama
Portuguese = Portugalczyk
pose = pozowaæ
possibility = możliwośæ
possible = możliwy
possibly = może
post = poczta
postman = listonosz
postpone = odkładaæ, przesuwaæ
postulate = żądaæ, postulowaæ
potato = ziemniak
pour = laæ
practical = praktyczny, realny, rzeczywisty
practice = zadanie
practice of medicine = medycyna
Prague = Praga
praise = chwaliæ
pray = modliæ siê
precede = wyprzedzaæ
precise = dokładny, precyzyjny
prefer = woleæ
preferably = raczej
prehistory = prehistoria
premier = premier
prepare = przygotowaæ
present = podarunek, obecny, współczesny, przedstawiaæ
presentation = przedstawienie
present with = przedstawiaæ
president = prezes, przewodniczący
press = prasa, ściskaæ, ponaglaæ, byæ pilnym
presume = przypuszczaæ
pretty = ładny
previous = poprzedni, przedni
previously = przedtem, na przodzie
price = cena
pricey = drogi, kosztowny
prime minister = premier
prince = książê
principal = główny
principally = zwłaszcza, szczególnie
print = drukowaæ
prior = poprzedni, przedni
private = prywatny
probably = prawdopodobnie
problem = problem
produce = realizowaæ
profess = wyznawaæ, przyznawaæ siê
professional = zawód
professor = profesor
programme = program
prohibit = zabraniaæ
promise = obiecywaæ
prompt = akuratny, punktualny
pronounce = wymawiaæ
proper = właściwy
property = cecha
propose = proponowaæ
prosecute = prześladowaæ
prospectus = prospekt
prosper = prosperowaæ, powodziæ siê
proud = dumny
proverb = przysłowie
provided that = jeżeli, o ile
province = prowincja
provost = sołtys
proximity = bliskośæ
pseudonym = pseudonim
public square = plac
publish = wydaæ
publisher = wydawnictwo
publishing house = wydawnictwo
pull out = wydobyæ
pullover sweater = sweter
punctual = akuratny, punktualny
punish = karaæ
purchase = kupiæ, kupno, zakup
pure = czysty
purge = czyściæ
purpose = cel
purse = portfel
pursue = prześladowaæ
put = kłaśæ
put down = kłaśæ
put in = wprowadzaæ do środka
put in order = porządkowaæ
put off = zdjąæ
put on = nałożyæ
put on the stage = przedstawiaæ
put to sleep = usypiaæ
put up with = cierpieæ
puzzle = zagadka
quality = cecha
quarrel = kłóciæ siê
quarter = dzielnica
quarter of an hour = kwadrans
quash = niszczyæ
quay = peron
question = pytanie, problem, zagadnienie
quick = szybki
quickly = szybko
quiet = spokój
quinsy = angina
quit = opuściæ
quite = mniej wiêcej, bardzo, nader, zupełnie
quiver = drżeæ
radio = radio
radius = promieñ
railroad = kolej
railway = kolej
railway carriage = wagon
rain = deszcz
rapid = szybki
rate = oceniaæ
rather = trochê, ileś, troszeczkê, przecież, wszak, średnio, w środku, raczej
ray = promieñ, radio
reach = osiągaæ, uzyskaæ
read = czytaæ
read again = przeczytaæ ponownie
reader = czytelnik
readiness = gotowośæ
reading matter = czytanka
read over again = przeczytaæ ponownie
ready = gotowy
real = realny, rzeczywisty
reality = prawda
realize = rozumieæ, mieæ świadomośæ
really = rzeczywiście
rebellion = bunt, powstanie
recall = pamiêtaæ, przypomnieæ
receive = przyjmowaæ, otrzymaæ
recent = świeży
recline = leżeæ
recognize = rozpoznaæ, uznaæ
recollect = pamiêtaæ, przypomnieæ
recollection = pamiêæ
recommend = poleciæ
record = płyta, dysk
record-player = gramofon
records = archiwum
recover = wyzdrowieæ
red = czerwony
reflect on = przemyśleæ
regard = patrzeæ
register = poleciæ
regrettably = niestety
regularly = czêsto, regularnie
rejoice = cieszyæ siê, radowaæ siê
relate = opowiadaæ
release = zostawiæ, puściæ
religion = religia
relish = łakomiæ siê
remain = zostawaæ
remember = pamiêtaæ, przypomnieæ
repair = naprawiaæ
repeat = powtarzaæ
repeatedly = wielokrotnie
replete = syty
reply = odpowiadaæ, odpowiedź
report = informowaæ, powiadamiaæ, komunikowaæ
repose = wypoczywaæ
request = prosiæ
require = potrzebowaæ, żądaæ, postulowaæ
re-read = przeczytaæ ponownie
reserve = zamawiaæ, rezerwowaæ
residence = mieszkanie
respond = odpowiadaæ
rest = wypoczywaæ
restaurant = restauracja
restrain = powstrzymywaæ, panowaæ, rządziæ
retardation = spóźnienie
return = oddawaæ, powróciæ, powrót
reveal = ujawniæ, odkryæ
review = recenzja
revolt = bunt, powstanie
revue = czasopismo, rewia
rice = ryż
rich = bogaty
rich man = bogacz
riddle = zagadka
ride = jechaæ
ridiculous = śmieszny
right = prawy, właściwy, właśnie, właściwie
right away = zaraz, natychmiast
righteous = sprawiedliwy
righthand = prawy
right now = zaraz, natychmiast
river = rzeka
roam = włóczyæ siê
rob = okraśæ
robe = suknia
rogue = łotr
roll = bułka
Roman = powieśæ
Romania = Rumunia
Romanian = Rumun
Rome = Rzym
roof = dach
room = pokój
root = zakorzeniæ siê, przyjąæ siê, rdzeñ
rope = sznur
rose = róża
rose-bush = krzak róży
rough = nieuprzejmy
round = wokół, dookoła, około
ruin = rujnowaæ, ruina
rule = panowaæ, rządziæ
run = działaæ, funkcjonowaæ, biec
run across = trafiæ
rush = śpieszyæ siê
Russian = Rosjanin
Sabbath = sobota
sack = worek, torba
sacred = świêty
sad = smutny
sagacious = mądry
sage = mądry
sallow = blady
salon = salon, sala
salt = sól
saltshaker = solniczka
same = taki sam, to samo
sandwich = kanapka
sap = sok
Sassenach = Anglik
satisfied = zadowolony, syty
Saturday = sobota
save = oszczêdzaæ
say = powiedzieæ
scales = waga
scarcely = zaledwie
scatter = laæ
school = szkoła
science = nauka
scientific = naukowy
scissors = nożyczki
Scot = Szkot
Scotsman = Szkot
script = scenariusz
sculptor = rzeźbiarz
sculpture = rzeźba
sea = morski, morze
sea- = morski
seamstress = krawcowa
seaside = wybrzeże
seat = siedziba
second = drugi
secret = tajemnica
secure = umocowaæ, ustaliæ
see = spotykaæ, widzieæ, troszczyæ siê, dbaæ
seem = zdawaæ siê
seemingly = pozornie
seldom = rzadko
self = sam, osobiście
self-conscious = zażenowany
sell = sprzedawaæ
send = posyłaæ
sensation = uczucie
sense = odczuwaæ
sensitive = uczuciowy
sentence = zdanie
separate = dzieliæ
separately = osobno, oddzielnie, szczególnie
September = wrzesieñ
Serb = Serb
sergeant = sierżant
serious = poważny
serve = służyæ
settlement = osada, kolonia
seven = siedem
seventeen = siedemnaście
seventeenth = siedemnasty
seventh = siódmy
seventy = siedemdziesiąt
severe = ostry, srogi
shack = chata
shake = potrząsaæ
shallowly = powierzchownie
shape = formowaæ, kształtowaæ, kształt, forma
share = dzieliæ, czêśæ, porcja
sharp = ostry, dokładnie
shave = goliæ
shawl = szalo
she = ona
shear = strzyc
shed = laæ
sheep = owca
sheet = arkusz, kartka, liśæ
shelf = półka
shine = błyszczeæ, świeciæ
ship = statek
shirt = koszula
shiver = drżeæ
shock = potrząsaæ
shoot = strzelaæ
shop = sklep
shore = brzeg, wybrzeże
short = krótki
shortage = brak
shortcoming = brak
shorten = skróciæ
short story = nowela
should = musieæ
shoulder = plecy
show = pokazaæ, przedstawienie
shower = przysznic, natrysk
shrub = krzak
shut = zamykaæ, zamkniêty
shy = zażenowany
sick = chory
side = strona, bok, partia
sideboard = szafa
sightseeing trip = wycieczka
signify = mieæ znaczenie, znaczyæ
silence = spokój
Silesia = Śląsk
silver = srebro
simple = prosty, zwykły
since = przez, do, ponieważ, bo
sincere = szczery
sincerity = szczerośæ
sing = śpiewaæ
singer = śpiewak
single = pojedynczy
singly = pojedynczo
sir = pan
sister = siostra
sit = siedzieæ
sit down = usiąśæ
sitting-room = salon, sala
six = sześæ
sixteen = szesnaście
sixteenth = szesnasty
sixth = szósty
sixtieth = sześædziesiąty
sixty = sześædziesiąt
size = wielkośæ
ski = jeździæ na nartach, narta
skin = skóra
skirt = spódnica
sky = niebo
sky blue = błêkitny
Slav = Słowianin
sleep = spaæ
sleepy = senny
slender = zgrabny
slice = ciąæ
slim = zgrabny
slogan = dewiza, zasada postêpowania, waluta
Slovak = Słowak
small = mały
smile = uśmiechaæ siê, uśmiech
smoke = paliæ, dymiæ
sneeze = kichaæ
snow = śnieg
so = wiêc, przeto, to, przeto, wiêc, zatem, w ten sposób
soap = mydło
social = socjalny
society = klub, towarzystwo
socket = pochwa, futerał
sofa = sofa
soft = słodki
soil = ziemia
soldier = żołnierz
sole = sam
solitary = sam
so long = do widzenia
solve = rozpuszczaæ, rozwiązywaæ
somber = smutny
some = trochê, ileś, ktoś, pewien, jakiś, jacyś, kilka, kilkoro
somebody = ktoś
somehow = jakoś
some kind of = jakiś
someone = ktoś
some one = ktoś
someone's = czyjś
something = coś
something new = nowina, rzecz nowa
sometime = kiedyś
sometimes = pewnego razu
somewhat = trochê, ileś
somewhere = gdzieś
son = syn
song = pieśñ
soon = wkrótce
soul = dusza
soup = zupa
sour = nieuprzejmy
south = południe
souvenir = pamiątka
Spaniard = Hiszpan
spare = oszczêdzaæ
spare time = urlop, wczasy
speak = mówiæ
spectacle = przedstawienie
speed = szybkośæ
speedy = szybki
spend = wydawaæ, spêdzaæ
spend the night = przenocowaæ
spider = pająk
spiderweb = pajêczyna
spinach = szpinak
spinster = panna
spoon = łyżka
sport = sport
spot = miejsce, miejscowośæ, punkt, kropka
spring = wiosna, skakaæ
springtime = wiosna
square = plac
squeeze = ściskaæ
stage = stacja
stage-manager = reżyser
staid = poważny
staircase = schody
stairs = schody
stand = staæ
stand up to = przeciwstawiaæ siê
star = gwiazda
start = zaczynaæ, początek
state = stan, pañstwo
statement of policy = program
station = dworzec, stacja
stature = postawa, budowa ciała
stay = pobyt, zostawaæ
stay for = doczekaæ siê
stay over = zostawaæ
steak = befsztyk
steal = kraśæ
steam = para, opar
steamship = parowiec
step = krok
step-father = ojczym
still = jeszcze
stipulation = warunek
stomach = żołądek
stone = kamieñ
stop = przystanek, postój, zatrzymaæ siê, zatrzymaæ, stacja, przestaæ
store = sklep
storey = piêtro
story = piêtro, opowiadanie
straigh ahead = wprost, prosto
straightforward = prosty, zwykły
strech = napinaæ
street = ulica
streetcar = tramwaj
strength = siła, moc
strict = ostry, srogi
stride = krok
strike = biæ, zakorzeniæ siê, przyjąæ siê, uderzaæ, pukaæ, trafiæ
striking = trafny
string = sznur
strive for = dążyæ
stroll = spacerowaæ
strong = mocny, silny
strongly = mocno, silnie
struggle = walczyæ
student = student
study = studiowaæ
stupid = głupi
style = styl
subdue = podporządkowaæ
subject = temat
subjugate = podporządkowaæ
subordinate = podwładny
subsequently = potem, przeto, wiêc, zatem
subtract = odejmowaæ
subtraction = odejmowanie
suburb = przedmieście
succeed = mieæ powodzenie, odnieśæ sukces
success = sukces, powodzenie
such = taki, w ten sposób
such a = jak, taki
such as = jak
suffer = cierpieæ
sufficient = wystarczający
suffix = przyrostek
sugar = cukier
suggest = proponowaæ, sugerowaæ
suit = byæ zdatnym
suitcase = walizka
sum = suma, ilośæ
summer = lato
summon = wołaæ
sun = słoñce
Sunday = niedziela
superficial = powierzchniowy
superior = wyższy
superscription = napis
supper = kolacja
suppose = przypuszczaæ
sure = pewny, przeświadczony
surely = przecież, wszak
surly = nieuprzejmy
surmise = przypuszczaæ
surname = nazwisko
surpass = przewyższaæ
surprise = niespodzianka
surroundings = okolica
survive = przeżyæ
Swede = Szwed
Sweden = Szwecja
sweet = słodki, smakołyk
swift = szybki
swiftly = szybko
swim = pływaæ
swine = świnia
Swiss = Szwajcar
switch = włączaæ
syllable = sylaba
sympathetic = sympatyczny
symphonic = symfoniczny
syrup = syrop
table = stół
take = przyjmowaæ, zajmowaæ, wziąæ, braæ
take an interest = interesowaæ siê
take away = zabraæ
take care = troszczyæ siê, dbaæ
take in = przyjmowaæ
take note = stwierdzaæ, konstatowaæ
take off = zdjąæ
take one's measure for = przymierzyæ
take over = kupiæ
take steps = staraæ siê
taking = kupno, zakup
taking over = kupno, zakup
tale = opowiadanie
talent = talent
talk = mówiæ
talkative = gadatliwy
tall = wysoki
tango = tango
tardy = późny
target = cel
tart = tort
Tartar = Tatar
task = praca
taste = gust
tasty = smaczny
Tatar = tatarski
taxi = taksówka
tea = herbata
teach = nauczaæ
teacher = nauczycielka, nauczyciel
teapot = czajnik
telephone = telefonowaæ, telefon
television = telewizja
television set = telewizor
tell = powiedzieæ, rozkazywaæ, opowiadaæ
temperature = temperatura
tempt = kusiæ
ten = dziesiêæ
tendency = skłonnośæ
tender = słodki, przedstawiaæ, proponowaæ
tend to = pielêgnowaæ
tented camp = obozowisko
tenth = dziesiąty
terminate = koñczyæ
terms = warunek
terrace = taras
terrain = teren
terrible = okropny, straszny
test = egzamin, próbowaæ
text = tekst
textbook = podrêcznik
than = niż, od
thank = dziêkowaæ
thanks = dziêkujê, dziekujemy
thank you = dziêkujê, dziekujemy
that = że, co, kto, który, w ten sposób
that kind of = taki
that much = tyle
that one = tamten
that one over there = tamten
that one's = tego
that ... over there = tamten
that over there = tamto
that way = w ten sposób
the = tym, im...
theatre = teatr
theatre play = sztuka teatralna
the day after tomorrow = pojutrze
their = ich, swój, swoje, swoja, swe
theme = temat
then = wiêc, przeto, to, wtedy
the Netherlands = Holandia
there = oto, tam
there are = są
therefore = wiêc, przeto, to, dlatego
there is = są
these = to
they = oni, one
thick = gruby
thief = złodziej
thimble = naparstek
thing = rzecz, przedmiot, obiekt
think = mniemaæ, śadzieæ, myśleæ, przemyśleæ
think about = przemyśleæ
thirsty = spragniony
this = to, ten
this here = to
this way = w ten sposób
those = tamto
thou = ty, pan, pani, panna, wy
though = choæ
thought = myśl
thousand = tysiąc
three = trzy
thrifty = oszczêdny
throat = gardło
through = za pomocą, gotowy, przez, na wskroś
throw = rzucaæ
Thursday = czwartek
thus = przeto, wiêc, zatem, w ten sposób
ticket = bilet
tidbit = smakołyk
tidy = porządkowaæ
tie = krawat, wiązaæ, łączyæ
tie up = wiązaæ, łączyæ
till = do, aż do
time = raz, godzina, czas
time off = urlop, wczasy
tired = zmêczony
title = tytuł
to = ku, do
today = dzisiaj
together = razem
tomato = pomidor
tomorrow = jutro
tone = tona
tongue = jêzyk
too = także, też, również, za, zbyt, zbytnio
tool = narzêdzie, instrument, przyrząd
too much = za, zbyt, zbytnio
tooth = ząb
toothache = ból zêba
topic = temat
torment = zamêczaæ
to some extent = trochê, ileś
to tell the truth = prawdê mówiąc
tourist = turysta
toward = ku, do
towards = ku, do, wokół, dookoła, około
towel = rêcznik
town = miasto
toy = zabawka
trade = handel
tradition = tradycja
traditional = tradycyjny
traffic = ruch
tragic = tragiczny
train = pociąg
tram = tramwaj
tranquil = spokojny
transfer = przejśæ, zmieniæ miejsce
translate = tłumaczyæ
transmit = posyłaæ
transport = przenosiæ
travel = jechaæ
treasure = skarb
treat = leczyæ
tree = drzewo
tremble = drżeæ
trip = podróż
trouble = problem, krêpowaæ, przeszkadzaæ
troublesome = żenujący, krêpujący
trousers = spodnie
truly = rzeczywiście
truth = prawda
try = próbowaæ
Tuesday = wtorek
tulip = tulipan
Turk = Turek
turn = obróciæ
turn around = obróciæ
turn on = włączaæ
turn round = obróciæ
TV = telewizja
TV set = telewizor
twenty = dwadzieścia
twin = bliźniak
twist = twist
two = dwa
two hundred = dwieście
type = pisaæ na maszynie
typewriter = maszyna do pisania
ugly = brzydki
ultimately = w koñcu
umbrella = parasol
uncle = stryj, wujek, wuj
under = pod
underground = podziemny
underneath = pod, pod spodem, na spodzie
understand = rozumieæ
undertake = staraæ siê
undoubtedly = niewątpliwie
undress = rozebraæ
unfortunately = niestety
unite = połączyæ
United States of America = Stany Zjednoczone
university = uniwersytet
unkind = nieuprzejmy
unmarried woman = panna
unpleasant = nieuprzejmy
until = do, aż do
up = do góry, w górê
uphill = do góry, w górê
upon = przeciw, naprzeciw, w zamian, o, na
upper-arm = nadramiê
upper arm = nadramiê
upstairs = na górze, u góry
upwards = do góry, w górê
urge = ponaglaæ, byæ pilnym
urgently = pilnie
USA = Stany Zjednoczone
US citizen = Amerykanin
use = używaæ
useless = daremny
usual = zwykły
usually = zwykle
utter = wydobyæ
vacation = urlop, wczasy
vain = daremny
valiant = odważny, śmiały
valise = walizka
valley = dolina
value = wartośæ
vapor = para, opar
vapour = para, opar
variable = zmienny, urozmaicony
varied = różny, rozmaity
various = różny, rozmaity
veiled = skryty
vend = sprzedawaæ
verbatim = dosłownie
very = bardzo, nader
very much = bardzo, nader
vessel = pojemnik, naczynie, statek
vice-versa = odwrotnie
vicious = złośliwy
victory = zwyciêstwo
view = panorama, patrzeæ, widok
viewpoint = punkt widzenia
vigour = siła, moc
village = wieś
violet = fiołek
violin = skrzypce
virtuoso = wirtuoz
visible = widoczny
visit = wizyta, odwiedziny
visit regularly = uczêszczaæ
vitamin = witamina
viz. = mianowicie
vocabulary = słownik
voluntary = chêtny
voyage = podróż
waggon = wagon
wait = czekaæ
2. doczekaæ siê
waiter = kelner
wait for = czekaæ
2. doczekaæ siê
waiting-room = poczekalnia
waiting room = poczekalnia
wall = ściana, mur
wallet = portfel
waltz = walc
wander = włóczyæ siê
want = życzenie, pragnienie, chcieæ
war = wojna
warehouse = magazyn, duży sklep, dom towarowy
wares = towar
warm = serdeczny, ciepły
warmly = ciepło
warning = ostrzeżenie
warrant = gwarantowaæ
Warsaw = Warszawa
wash = myæ
watch = zegarek, zegar, patrzeæ
watch out for = uważaæ, zwracaæ uwagê
watchword = dewiza, zasada postêpowania, waluta
water = woda
way = zwyczaj
weak = słaby
weakly = słabo
wealthy = bogaty
wear = nieśæ, nosiæ
weather = pogoda
wed = ożeniæ, wydaæ za mąż
Wednesday = środa
week = tydzieñ
weep = płakaæ
weigh = ważyæ, mieæ ciêżar, ważyæ
weight = odważnik
welcome = witaæ
well = dobrze, kałamarz, no, zdrów, zdrowy
well-off = bogaty
well then = no
west = zachód
wet = mokry
wharf = peron
what = co
what a = jaki, jak
what for = dlaczego
what kind of = jaki
what number = który
what's more = zresztą
what sort of = jaki
when = gdy, kiedy
whence = skąd
where = gdzie
whereas = podczas, gdy
which = kto, który
which one's = czyj, którego
while = podczas, gdy, czas
whilst = podczas, gdy
white = biały
who = kto
whole = całkowity, całośæ
wholly = zupełnie
whose = czyj, którego
why = dlaczego
wife = żona
willing = chêtny
willingly = chêtnie
win = zarabiaæ
wind = wiatr
window = okno
wind up = napinaæ
wine = wino
winter = zimowy, zima
winter- = zimowy
wireless = radio
wise = mądry
wisely = mądrze
wish = pragnąæ, życzyæ, życzenie, pragnienie, chcieæ
with = z, za pomocą
with difficulty = trudno
within = w
without = bez
without fail = koniecznie
withstand = przeciwstawiaæ siê
with wisdom = mądrze
witness = byæ obecni
witty = sprytny, dowcipny
woman = kobieta
wonder = dziwiæ siê
wonderful = cudowny, wspaniały
woods = las
word = słowo
word-for-word = dosłownie
work = działaæ, funkcjonowaæ, uruchamiaæ, pracowaæ, robota, praca, dzieło
worker = robotnik
working man = robotnik
workman = robotnik
work out = liczyæ
workplace = pracownia, zakład
world = świat
worry = troszczyæ siê, dbaæ
worth = wartośæ
worthy = godny
wrangle = kłóciæ siê
write = pisaæ, tworzyæ dzieło, pisaæ
writer = autor, pisarz
writing = pismo, dokument
wrong = niewłaściwy
ye = ty, pan, pani, panna, wy
year = rok
yellow = żółty
yes = tak
yesterday = wczoraj
yet = jeszcze, już, jednak
yon = tam
yonder = tam, tamten
you = ty, pan, pani, panna, wy
young = młody
youngster = młodzieniec
young woman = dziewczyna
your = twój, wasz
you're welcome = nie ma za co
youth = młodośæ, młodzieniec
Yule = Boże Narodzenie
Zaire = rzeka Kongo
zeal = zapał, gorliwośæ
zealous = gorliwy, zapalony
zero = zero
zilch = zero
