#setName = words_en_la_df
#sideOneTitle = ENG
#sideTwoTitle = LAT
dad = tata
daddy = tata
daffodil = narcissus
daft = cerritulus
dagger = parazonium, pugio
daily = cotidianus, cotidie
danger = periculum
dangerous = acutus
Danube = Hister
dare = audere
daring = ferocia
dark = ater, cæruleus, caligineus, caliginosus, obscurus, tenebricosus
dark blue = cæruleus
darkness = caligo, caligatio
darling = cicaro
darn = bombax
date = caryota, caryotis
daughter = filia
day = dies
dazzle = cæcare
dead = mortuus
dead-nettle = lamium
dear = carus
death = funus, letum, mors, obitus, Orcus
decapitate = carnificare
decide = censere
deem = credere, opinari, spectare
deep = profundus
deer = cervinus, cervus
deer- = cervinus
defecate = assidere, cacare
defend = defendere
deference = cæremonia, cærimonia
degree = titulus
deluge = cataclysmus
demand = exigere, postulare
demigod = heros, semideus
demigodess = heroine, herois
den = antrum, caverna
deny = abnuere, negare
deny oneself = abnegare
depart = abætere, abire, abitere, abscedere
depth = altum
desert = arena
desire = optare
despair = desperare, desperatio
despise = apolactizare
despot = dominus
despotic = tyrannicus
destroy = annihilare, annullare
devil = antitheus
devotion = cæremonia, cærimonia
diagram = figura
Diana = Diana
diary = commentarius
dictator = dictator
die = mori, alea, cubus
different = absimilis
dig = fodere
dill = anethum
dim = ater, cæruleus, caligineus, caliginosus, obscurus, tenebricosus
diminutive = parvus
direct = rectus
disappear = abolescere, aboriri, aborisci, abscedere
discover = reperire
disease = ægritudo, ægror, morbus
dish = catinus, tryblium
dismal = abominabilis, abiectus, acidus, amarus
dismiss = ablegare, amandare, relegare
disobedient = inobsequens
dispose of = vendere
district = regio, vicus
ditch = fossa
divide = abiungere, abrumpere, segregare, seiungere
divine = cælestis, dius, divus, sacer, sanctus
do = facere
do away with = relegare
dock = lapathum, rumex
doctor = clinicus, medicus
doe = cerva
dog = canis
dogberry = cornum, cornus
doll = pupa
dolphin = delphin
donkey = asinarius, asininus, asinus
donkey- = asinarius, asininus
donkey-driver = agaso, asinarius, onagus
door = ianua
doorwoman = ianitrix
doubt = dubitare, addubitare, dubium
dove = columbula, columba
dragon = draco, serpens
draw = æquabilitas
dreary = abominabilis, acidus, amarus
dress = vestire
drink = bibere
drinkable = bibilis
drive away = abigere
dromedary = camelus
droop = pendere
drop = cadere, cædere
drunk = appotus
dry = assiccare
duck = anatinus, anatina, anas
duck- = anatinus
duck meat = anatina
duck's = anatinus
dull = brutus
dung = merda
during = dum
during the night = noctu
dusk = crepusculum
dust = pulvis
dwell = colere, habitare
dwelling = atrium
dye = color
each = omnis
eagle = aquila
ear = auris, auricilla, auricula, arista
ear-drop = tribacca
earlobe = auricilla, auricula
earn back = reparare
earring = tribacca
earth = humus, tellus, terra
earthquake = ostes, tremor
earthworm = lumbricus
easily = facile
easy = facilis
Ebro = Hiberus
edge = labrum, limbus, ora
edging = labrum, limbus, ora
education = catechesis
eel = anguilla
effort = opera
egg = ovum
eight = octo
eighteen = duodeviginti
eighth = octavus
eighty = octoginta
elbow = ancon
elder = sambucus
elect = optare
elegy = ælinos
element = elementa, basis
elements = abecedarium
elephant = barrinus, barrus, elephantus
elephant- = barrinus
elephantine = barrinus
elephant's = barrinus
eleven = undecim
elk = alces
else = alius
elsewhere = alibi
emerge = apparere, comparere
emmet = formica
emperor = dominus, imperator
employ = uti
empty = inanis, vacuus
enchanter = magus
enchantment = magia
end = finis
ending = finis
endive = cichorium
end up = advenire, pervenire
endure = patiri, tolerare
enemy = colluctator, hostis
engine = machina
enigma = ænigma, griphus
enigmatic character = ænigma
enjoyable = acceptabilis
enlargement = accretio
ennumeration = catalogus
enough = satis
entire = universus
entrée = antecenium
equal = æquus, par
equality = æquabilitas
equestrian = caballinus, canterinus
equilibrium = æquilibrium
err = errare
errand = nuntius
error = error
especially = potissimum
essay = thesis
estate = vicus, villa
estimate = æstimare, appretiare, censere, taxare
estuary = bracchium
eternal = æternalis, æternus
eternity = æternitas, ævum, ævitas
ether = æther
Ethiopian = Æthiops
Etruria = Etruria
eunuch = castratus
Europa = Europa
Europe = Europa
Euxine Sea = Pontus, Pontus Axenus
evade = vitare
even = æquus, planus, par
evening = vesper
Evening Star = Cytherea, Venus
event = occasio
ever = semper
ever since = a, ab, abs
every = omnis
everybody = omnis
every one = omnis
everywhere = perubique
exceed = antepollere, antestare, antevenire, superare
except = absque
exclusively = modo, solum, tantum
excommunication = anathema
excrement = merda
executioner = carnifex
exhale = exhalare
exhortation = admonitus
expel = abigere
expert = artifex
expire = mori
expurgate = castificare
extensive = amplus, capax, latus
eye = oculus
fabric = tela, textile, textura, textus
face = facies, vultus
facile = facilis
failure = abortus
faint = æger
fair = forum
faith = fides
fall = cadere, casus
fall ill = ægrescere
false = falsus
false step = casus
fame = fama, gloria
family = familia, gens
famine = fames
famous = famosus
farewell = ave
farm = vicus, villa
farmer = colonus, cultor, agoris
farming = agricultura, agricultio
farmland = arvum
fast = firmus
fat = carnatus, crassus, obesus, pinguis, arvina
father = pater
father-in-law = socer
fatherland = patria
fatherless = apator
fatty = crassus, pinguis
fault = crimen, culpa
favour = favere, faventia, favor
favourable = faustus
favourite = favea
fear = timere
February = Februarius
feed = alere, nutrire
feel = sentire
fellow = vir
female = femineus, femininus
female angel = angela
female martyr = martyria
female panther = pardalis
female pigeon = columbula
female singer = cantrix
female slave = ancilla, serva
female stranger = hospita
female thief = fur
feminine = femineus, femininus
fennel = feniculum
fertile = fecundus
festival = festum
fetch = adducere, ferre
fever = febris
fewer = minus
fiber = fibra
fibre = fibra
field = ager, arvum
fifteen = quindecim
fifth = quintus
fifty = quinquaginta
fig = ficus
fight = battuere, dimicare, fendere, pugnare
fighting cock = cicirrus
fig-tree = ficus
figure = figura, calculare
file = limare, lima
fill = opplere
fillet = fascia
fill in = opplere
fill up = opplere
find = reperire
fine = formosus, pulcher, cardinalis
finger = digitus
fir = abies
fire = ignis, incendium
firebox = caminus
fire on the hearth = caminus
firm = firmus, solidus
first = primus
first name = prænomen
firth = bracchium
fish = piscis
fishing rod = arundo, calamus
fist = pugnus
fit = apoplexia
fitness = capacitas
five = quinque
fix = reparare
flame = flamma
flamingo = phoenicopterus
flat = æquus, planus
flax = linum
flee = profugere
flee back = refugere
flesh = caro, corpus
flight = fuga
flint = silex
float = nare, natare
flock = grex
flood = cataclysmus
flow = fluere, amnis
flower = flos
flow towards = affluere
fly = volare, musca
fly away = avolare
fog = caligo
fold = plicare, ovile
folk = plebs, populus
follow = sequi
fondle = admulcere, adulare
fool = baceolus
foolish = demens, stultus, bardus, blennus
foot = pes
for = dum, quia, quod
forbid = prohibire, vetare
force = coercere, cervix, ops, vis
forefather = abavus, avus
forehead = frons
foreign = advena, adventicius, alienigenus, allophylus, barbarus, bracatus, hospitus
foreign country = barbaria, barbaries
foreigner = advena, barbarus, hospes
foreign lady = advena
foreign woman = advena
foreleg = antepes
forest = lustrum, silva
forest path = callis
form = facies, forma
formerly = ante, antehac
for the rest = ceterum
fortification = castellum, castrum
fortune = fortuna
forty = quadraginta
foundation = basis
four = quattuor
fourteen = quattuordecim
fourth = quartus
fowl = gallina
fox = vulpes
fragment = fragmentum
free = liber
freezing cold = gelu
frequently = sæpe
friend = amica, amicus, cultor
friendly = comis, lepidus, amicus
friendship = amicitia, hospitium
fringe = labrum, limbus, ora
frog = rana
from = a, ab, abs, e, ex
from where = unde
frontier = finis, limes, ora
front paw = antepes
frost = gelu
fruit = fructus, pomum
fruitful = fecundus
fruit-tree = pomum, pomus
full = plenus
function = officium
fund = fiscus
fungus = fungus
furnace = caminus
futile = vanus
fuzzy = caliginosus