#setName = words_en_es_ss
#sideOneTitle = ENG
#sideTwoTitle = SPA
sack = despedir, bolso
sacrifice = ofrecer, presentar
sad = afligido, triste
sadness = tristeza
safety = seguridad
safety-pin = imperdible
safety pin = imperdible
sage = salvia
Sahara = Sahara
sailor = marinero
saint = santa, santo
salad = ensalada
salary = salario
sale = consumo, despacho, salida, deducción, venta
sales activity = mercado, mercado de consumo
salesman = vendedor
saleswoman = dependienta, vendedora
sallow = pálido
salmon = salmón
salted meat = carne salada
salt meat = carne salada
salutation = acogida, saludo
salute = acoger, saludar
sand = arena
sandal = sandalia
sandwich = bocadillo, sandwich
sap = jugo, zumo
Sardina = Cerdeña
Sardinia = Cerdeña
Sassenach = inglés
Satan = Satán, Satanás
satisfied = contento
satisfy = complacer
sauce = salsa
saucepan = cacerola
saucer = platillo
savage = fiero
save = guardar, salvar
Saviour = Redentor, Salvador
saw = sierra
Saxe = Sajonia
Saxon = sajón
Saxony = Sajonia
say = decir
say goodbye = despedirse
say goodbye to = despedirse
say yes = asentir, confirmar
scale = incrustación, escama, ascender, escalar, subir a
scale off = desconcharse
scales = balanza
scandal = escandálo
Scandinavia = Escandinavia
scarcely = apenas
scare = espantar
scatter = derramar
scenery = paisaje
scent = olor
schedule = horario
Scheldt = Escalda
scheme = propósito
school = escuela
science = ciencia
scientist = hombre de ciencia
scissors = tijeras
scold = exhortar, requerir, censurar, desaprobar, reprender, reprobar
scooter = patinete
Scot = escocés
Scotland = Escocia
Scotsman = escocés
Scottish = escocés
scratch = rascar
scream = gritar
screw = atornillar, tornillo
screwdriver = destornillador
scrupulous = escrupuloso, meticuloso
scuffle = batalla
sculptor = escultor
scythe = guadaña
sea = mar
sea-dog = foca
seagull = gaviota
seal = foca
seam = costura
seaside = costa
season = estación, temporada
seat = asiento, sitio
secede = desertar
second = segundo
second cousin = primo segundo
secondhand = de segunda mano
second hand = de segunda mano
secret = secreto
secretion = secreción
sect = secta
section = departamento, sección
secure = fijar
security = dinero del embase, seguridad
see = hallar, encontrar, ver, visitar, cuidar
seek = buscar
seem = parecer
seemly = conveniente
seize = asir, coger
seized with emotion = conmovido
seizure = apoplejía
seldom = raramente
self-interested = egoísta
selfish = egoísta
selfless = afectuoso
self-possessed = dueño de sí mismo
sell = vender
send = despachar, difundir, enviar
sender = remitente
send off = despachar, enviar, expedir
sensation = sentimiento
sense = inteligencia, sentir
sensitive = sensible
sentence = frase, condenar
separate = aparte, particular, separado, apartar, segregar, separar, compartir, dividir
separately = aparte, por separado
separation = separación, aislamiento, retiro
sepia = calamar
September = septiembre
serene = sereno
series = serie
serious = grave, importante, crítico, serio
serpent = serpiente
servant = criada
serve = servir
service = culto, servicio
service charge = servicio
set = aparato, grupo, trinquete, serie
set a trap = acechar
set a trap for = acechar
set conditions = estipular
settle = despachar
settlement = colonia
seven = siete
seventeen = diez y siete
seventh = séptimo
several = varios
several times = a veces
severe = áspero, inclemente, severo
sew = pegar, coser
sewer = cloaca
sew on = pegar
shack = barraca, cobertizo, cabana
shade = sombra
shadow = sombra
shallow = de poca profundidad, somero
shame = uf, vergüenza
shampoo = champú
shanty = barraca, cobertizo
share = acción, compartir, dividir, parte, pieza, ración
shareholder = accionista
shark = tiburón
sharp = afilado, agudo, justamente
shave = afeitar
shaving-brush = brocha de afeitar
shawl = chal
she = ella
shear = cortar
she-bear = osa
shed = barraca, cobertizo, cabina, granero, puesto, derramar
sheep = oveja
sheet = hoja, sábana, lámina, libra
sheet metal = hojalata
shelf = tabla
shell = concha, cáscara
shelter = guardar
she-wolf = loba
shifting spanner = llave inglesa
shine = brillar, lucir
ship = despachar, enviar, expedir, barco, embarcación
shirt = camisa, camiseta
shiver = tremblar
shock-absorber = amortiguador
shoe = zapato
shoe-horn = calzador
shoe-lace = cordón
shoe-lift = calzador
shoemaker = zapatero
shoot = tirar
shoot dead = fusilar
shop = tienda, hacer las compras
shore = orilla, costa
short = corto
shortage = falta
short circuit = cortacircuito
shortcoming = falta
shorten = abreviar, acortar
shortness of breath = asma
short pants = pantalón corto
shorts = pantalón corto
short-sighted = miope
should = tener que
shoulder = lisera, hombro
shout = gritar, grito
shovel = pala
show = designar, enseñar, indicar, mostrar
shower = ducha
show window = escaparate
Shrove-Tuesday = martes de carnestolendas
shrub = arbusto
shut = cerrar, cerrado
shut off = parar
Siberia = Siberia
Siberian = siberiana, siberiano
siblings = hermanos
side = lado, partido
sideboard = armario
side-issue = apéndice
sidewalk = acera
side-way = carretera secundaria
side-whiskers = patillas
siege = asedio, sitio
sigh = suspirar
sight = aspecto, vista
sightseeing trip = excursión
sign = agüero, prueba, señal, seña, firmar
signal = señal, seña
signalman = guardavía
signature = firma
signify = significar
silence = silencio
silver = plata
similar = semejante
simple = sencillo, simple
since = de, desde, porque, puesto que, ya que
sincere = sincero
sing = cantar
singer = cantora, cantor
single = soltero
sink = bucear
sir = caballero, señor
sister = hermana
sit = estar sentado
sit down = sentarse
six = seis
sixteen = diez y seis
sixth = sexto
sixty = sesenta
sizable = considerable, notable
size = tamaño
skate = patinar
skeleton = esqueleto
ski = esquiar, esquí
skilful = experto, hábil
skilfulness = agilidad, destreza
skill = agilidad, destreza
skilled = experto, hábil
skillful = experto, hábil, ágil, diestro
skillfulness = agilidad, destreza
skim = desnatar
skin = piel
skirt = falda
skull = cráneo
sky = cielo
sky blue = azul
slab = lámina, libra
slander = calumniar, infamar
slanting = inclinado
slat = tabla
slaughter = matar
Slav = eslavo
Slavic = eslavo
slay = matar
sledge = endrino
sleep = dormir, sueño
sleeping-accomodation = cama
sleeping-car = coche-cama
sleeping-place = cama
sleeve = manga
sleigh = endrino
slender = fino
slice = filete, tajada, trozo, cortar
slime = barro
slipper = zapatilla
slope = cuesta
slow = lento
slug = babosa
sluice = esclusa
slum = barrio bajo
slumber = echar la siesta
small = chico, pequeño
small-minded = mezquino
smell = apestar, oler mal, oler
smell bad = apestar, oler mal
smell of = oler a
smile = sonreír, sonrisa
smoke = fumar, humear
smoked = ahumado
smokers = departamento de fumar
smooth = liso, plano
snack = almuerzo
snail = caracol, arroba
snake = serpiente
snap at = dar dentelladas a
snare = astucia
snarl at = dar dentelladas a
sneeze = estornudar
snifter = aperitivo
snore = roncar
snorter = aperitivo
snow = nevar, nieve
snowflake = copo de nieve
snowy = nevado
snub = dar dentelladas a
so = para que, así
society = club
sock = calcetín
sofa = canapé
soft = dulce, tierno
soil = tierra
soiled = sucio
sole = planta, suela, solo, único, lenguado
sole agent = representante exclusivo
solely = no ... mas que, solamente, sólo
solicitor = abogado
solid = fuerte, sólido
soliloquy = monólogo
solitary = solo, único
so long = hasta luego, hasta la vista
solve = resolver
somber = afligido, triste
some = bastante, poco, alguien, alguno, cierto, unas, unos
somebody = alguien, alguno, cierto
someone = alguien, alguno, cierto
some one = alguien, alguno, cierto
something = algo
something new = noticias
sometimes = a veces
somewhat = bastante, poco
son = hijo
song = canción
son-in-law = yerno
soon = luego, pronto
soothe = calmar, sosegar
sore = úlcera
sorrow = tristeza
sort = clase, especie, suerte
so so = así así
so that = para que
so to speak = por decirlo así
soul = alma
sound = tocar, ruido, sonido
soup = sopa
sour = agrio, bronco, brusko
source = fuente
south = sur
South Africa = África del Sur
South African = sudafricano
South America = América del Sur, América meridional
South American = sudamericano
souvenir = recuerdo
Soviet Union = Unión soviética
sow = cerda, cochina, sembrar
spa = aguas, balneario, estación balnearia
space = espacio
spaceman = astronauta
spade = cavar
Spain = España
Spaniard = español
Spanish = español
Spanish language = español
Spanish woman = española
spanner = llave
spark = chispa
spark plug = bujía
sparrow = gorrión
spawn = huevas
speak = hablar
special = aparte, particular, separado, especial
spectacles = gafas
speechless = mudo
speed = prisa, velocidad
speedy = rápido
spell = deletrear
spend = gastar, alargar, entregar, llegar, pasar
spice = especia
spider = araña
spiked = puntiagudo
spinach = espinaca
spine = espina dorsal
spinster = solterona
spirits = alcohol
spit = escupir
splinter = astilla
split = fender, henderse, resquebrajarse
spoil = deteriorar, corromper, echar a perder, consentir, mimar
sponge = esponja
spoon = cuchara
sport = deporte
sports ground = campo deportivo
sports shirt = camisa de deporte
spot = sitio, mancha, punto
spring = fuente, primavera, muelle, saltar
springtime = primavera
spur = espolear
spur on = animar, espolear, incitar, inpulsar
square = cuadro, plaza
square decametre = grupo
squeeze = apretar
squirrel = ardilla
stab = picar
stable = fijo, cuadra, establo
staid = serio
staircase = escalera
stairs = escalera
stake = poste
stale = manido, oprimido, redicho, trillado
stall = cuadra, establo
stallion = caballo padre
stamp = sello, sello de correos, sellar, timbrar
stanchion = poste
stand = cabina, granero, puesto, levantarse, estar de pie
standard = bandera, estandarte
stand up = levantarse
stand up to = oponerse
star = estrella
start = poner, instigar, maquinar, comenzar, decentar, empezar, enteblar, principiar, comienzo, origen, principio, arrancar
starting point = punto de partida, punto inicial, enlace, punto de contacto
start running = arrancar
state = declarar, estado
statement = declaración
statement of policy = programa
station = estación
stationer's shop = papelería
statue = estatua
stay = alojarse, quedarse, restar
stay for = aguardar, esperar
stay on = quedarse atrás, tardar
stay over = quedarse, restar
stay with = alojarse
steak = bife, biftec, bisté, bistec
steal = robar
steamship = barco de vapor
steel = ballena, acero
steep = escarpado
steer = mandar
steering-wheel = volante
stem = tronco
stench = mal olor
stenotypist = mecanógrafa
step = paso
stern = popa
stew = estofado de carne húngaro
stewardess = azafata
stick = palo, pegar
stick to the pan = quemarse
stiff = rigido
stiffling = oprimido
still = aún, todavia, calmar, sosegar
stimulate = instigar, animar, espolear, incitar, inpulsar, estimular
sting = picar, aguijón
stink = oler mal, apestar
stipulate = estipular
stipulation = condición
stir = conmover
stir up = instigar, animar, incitar, espolear, estimular
stocking = media
stodgy = aburrido
stoke = calentar
stomach = estómago
stone = piedra
stone-chippings = cascajo
stop = alojarse, parada, parar
storage battery = acumulador
store = tienda
storey = piso
storm = tempestad, tormenta
story = piso, historia
stove = estufa
straggler = rezagado
straigh ahead = seguido
straight = derecho
straight ahead = seguido
straight along = seguido
straightforward = sencillo, simple
strait = estrecho
Strait of Gibraltar = Estrecho de Gibraltar
Strasbourg = Estrasburgo
strawberry = fresa
stray from one's subject = digresar
stray off = extraviarse
stream = corriente, arroyo
strecher = andas, camilla
strech out = alargar
street = calle
streetcar = tranvía
strength = fuerza, virtud
stress = acentuar, acento
strict = áspero, inclemente, severo
stride = paso
strike = golpear, llamar, declararse en huelga, huelga, acertar
string = mondar habas, cuerda
strip = raya
stripe = raya
stroke = apoplejía, acariciar, caricia
stroke of apoplexy = apoplejía
strong = fuerte
strong drink = alcohol
struggle = batalla
student = estudiante
study = estudiar, estudio
stun = aturdir
stupefy = aturdir
stupid = zote
sturdy = fuerte, sólido
sturgeon = sollo
sty = cuadra, establo
subject to = salvo
subjunctive = modo subjuntivo
subscribe = abonarse, suscribirse
subscriber = abonado, subscriptor, suscriptor
subscribe to = abonarse, suscribirse
subscription = abono, subscripción, suscripción, cuota
subsequently = después, luego, más adelante
subside = calmarse, sosegarse
substantive = substantivo
substitute = substituir
substitution = relevo
subtract = sustraer
subway = metro
succeed = conseguir, tener éxito
successor = descendiente
such = tal, así
such a = a título de, como, tal
such as = a título de, como, si
suck = chupar
suction apparatus = campana
suddenly = de golpe, de repente, de sopetón
sue = poner pleito a
suffice = bastar
sufficient = bastante
sufficiently = bastante
suffocate = sofocar
sugar = azúcar
sugarbowl = azucarero
sugar-bowl = azucarero
suggest = designar, enseñar, indicar, proponer
suit = convenir, traje
suitability = capacidad, disposición
suitable = conveniente
suitcase = maleta, maleta de mano
sultry = oprimido
sum = cantidad, importe, suma
summer = verano
summery = resumen
summit = punta, superficie
summon = notificar, llamar
sum up = sumar
sun = sol
Sunday = domingo
sun-glasses = gafas oscuras
sunrise = salida del sol
sunset = puesta del sol
superficial = de poca profundidad, somero
super highway = autovía
superior = jefe
supermarket = supermercado
superscription = título
supersign = acento
supervise = controlar, registrar, revisar
supper = cena
supplement = cumplimiento, relleno, suplemento
supplication = oración, ruego
supply = aprovisionamiento, entregar
support = respaldo, sostener
supporter = partidario
supporters = partido
suppose = asumir, suponer
supposing that = dado que
suppress = oprimir, sofocar
sure = cierto
surface = superficie
surgeon = cirujano
Surinam = Surinam
surly = bronco, brusko
surmise = asumir, suponer
surname = apellido
surpass = aventajar
surprise = sorprender, sorpresa
surrender = capitular
surroundings = alrededores
suspect = sospechar
suspenders = tirantes
suspicion = recelo, recelocaz, sospecha
suspicious = receloso, suspicaz
sustain = sostener
sustained = continuo
swaddling cloth = pañal
swallow = tragar, golondrina
swallow up = tomar, tragar
swamp = terreno pantanoso
swap = cambiar
swear = jurar
swear off = abjurar
sweat = sudar, transpirar, sudor
Swede = sueco
Sweden = Suecia
Swedish = sueco
sweep = barrer
sweeper = barrendero
sweet = dulce
sweet-and-sour = agridulce
sweetheart = querido, novio
sweet potato = batata, boniato, camote
swift = rápido
swiftly = de prisa, pronto
swim = nadar
swimming-bath = piscina
swimming-pool = piscina
swimming trunks = bañador
swindle = embuste, engaño
swine = cerdo
swing = balancear
Swiss = suizo
switch = interruptor
switch off = parar
switch on = arrancar, poner
Switzerland = Suiza
swoon = desmayarse, desmayo
syrup = almíbar
system = sistema