#setName = words_en_it_qs
#sideOneTitle = ENG
#sideTwoTitle = ITA
quarter = circondario, distretto
quarter of an hour = quarto d'ora
quash = distruggere
quay = piattaforma
quell = soffocare
question = domanda, contestare, disputare
quickly = presto
quiet = calmare, placare
quit = abbandonare
quite = abbastanza, assai, molto
quiver = tremare
quotation = citazione
quotation marks = virgolette
quote = citare
quotes = virgolette
rabbit = coniglio
rabid = rabbioso
race = razza
radiation = radioterapia
radio = radio
radish = ravanello
radius = radio, sciopero
ragout = cibreo
railing = parapetto
railroad = ferrovia
railway = ferrovia
railway carriage = vagone, vettura
rain = piovere, pioggia
rainbow = arcobaleno
raise = alzare
ranch = fattoria
rand = orlo
rapier = spada
rare = raro
raspberry = lampone
rat = topo
rate = apprezzare, stimare, valutare
rather = piuttosto, abbastanza
raven = corvo
raw = crudo
ray = sciopero
reach = arrivare
react = reagire
read = leggere
ready = pronto
real = reale
reality = verità
realize = capire, comprendere
really = davvero, infatti
rear = retroguardia
rearguard = retroguardia
rear-lamp = luce di posizione, fanale posteriore
rear-light = luce di posizione, fanale posteriore
reason = causa, ragione
reasonable = sensato
rebuke = biasimare, disapprovare, riprendere
receipt = ricevuta
receive = accettare, accogliere, ricevere
recent = fresco
recently = recentemente
recess = alcova
recipient = destinario
recite = recitare
recognize = riconoscere
recollection = memoria
recommend = raccomandare, vantare
recommendable = raccomandabile
recommendation = raccomandazione
recruit = arruolare, ingaggiare
red = rosso
redeemable = rimborsabile, estinguibile
redemption = ammortizzamento
reduce the price = respingere
reek = sentire
referee = arbitro
refined = delicato
refusal = rifiuto
refuse = rifiutarsi
regard = considerazione, stima, riguardo, rispetto, considerare, guardare
register = raccomandare, vantare
regret = rincrescere
regular = regolare
regularly = frequentemente, sovente, spesso
regulation = regola
reject = rifiutare, rifiutarsi
relate = raccontare
related = congiunto, parento
related by marriage = imparentato
relation = relazione
relations = parentado
relationship = parentado, parentela
relative = parente, relativo
relatives = parentado
release = liberare
relinquish = cedere
remain = resti dietro, stare, restare, rimanere
remit = annullare
remote = isolato, distante, lontano
remote control = telecomando
rendezvous = appuntamento
rent out = affittare
repair = riparare
repayable = rimborsabile, estinguibile
repeat = ripetere
repentance = pentimento, rimpianto
repentant = pentito
reply = replicare, rispondere, risposta
report = informare, insegnare, annunciare, comunicare, annunzio, comunicato
repose = riposarsi, riposo
represent = rappresentare
representation = figura
representative = delegato, deputato
reproach = riprendere
reprove = riprendere
republic = repubblica
request = chiedere
require = aver bisogno di
rescue = salvare
resemble = rassomiglare
reserve = ordinare, riservare
residence = residenza, alloggio, appartamento
respect = rispettare, rispetto
respectable = onorevole, rispettabile
respiration = respirazione
respond = reagire, replicare, rispondere
responsible = responsabile
rest = riposarsi, riposo
restaurant = ristorante
restrain = dominare, governare
restrict = limitare, restringere
result = discendere, risultato, esito
resumé = sommario
retain = ritenere
retardation = ritardo
retarded = deficiente
retention = conservazione, preservazione
return = restituire, ritornare, rivenire
return-ticket = biglietto d'andata e ritorno
reveal = pubblicare
revenge = vendetta
revue = rivista
reward = ricompensare, ricompensa
Rhine = Reno
Rhine barge = chiatta
Rhineland = Renania
rhino = rinoceronte
rhinoceros = rinoceronte
rib = costola
ribbon = nastro
rice = riso
rich = ricco
rickety = decrepito
ride = camminare
ridiculous = ridicolo
rifle = fucile
right = destro, corretto, diritto
right away = fra poco, immediatamente, subito
righthand = destro
right-hand side = destra
right now = fra poco, immediatamente, subito
rigid = rigido
rim = orlo
ring = anello
riotous = dissoluto, licenzioso
ripe = maturo
rise = alzarsi, salire
risk = arrischiare,. rischio
river = fiume
road = cammino, corsia, pista, strada, via
roar = muggire
rob = derubare
robe = abito
rock = roccia
rod = barra
roll = panino
roll-call = chiamata
roller = cilindro
roller-blind = persiana
Roman = romano, romanzo
Rome = Roma
roof = tetto
room = spazio, camera
rooster = gallo
rough = crudo, brusco, rude
round = rotondo, arrotondare, intorno a
round off = arrotondare
rouse = incitare, spronare, stimolare
route = cammino, corsia, pista, strada, via
rubber = gomma
rubbish = macerie
rudder = remo
rude = rozzo, scortese
rudiments = alfabeto
ruin = rovinare
rule = dominare, governare, regola
rump = sedere
run = fuga, correre
run across = colpire
run away = fuggire
rush = affrettarsi
Russia = Russia
Russian = russo
rusty = arrugginito
rye = segale
Sabbath = sabato
sack = borsa
sacrifice = offrire
sad = afflitto, triste
sadness = tristezza
safety = sicurezza
sagacious = saggio
sage = salvia, saggio
sail = vela
sailor = marinaio
salad = insalata
salary = paga, salario
sale = smercio, vendita
sales activity = sbocco
sallow = pallido
salmon = salmone
salon = salotto
salt = sale
salute = salutare
sample = campione
sand = sabbia
Sardina = Sardegna
Sardinia = Sardegna
Sassenach = inglese
Satan = Satana
satisfied = contento
Saturday = sabato
sauce = salsa
saucepan = casseruola
saucer = piattino
Saudi Arabia = Arabia Saudita
sausage = salsiccia
savage = selvaggio
save = salvare
saw = sega
say = dire
say goodbye = dire addio
say goodbye to = dire addio
say yes = affermare
scale = squama
scales = bilancia
scandal = scandalo, maldicenza
scarcely = appena
scare = impaurire, spaventare
scatter = versare
schedule = orario
scheme = progetto
scholar = dotto, erudito, allievo, scolaro
school = scuola
science = scienza
scientist = scienziato
scissors = forbici
scold = riprendere
Scot = scozzese
Scotland = Scozia
Scotsman = scozzese
scratch = raschiare
scream = gridare
screen = schermo
screw = vite
screwdriver = cacciavite
scuffle = battaglia
sculptor = scultore
sculpture = scultura
scythe = falce
sea = mare
sea-dog = foca
seagull = gabbiano
seal = foca
seasickness = mal di mare
seaside = costa
season = stagione
seat = posto
second = secondo
second cousin = pronipote
secret = segreto
secretion = secrezione
section = divisione
secure = fissare
security = sicurezza
see = incontrare, vedere, visitare
seek = cercare
seem = parere
seemly = conveniente
seize = afferrare
seizure = apoplessia
seldom = raramente
self = stesso
self-conscious = timido
self-interested = egoistico
selfish = egoistico
sell = vendere
send = mandare
send about his business = imbarcare, sbrigarsi di
sensible = sensato
sensitive = sensibile
sentence = frase, condannare
separate = separato, separare, dividere
September = settembre
serious = grave, importante, serio
serpent = serpente
servant = servire
serve = servire
service = uffizio divino, servizio
set = apparecchio, gruppo
settlement = pareggiamento dei conti
seven = sette
seventeen = diciasette
seventh = settimo
seventy = settanta
several times = qualche volta, talvolta
severe = severo
sex = sesso
shack = baracca, capanna
shade = ombra
shadow = ombra
shaft = albero
shallow = basso
shame = vergogna
Shanghai = Sciangai
shanty = baracca
share = azione, dividere, spartire, parte, porzione
shareholder = azionista
shark = pescecane
sharp = acuto, affilato, aguzzo, appuntito, aspro, piccante, tagliente, giustamente, giusto
shave = far la barba
she = lei
shed = tettoia, baracca, granaio, versare
sheep = pecora
sheet = foglia, foglio, lenzuolo
sheet metal = latta
she-goat = capra
shelf = asse
shell = conchiglia
shelter = riparo, rifugio, riparare
shine = brillare, risplendere
shiver = tremare
shoe = scarpa
shoemaker = calzolaio
shoot dead = fucilare
shop = negozio
shore = costa
short = corto
shortage = mancanza
shortcoming = mancanza
shorten = abbreviare, accorciare
shortness of breath = asma
short-sighted = miope
shoulder = spalla
shout = gridare, grido
show = mostrare
shower = doccia
shrew = megera
shrub = arbusto
shut = chiudere, chiuso
shy = timido
Siam = Tailandia
Sicily = Sicilia
sick = malato
side = fianco, lato, partito
sideboard = armadio
side-whiskers = baffi
siege = assedio
sigh = sospirare
sight = apparenza, aria, aspetto, vista
sightless person = cieco
sign = augurio, prova, segno, firmare
signal = segno
signalman = cantoniere, casellante
signature = firma
signify = significare
silent = silenzioso
sill = soglia
silver = argento
similar = simile
simple = semplice
since = di, considerato che, visto che
sincere = sincero
sing = cantare
singer = cantante
sir = signore
sister = sorella
sister-in-law = cognata
sit = covare, essere seduto
sit down = sedersi
sitting-room = stanza, salotto
six = sei
sixteen = sedici
sixth = sesto
sixty = sessanta
sizable = considerevole, notevole, ragguardevole
size = grandezza
skeleton = scheletro
sketch = progettare, progetto
skilfulness = abilità, destrezza
skill = abilità, destrezza
skillful = abile, destro, lesto, sveglio
skillfulness = abilità, destrezza
skim = scremare
skimpy = magro
skin = pelle
skinny = magro
skull = cranio
sky = cielo
sky blue = azzurro
slander = calunniare, maldicenza
slay = ammazzare, uccidere
sleep = dormire, sonno
sleeping-car = vettura letti
slender = sottile
slice = tagliare
slime = fango
slug = lumaca
slum = quartiere popolare, rione popolare
small = piccolo
smell = sentire
smell of = sentire di
smile = sorridere, sorriso
smoke = fumare, fumo
smokers = fumatori
smokestack = fumaiuolo
smooth = piano, liscio
snail = chiocciola, chiocciolina
snake = serpente
snore = russare
snow = nevicare, neve
so = così
sober = sobrio
sobriquet = soprannome
social = sociale
society = compagnia
soft = dolce, molle
soil = insudiciare, sporcare, terra
sole = pianta, solo, sogliola
solely = non ... che, solamente, soltanto, unicamente
solicitor = avvocato
soliloquy = monologo
solitary = solo
so long = arrivederci
solve = risolvere
somber = afflitto, triste
sometimes = qualche volta, talvolta
somewhere = in qualche luogo
son = figlio, figliolo
song = canzone
son-in-law = genero
soon = fra poco
soothe = calmare, placare
sorrow = tristezza
sort = genere, specie
so so = così così
so to speak = per così dire
sound = sonare, suono
soup = minestra
sour = acido, agro, brusco, rude
source = fonte, sorgente
south = sud
South America = America del Sud
souvenir = memoria
sow = seminare
spa = bagni, stazione balneare
space = spazio
Spain = Spagna
Spaniard = spagnolo, spagnuolo
spanner = chiave
spark = scintilla
spark plug = candela
sparrow = passero
speak = parlare
special = separato, speciale
specimen = campione
spectacles = occhiali
speechless = muto
speed = velocità, andatura
speed up = accelerare
spell = compitare
spend = spendere, passare
sphere = sfera
spider = ragno
spiked = appuntato
spinach = spinaci
spindle = albero
spine = spina dorsale
spirit = spirito
spiritual = spirituale
spit = sputare
split = fendere
spoil = danneggiare
spoon = cucchiaio
sport = sport
spot = luogo, punto
spring = fonte, sorgente, primavera, molla, saltare
springtime = primavera
spy = spiare
squad = compagnia
square = quadrato, piazza
square decametre = gruppo
squeeze = premere, serrare, stringere
squirrel = scoiattolo
stab = pungere
stable = stabile, stalla
staid = serio
staircase = scala
stairs = scala
stale = trito e ritrito
stall = stalla
stamp = bollo, francobollo
stand = granaio, stare in piedi, alzarsi
standard = stendardo
stand up = alzarsi
stand up to = far fronte a, opporsi a
star = stella
stare = fissare
start = cominciare, inizio, principio
state = asserire, sostenere, stato
statement = dichiarazione
station = stazione
station-master = capostazione
statue = statua
stay = stare, restare, rimanere
stay on = resti dietro
stay over = stare, restare, rimanere
steak = bistecca
steal = rubare
steam-boiler = caldaia
steel = osso di balena, acciaio
steep = ripido
steering-wheel = timone, volante
stem = tronco
stenotypist = dattilografa
step = passo
step-brother = fratellastro
step-father = patrigno
step-mother = matrigno
step-sister = sorellastra
sterile = sterile
stern = poppa
stew = cibreo
stick = appiccicare
sticky = appiccicaticcio
stiff = rigido
still = ancora, calmare, placare
stimulate = incitare, spronare, stimolare
sting = pungere, aculeo, pungiglione
stingy = avaro
stir up = incitare, spronare, stimolare
Stockholm = Stoccolma
stoke = riscaldare
stomach = stomaco
stomach ache = mal di pancia
stone = pierra
stoop = curvarsi
stop = fermata,. Fermarsi, fermare, cessare, interrompere
storage battery = accumulatore
store = negozio
storey = piano
storm = tempesta
story = piano, storia
straggler = ritardatario
straight = destro
straightforward = semplice
strait = stretto
strange = strano
strawberry = fragola
stray off = perdersi, smarrirsi
stream = corrente, ruscello
strech = caricare
street = via
streetcar = tram
strength = forza
stress = accentare, accento
stretcher = barella
strict = severo
stride = passo
strike = battere, picchiare, fare sciopero, colpire
strike a balance = saldare
stroke = apoplessia, accarezzare
stroke of apoplexy = apoplessia
strong = forte
struggle = battaglia
stubborn = ostinato
student = studente
study = studiare
stupid = ignorante, sciocco, stupido
sty = stalla
subject to = eccetto, salvo
subject to tax = tassabile
subscriber = abbonato
subscription = abbonamento
subsequently = dietro, dopo
succeed = riuscire, succedere
success = successo
successor = discendente
such = così
such a = come
such as = come
suck = succhiare
suckle = allattare
sudden = subitaneo
suddenly = ad un tratto, improvvisamente
suffice = bastare
sufficient = sufficiente
sufficiently = abbastanza
suffix = suffisso
suffocate = soffocare
sugar = zucchero
suggest = indicare, mostrare, proporre
suggestion = suggerimento
suit = abito, costume
suitable = decente, conveniente, adatto, capace, idoneo, utilizzabile, utile
suitcase = valigia
sum = importo, somma
summer = estate
summery = sommario
summit = punta, cima
summon = chiamare
sun = sole
Sunday = domenica
sunrise = levar del sole
sunset = tramonto
superficial = basso
superior = superiore
superstition = superstizione
superstitious = superstizioso
supervise = controllare, verificare
supper = cena
supplication = domanda, preghiera
support = sostenere, poggiare, appoggiare
supporter = membro
supporters = partito, seguito
suppose = supporre
suppress = opprimere, soffocare
sure = certo
surface = cima, superficie
surgeon = chirurgo
surly = brusco, rude
surmise = supporre
surname = cognome
surprise = sorprendere, sorpresa
surrender = arrendersi
surround = circondare
surroundings = ambiente
suspect = sospettare
suspicion = sospetto
sustain = poggiare, appoggiare, sostenere
sustained = costante
swallow = rondine
swear = bestemmiare, giurare
sweat = sudare, traspirare
Swede = svedese
Sweden = Svezia
sweet = dolce
swiftly = presto
swim = nuotare, 
swindling = imbroglio, inganno, truffa
swine = porco
Swiss = svizzero
switch = accendere, interruttore
Switzerland = Svizzera
swoon = svenirsi
system = sistema