#setName = words_en_es_il
#sideOneTitle = ENG
#sideTwoTitle = SPA
Iberian = ibérico
ice = hielo
Iceland = Islandia
idea = idea, noción
ideal = ideal
identify = identificar
idol = ídolo
idolatry = idolatría
idol worship = idolatría
if = si
ignition = ignición
ignore = desentenderse de
iguana = iguana
ill-fated = fatal
illiterate = analfabeto
illness = enfermedad
illuminate = alumbrar, encender
image = grabado, imagen, reproducción, retrato
imagine = figurarse
imitate = imitar
imitation = imitación
immediately = directamente, ahora mismo, en el acto, en seguida, inmediatamente
impediment = impedimento
impel = animar, espolear, incitar, inpulsar
impetus = instinto
implore = implorar, suplicar
imply = significar
important = grave, importante
impossible = imposible
imposter = embustero
impulse = instinto
in = a, dentro de, en, por
in action = activo
in addition = demás, además
in a hurry = precipitadamente
in all respects = en todos conceptos
in a way = como si
inborn = innato
inbred = innato
in cash = contante
incendiary bomb = bomba incendiaria
incite = instigar, espolear
inclination = tentación
include = contener
including = incluído
inclusively = incluído
inconvenient = dificil
increase = ampliación, aumentar
increasingly = más y más
incredible = increíble
incus = yunque
indecisive = indeciso
indeed = de veras, en efecto, en realidad, verdaderamente
index = indicación, indicio
India = India
Indian = indico, indio, amerindio, indio americano
Indian corn = maíz
indicate = designar, enseñar, indicar, mostrar
indication = agüero, indicación, indicio
indictment = acusación, cargo
indigence = indigencia
individual = individuo
Indonesia = Indonesia
Indonesian = indonésico, indonesio
induce = decudir
inducement = lugar, motivo
indulgence = bula, indulgencia
industry = empresa
in easy circumstances = acomodado
inebriety = embriaguez
in every respect = en todos conceptos
in every way = en todos conceptos
in exchange for = contra
inexpensive = barato
in fact = en efecto
infant = niño
infect = contagiar, infectar, inficionar
infected = contagiado
infection = infección
infectious = contagioso
infer = decudir
inference = conclusión
inferior = inferior
inflammation = inflamación
inflate = inflar
influence = influir en
influenza = gripe
inform = informar, divulgar, publicar
information = información
in front of = antes, delante de
infusion = extracto
ingredient = ingrediente
inhabitant = habitante
inherit = heredar
inhibit = estorbar, impedir
initial = inicial, primitivo
initial velocity = velocidad inicial
initiate = instigar, maquinar
injection = inyección
injure = deteriorar
injured = herido
injury = herida
ink = tinta
inn = albergue
innate = innato
inner = interior, interna
inner tube = cámara de aire
innocent = inocente
in no way = de ninguna manera
inoffensive = cándido, ingenuo
in principle = en principio
in question = dicho, en cuestón
inquiry = encuesta
inquiry-office = oficina de informaciones
inquisitive = curioso
insect = insecto
inside = a, dentro de, en, por, interior, interna, dentro
insidious = astuto
insist = insistir, instar
insistence = insistencia, instancia
inspection = visitación
inspire = animar, incitar
instalment = anualidad
instant = momentito, momento
instantly = directamente, en seguida
instigate = animar, espolear, incitar, inpulsar
instigator = instigador
instinct = instinto
instruct = notificar
instructor = maestro
insulation = aislamiento
insult = injuriar, injuria, insulto, ofensa, insultar, ofender, ultrajar
insurance = seguro
insurance policy = póliza
insure = asegurar
insurer = asegurador
intend = querer decir, tener el propósito
intense = violento
intensive = violento
intention = intención
inter = enterrar
intercessor = abogado
interchange = cambiar
interest = interesar, interés
interesting = interesante
interference = molestia
interment = enterramiento, entierro
intermission = descanso
internal = interior, interna
interpreter = interprete
interrupt = interrumpir
intestines = intestinos
in the beginning = en un principio
in the Cuban way = a la cubana
in the daytime = de dia
in the evening = por la noche, por la tarde
in the morning = por la mañana
in the rear = atrás, detrás, en pos
intimate = cómodo
in time = a tiempo
into = a, dentro de, en, por
intone = entonar
intoxicate = aturdir
intoxicated = borracho, ebrio
introduce = ofrecer, presentar, reproducir, retratar
in vain = en vano
invent = inventar
inverted comma = conulla
inverted commas = conullas
invest = colocar
investigation = examen, encuesta
invite = invitar
invite tenders for = contratar, dar a destajo
invoice = cuenta
invoke = invocar, llamar, implorar, suplicar
in what way = cómo
iodine = yodo
Ireland = Irlanda
Irish = irlandés
Irishman = irlandés
iron = de hierro, hierro, planchar, plancha
iron clothes = planchar
ironing board = tabla de planchar
iron wire = alambre
irrigate = regar
island = isla
isolation = aislamiento, retiro, separación
Israelian = israelí
Israelite = hebreo, israelita, judío
issue = dar parte de, proclamar, promulgar
Italian = italiano
Italian language = italiano
Italian woman = italiana
Italy = Italia
itch = picazón
its = su
ivory = marfil
ivy = hiedra, yedra
jack = gato
jacket = americana, chaqueta
jade = cansar, fatigar
jail = prisión
jam = mermelada
January = enero
Japan = Japón
Japanese = japonés
Japanese language = japonés
Japanese woman = japonesa
Java = Java
Javan = javanés
Javanese = javanés
Javanese woman = javanesa
jaw = mandíbula
jawbone = mandíbula
jeer = injuriar, insultar
jeer at = injuriar, insultar
jelly-fish = medusa
jest = bromear
Jesus Christ = Jesucristo
Jew = hebraico, hebreo
jewel = joya
jeweller = joyero
Jewish = hebraico, hebreo
job = trabajo, cargo, función, oficio
join = reunirse, juntar, juntarse, liar, ligar, reunir, unirse
joining = unión, reunión
joint = común
joke = bromear, broma, burla, chanza
journalist = periodista
journey = viaje
joy = alegría
joystick = volante
judge = juez, criticar, juzgar
judgement = sentencia
judgment = juicio
jug = jarra, jarro, olla, caja, estuche
juice = jugo, zumo
July = julio
jump = saltar, salto
junction = unión, reunión
June = junio
junto = trinquete
just = no ... mas que, sólo, solamente, ahora mismo, en el acto, en seguida, inmediatamente, hace poco
just now = hace poco
keep = vigilar, conservar, guardar, observar, cometer, hacer, perpetrar, salvar
keeper of the records = archivista, archivero
keep on = continuar, durar
keep one's hands off = no tocar
keepsake = recuerdo
key = llave
kick = patada
kick-off = saque de comienzo
kidney = riñón
kill = matar
kiln = estufa
kilo = kilo
kilometre = kilómetro
kind = amable, bonito, gracioso, clase, especie, suerte
kindle = encender
king = rey
kingdom = reino
kiss = besar, beso
kitchen = cocina
klaxon = bocina
knapsack = mochila
knee = rodilla
kneel = arrodillarse
knife = cuchillo
knight = caballero
knock = llamar
knock at the door = llamar a la puerta
knock-kneed legs = piernas torcidas hacia afuera
knot = nudo
know = saber
know how = saber
knowledge = conocimiento
Koran = Alcorán
laborer = obrero, trabajador
labor exchange = bolsa de trabajo
labourer = obrero, trabajador
labour exchange = bolsa de trabajo
lace = encaje
lack = falta
lad = chico, muchacho
ladder = escala
laddie = chico, muchacho
lady = dama
Lady Day = Anunciación
lady's bag = bolsa para señoras
laggard = rezagado
laid up = encamado
lake = lago
Lake of Geneva = lago Lemán
lamb = carne de cordero, cordero
lame = cojo
lamp = lámpara
land = abordar, atracar, país, aterrizar, tierra
landing = aterrizaje
landing-stage = amarradero, desembarcadero
landscape = paisaje
landslide = desprendimiento de tierras
lane = calleja
language = lengua
lantern = farol
Lapland = Laponia
lapsed = decrépito
large = grande
lark = alondra
lass = muchacha
last = pasada, continuar, durar, postrero, último
lasting = continuo
last night = anoche
late = tardío
lath = tabla
Latin = latino, latín
Latvia = Latvia, Letonia
Latvian = letón
laud = alabar
laugh = reír
laugh at = mofarse de, reírse de
laughter = risa
laundry = lavadero
laurel = laurel
lava = lava
law = ley
lawless = desenfrenado, libertino
lawn = batista
lawsuit = proceso
lawyer = abogado
laxative = purgante
lay = colocar, poner
lay-by = aparcamiento
lay down = colocar, meter, poner
lay hold of = buscar, coger, recoger, tomar
lazy = holgazán
lead = guiar, conducir, dirigir, plombo
leader = amo, capitán, caudillo, comandante, dueño, jefe, patrón, guía
leaf = hoja
leaflet = folleto
league = cinta, lazo
lean = apoyarse, fino
leap = saltar, salto
leap-year = año bisiesto
learn = aprender, estudiar
leather = duro, cuero
leather goods = artículos de cuero
leave = quitarse, salir, abandonar, dejar
leave behind = dejar, dejar en pos
leave out of account = desentenderse de
leek = ajo
left = por la izquierda
leg = pierna
legging = polaina
lemon = limón
lend = prestar
length = largura
lengthen = alargar
lens = lente
lentil = lenteja
less = menos
less and less = menos y menos
lesson = lección
let = dejar, alquilar
let know = informar, divulgar, publicar
Lett = letón
letter = carta
letterbox = buzón
lettuce = lechuga
level = liso, plano, igual, nivel
level-crossing = paso a nivel
lever = levantar
library = biblioteca
licentious = desenfrenado, libertino
lick = lamer
lid = tápa
lie = estar tendido, mentir, mentira
lie encamped = acampar
Liège = Lieja
life = vida
lift = levantar, subir, ascensor
light = claro, ligero, alumbrar, encender, luz, débil
lighten = relampaguear
lighter = encendedor, mechero
lighting = alumbrado
lightning = relámpago
like = a título de, como, si, semejante, gustar
likewise = también, idem
lilac = lila
limb = miembro
lime = cal
lime-tree = tilo
limit = limitar, frontera
limited = limitado
limp = cojear
linden-tree = tilo
line = cordel, línea, turno
lineage = descendencia, origen
lining = forro
lion = león
lip = labio
liqueur = licor
liquid = líquido
liquidate = saldar, matar
liquor = alcohol
Lisbon = Lisboa
list = lista
listen = escuchar
liter = litro
Lithuania = Lituania
litre = litro
litter = andas, camilla
little = chico, pequeño, poco
little by little = poco a poco
Little Snow White = Blanca-Nieve
live = habitar, morar, vivir
liver = hígado
liver sausage = butifarra de hígado
livestock = ganado
Livonia = Livonia
load = cargar, carga
loaf = pan
loan = prestar
loathe = detestar
lobster = langosta
location = sitio
loch = lago
lock = esclusa, cerradura, cerrar
locust = saltamontes
lofty = alto
loin = lumbar
London = Londres
Londoner = londinense
long = largo
look = parecer, aspecto, vista, tenga, contemplar, mirar, observar, ver, mirada
look after = vigilar, atender a, cuidar de
look at = contemplar, mirar, observar, ver
look for = buscar
looking-glass = espejo
loose = suelto
lord = caballero, señor
Lorraine = Lorena
lorry = camión
lose = adelgazar, perder
lose flesh = adelgazar
lose in weight = adelgazar
lose one's way = perderse
loss = perdida
lost = perdido
Lothringen = Lorena
loud = alto
loudly = en alta voz
lounge suite = tresillo
louse = piojo
Louvain = Lovaina
lovable = afable, amable
love = amar, querer, amor
loved one = querido, novio
lovely = agradable, bonito, hermoso, magnífico, caro, lindo, encantador
lover = querido, novio
low = bajo
lower = bajar
lower-arm = antebrazo
low relief = bajorrelieve
low tide = bajamar, reflujo
Lucifer = Satán, Satanás
luck = suerte
luggage = equipaje, equipajes
luggage ticket = billete de equipaje
luggage-van = furgón
lukewarm = tibio
lump = bola, pieza, masa, tela, pedazo
lunch = almuerzo, almorzar, comer
lung = pulmón
lupine = loba
lurid = afilado, agudo
Luxemburg = Luxemburgo, luxemburgués
Luxemburger = luxemburgués
lynx = lince
lyric = texto