#setName = words_en_es_qr
#sideOneTitle = ENG
#sideTwoTitle = SPA
quality = calidad, ralea
quantity = cantidad
quarrel = disputar, reñir
quarter = barrio
quash = provocar un aborto, destruir
quay = andén
queen = reina
quell = sofocar
question = pregunta
quick = rápido
quickly = de prisa, pronto
quicksand = arenas movedizas
quicksands = arenas movedizas
quiet = quieto, silencio, calmar, sosegar
quit = darse de baja, dimitir, hacer dimisión, abandonar
quite = bastante, muy, enteramente
quiver = tremblar
quotation = cita, citación
quotation mark = conulla
quotation marks = conullas
quote = citar, mencionar, conulla
quotes = conullas
rabbit = conejo
race = correr, raza
radiator = radiador
radio = radio
radish = rábano
radius = radio, rayo, radio de acción
railing = balaustrada
railway carriage = coche
railway ticket = billete del tren
rain = llover, lluvia
rainbow = arco iris
raise = entonar, levantar
ram = carnero
ranch = finca, granja
rand = cordillera, sierra, baranda
rank = fila, turno
rap at the door = llamar a la puerta
rapid = rápido
rare = raro
raspberry = frambuesa
rat = rata
rate = fila, estimar
rate of exchange = curso
ratepayer = contribuyente
rather = bastante, poco, poquito, tantico, más bien
raven = cuervo
ravine = hendidura
raw = crudo
ray = rayo, raya
razor-blade = hoja de afeitar
reach = alcanzar
react = reaccionar
read = leer
ready = listo
reality = verdad
realization = inteligencia
realize = comprender, entender
really = de veras, en efecto, en realidad, verdaderamente
rear = retaguardia, revés
rearguard = retaguardia
rear-lamp = luz posterior, luz trasera
rear-light = luz posterior, luz trasera
rear platform = plataforma posterior
rear wheel = rueda posterior
reason = causa, lugar, motivo
rebate = bajar, descuento, rebaja, reducción
rebuke = desaprobar, reprobar,. censurar, reprender
receipt = recibo, talón
receive = aceptar, admitir, tomar, obtener, recibir
recent = fresco
recently = recientemente
recess = descanso
recipe = receta
recipient = destinatario
recite = recitar
recline = estar tendido
recognize = reconocer
recollection = recuerdo
recommend = certificar, encarecer, ensalzar, recomender
recommendable = recomendable
recommendation = recomendación
record = certificar, inscribir, registrar, registro, récord
records = archivo
recover = sanar
recruit = alistar
red = rojo
Red Cross = Cruz Roja
red currant = grosella
redeem = amortizar
Redeemer = Redentor, Salvador
redemption = amortización, castigo
red herring = arenque ahumado
Red Indian = indio
Red Sea = mar Rojo
reduce the price = repulsar
reed = junco
reef = roca
reek = oler mal, apestar, oler
refined = fino
reflect on = reflexionar
refusal = negativa
refuse = desechos, detrito, rechazar, rehusar
refuse dump = basurero
regard = estima, estimación, considerar, contemplar, tomar en consideración, mirar, observar, ver
region = comarca, región
register = hacer incribir, certificar, inscribir, registrar, registro, encarecer, ensalzar, recomender
registered = certificado
regret = deplorar, sentir
regrettable = deplorable
regrettably = es una lástima
regularly = a menudo
regulation = regla
regulations = reglamento
reject = rechazar, rehusar, suspender
relate = contar
relation = relación, conexión
relative = deudo, familiar, pariente
release = dejar
reliable = de confianza
religion = religión
relinquish = abandonar, ceder, desistir de, renunciar a
remain = quedarse atrás, tardar, quedarse, restar
remainder = desechos, detrito
remark = censura, reparo
remedy = curar, medio
remit = anular, contramandar
remote = aislado, apartado, separado, lejano
remote control = telemando
remotely = lejos
remove = abolir, abrogar
remove the cloth = recoger la mesa
rendezvous = cita
renounce = abjurar, desistir de, renunciar a
renown = conocimientos, hambre
rent out = alquilar
repair = reparar
repayment = anualidad
repeat = repetir
repentance = arrepentimiento
replace = substituir
replacement = relevo, cumplimiento, relleno, suplemento
replenishment = cumplimiento, relleno, suplemento
reply = contestar, responder, contestación, respuesta
report = comunicar, informar, noticia, noticias, publicación
repose = descansar, descanso
represent = reproducir, retratar, representar
representation = reproducción, retrato
representative = diputado
reproach = censurar, desaprobar, reprender, reprobar
reproof = censura, reparo
reprove = censurar, desaprobar, reprender, reprobar
republic = república
repute = hambre
request = demandar, pedir, solicitar, petición, solicitación, solicitud
require = necesitar, exigir
rescue = salvar
resemble = parecerse
reserve = reservar, pedir
reservoir = recipiente de agua
residence = domicilio
resign = abdicar, darse de baja, dimitir, hacer dimisión
resist = oponerse, resistir
resources = medio
respect = respetar, estima, estimación
respectable = honorable, respetable
respiration = respiración
respond = reaccionar, contestar, responder
responsibility = responsabilidad
responsible = responsable
rest = desechos, detrito, descansar, descanso
restaurant = restaurante
restrain = contener, reprimir, capitanear, subyugar, gobernar, refrenar
restrained = dueño de sí mismo
restrict = limitar
restricted = limitado
result = descender, arrojar, resultado
resumé = resumen
retain = retener
retardation = retraso
retarded = atrasado
retention = conservación
retreat = retirarse
retrograde = retrógrado
return = devolver, volver
return-ticket = billete de ida y vuelta
reveal = divulgar, publicar, revelar
revenge = venganza
reverse = reverso, revés, al contrario, al revés, parte trasera
reversed = al contrario, al revés
reverse side = reverso, revés, parte trasera
revise = revisar
revive = reponerse
revue = revista
reward = recompensar, recompensa
rezignation = resignación
rheumatism = reumatismo
Rhine = Rin
rhino = rinceronte
rhinoceros = rinceronte
rhythm = ritmo
rib = costilla
ribbon = cinta
rice = arroz
rickety = decrépito
ride = conducir
ridicule = ridiculizar
ridiculous = ridículo
rifle = escopeta
right = por la derecha, correcto, derecho, preciso
right away = ahora mismo, en el acto, en seguida, inmediatamente
right now = ahora mismo, en el acto, en seguida, inmediatamente
rigid = rigido
rim = llanta, baranda, borde
ring = anillo, llamar, tocar la campanilla
ring the bell = llamar, tocar la campanilla
riot = ruido
riotous = desenfrenado, libertino
ripe = maduro
rise = levantarse, subir
risk = arriesgar, riesgo
risky = arriesgado
rival = competir, competidor
river = río
road = camino, vía
road-metal = cascajo
roast = asar
roasted = asado
rob = despojar, privar, hurtar, robar
robe = vestido
robust = fuerte, sólido
rock = balancear, roca
rocket = cohete
roe = corzo
roll = bocadillo, panecillo, rodar
roll-call = llamada
roller = cilindro
Roman = romano
Romanesque = románico
Romania = Rumania
Romanian = rumano
Rome = Roma
roof = tejado
room = espacio, cuarto, habitación
rooster = gallo
rope = cuerda
rose = rosa
rotten = podrido
rough = crudo, bronco, brusko, áspero, desigual
round = redondo, redondear, alrededor de, en torno de
round off = redondear
rouse = instigar, espolear, animar, estimular, incitar
route = ruta, camino, vía
row = remar, turno
row-boat = barco de remos
rowing-boat = barco de remos
rub = frotar
rubber = caucho, condom, preservativo, goma
rubbish = desechos, detrito, derribos
rubbish tip = basurero
rubble = desechos, detrito, cascajo
rucksack = mochila
rudder = timón, volante
rude = descortés, grosero, insolente
rudiments = abecé, alfabeto
ruin = arruinar, ruina
rule = contener, gobernar, subyugar, refrenar, reprimir, regla
rules = reglamento
rum = ron
Rumanian = rumano
rumor = hambre
rumour = hambre
run = atropellar, arranque, funcionar, correr
run across = acertar
run away = huir
rush = apresurarse
Russia = Rusia
Russian = ruso
Russian woman = rusa
rye = centeno