#setName = words_en_es_tu
#sideOneTitle = ENG
#sideTwoTitle = SPA
table = mesa
table-cloth = mantel
taco = taco
Tagus = Tajo
tail = cola
tail-light = luz posterior, luz trasera
tailor = costurera, sastre
taint = deterioración, putrefacción
take = aceptar, admitir, tomar, desempeñar, ocupar, buscar, coger, recoger
take along = llevar, ir a buscar a
take apart = demontar
take a shower = ducharse
take away = arrancar, descolgar, quitar
take care = cuidar
take care of = cuidarse de
take down = demoler, derribar
take in = aceptar, admitir, tomar, engañar
take into account = considerar, contemplar, tomar en consideración
take leave = despedirse
take leave from = despedirse
take off = quitarse
take over = comprar, procurarse
take somebody's name = multar
take steps = esforzarse por, tratar de
take the place of = relevar, substituir
taking = adquisición, compra
taking over = adquisición, compra
talent = capacidad, disposición, talento
talented = dotado, talentoso
talk = hablar
tall = alto
tame = adiestrar, domesticado, manso
tampon = tampón
tangerine = mandarina
tangle = caos
tank = tanque
tap = grifo
tape-recorder = magnetófono
tapestry = papel pintado
tar = alquitrán
tardy = tardío
target = fin, objeto
tart = agrio, pastel, torta
taste = gusto, saborear
tasty = rico
taunt = injuriar, insultar
tax = imponer, contribución, impuesto, tributo
taxi = taxi
taxpayer = contribuyente
tea = té
teach = desacostumbrar, instruir, enseñar
teacher = maestra
teapot = tetera
tear = lágrima
tear off = arrancar, cortar
technics = técnica
technique = técnica
teetotalism = abstinencia
telegram = telegrama
telephone = teléfono
telephone booth = cabina telefónica
telephone kiosk = cabina telefónica
television = televisión
tell = decir, contar
tell a lie = mentir
temper = humor
temperature = temperatura
tempest = tormenta
temple = sien, templo
temporarily = provisionalmente
temptation = tentación
ten = diez
tendency = tentación
tender = dulce, ofrecer, presentar, reproducir, retratar, destajo, subasta, proposición, proponer, oferta, ofrecimiento
tend to = cuidar
tennis = tenis
tension = tensión, afán, voltaje
tent = tienda de campaña
tented camp = campamento
terminate = acabar, concluir, terminar, expiración, vencimiento
terms = condición
terrace = terraza
terrain = terreno
terrestrial = terrenal, terrestre
test = examen, intentar, probar, carné, carnet
testimony = certificado, certificación
text = texto
Thames = Támesis
than = que
thank = agradecer, dar gracias a
thanks = gracias
thank you = gracias
that = cuál, que, así
that is = a saber, es decir
that kind of = tal
that much = tanto
that over there = eso
that's too bad = es una lástima
that way = así
thaw = deshielo
the = el, la, las, lo, los
theatre = teatro
the day after tomorrow = mañana pasado, pasado mañana
the day before yesterday = anteayer
thee and thou = tutear
the Far East = Extremo Oriente
theft = robo
The Hague = La Haya
their = su
then = después, luego, entonces
the Netherlands = Holanda, Los Países Bajos
there = tenga, ahí, allí
thereafter = después, luego
there are = hay
therefore = por eso
there is = hay
thermometer = termómetro
thermos = termos
thermos bottle = termos
thermos flask = termos
these = esta
these days = ahora, al presente, hoy día
they = ellas, ellos
thick = grueso
thief = ladrón
thigh = muslo
thin = fino
thing = cosa, objeto, objecto
think = acordarse, creer, pensar, reflexionar
think about = reflexionar
think well of = estimar, respectar
third = tercero, tercio
thirst = sed
thirteen = trece
thirty = treinta
this = esta
this evening = esta tarde
this here = esta
thisle = cardo
this morning = esta mañana
those = eso
thou = tú, usted, ustedes, vosotras, vosotros
though = aunque
thought = pensamiento
thoughtful = circunspecto, prudente
thousand = mil
thrash = aporrear, pegar, zurrar
thread = hilo
threat = amenaza, conminación
threaten = amenazar, conminar
three = tres
three-piece suite = tresillo
three times = tres veces
thrice = tres veces
thrifty = económico
throat = garganta
throne = trono
through = acabado, terminado, completamente, por medio de, listo, a lo largo de, por
throw = echar, lanzar
throw up = vomitar
thrust = empujar
thumb = pulgar
thunder = tronar, trueno
Thursday = jueves
thus = así
thwart = dificultar
ticket = billete, billete de viaje
ticket-window = taquilla
tidbit = dulce
tide = marea
tidy = arreglar
tie = corbata, liar, ligar, cinta, lazo
tie on = anudar
tie up = liar, ligar
tiger = tigre
tighten = apretar
tile = azulejo
till = caja, a que, hasta que
timber = leño, madera
time = hora, tiempo
time-table = horario
timid = encogido, tímido, miedo
tin = hojalata, lata, estaño
tin can = lata
tin-opener = abrelatas
tin plate = hojalata
tint = teñir
tip = basurero, punta, propina
tire = neumático
tired = cansado
tired out = agotado
tiresome = aburrido
to = a
toad = sapo
toast = asar
tobacco = tabaco
today = hoy
toe = dedo de pie
together = juntamente
together with = así como, y también
toilet = excusado, retrete
toilet-paper = papel higiénico
token = prueba, señal, seña
tolerate = tolerar
tomato = tomate
tomb = tumba
tomorrow = mañana
tomorrow evening = mañana por la tarde
tomorrow morning = mañana por la mañana
tongs = tenazas
tongue = lengua
too = también, demasiado
tool = herramienta, instrumento, medio
too much = demasiado
toothache = dolor de muelas
tooth-brush = cepillo de dientes
tooth-paste = pasta dentrífica
top = superficie
topical = actual
to some extent = bastante, poco
total abstinence = abstinencia
to the left = por la izquierda
to the right = por la derecha
touch = toque, tocar
touching = conmovedor
touch upon = tocar
tourist = turista
tourist agency = agencia de viaje
tow = remolcar
toward = a
towards = a, alrededor de, en torno de
towel = toalla
tower = torre
towing-line = cable de remolque
town = ciudad, población
town-hall = ayuntamiento
town hall = ayuntamiento
township = pueblecito
toy = juguete
trace = amojonar, impresión
trace out = amojonar
track = impresión
trade = comercio, oficio
traffic = tráfico
trailer = remolque, coche remolque
train = adiestrar, tren
train ticket = billete del tren
tram = tranvía
tranquil = sosegado, tranquilo
transfer = atravesar
transitive = activo, transitivo
translate = traducir
transmit = despachar, difundir, enviar
transport = transportar, transporte, trasporte
travel = conducir, viajar
travel agency = agencia de viaje
traveller = viajero
tray = bandeja
treat = curar, tratar
treatment = cura, tratamiento, trato
treaty = tratado
tree = árbol
tree-trunk = tronco
tremble = tremblar
tribunal = juzgado
tribute = tributo
trick = mala costumbre, resabio, engañar
trifle = bagatela, friolera
Trinity = Trinidad
trip = viaje
trite = común, trivial, redicho, trillado
trouble = inconveniente, prueba, incomodar, molestar, molestia
trousers = pantalón
trout = trucha
truck = camión
true = verdadero
truly = de veras, en efecto, en realidad, verdaderamente
trumpet = trombón
trunk = tronco, baúl, maleta
trustworthy = de confianza
truth = verdad
try = intentar, probar
try on = probar
tube = cámara de aire, válvula
Tuesday = martes
tug = tirar
tummy = vientre
tumor = tumor
tumour = tumor
tumult = ruido
tuna = atún
tuna-fish = atún
tune = acomodar, adaptar
Tunis = Túnez
tunnel = túnel
tunny = atún
tup = carnero
Turk = turco
turkey = pavo
Turkish = turco
Turkish lady = turca
Turkish woman = turca
turn = desviarse, talento, trastornar, volver, girar, apretar, turno
turn around = volver
turn away = parar, despachar, despedir, enviar, expedir, apartar, volver
turned-in legs = piernas torcidas hacia afuera
turnip = nabo
turnip-rooted celery = apio
turn off = parar
turn on = arrancar, poner, apretar
turn over = trastornar
turnpike = autovía
turn round = volver
turn to good account = aprovechar
TV = televisión
twaddle = desatinar
twelve = doce
twenty = veinte
twenty-one = veinte y uno
twice = dos veces
twilight = anonchecer
twin = gemelos
twins = gemelos
two = dos
type = escribir a máquina
typewriter = máquina de escribir
tyre = neumático
ugly = feo
ulcer = úlcera
ultimately = al fin, finalmente, por fin
umbrella = paraguas
uncle = tío
unclean = sucio
unconscious = desmayado
uncooked = crudo
uncover = descubrir
under = debajo de
undergarment = combinación
underground = metro
underneath = abajo, en el fondo, debajo de
underpants = calzoncillos
understand = comprender, entender
understandable = comprensible, inteligible
understanding = relación, inteligencia
understood = comprendido
undertake = encargarse de, emprender, esforzarse por, tratar de
undoubtedly = sin duda
undress = bata
unfaithful = renegado
unfortunately = es una lástima, por fortuna, desgraciadamente
unhappy = infeliz
unique = único
unite = juntar, reunir
United States of America = Estados Unidos
university = universidad
unkind = bronco, brusko
unknown = desconocido
unlearn = desaprender
unload = descargar
unmarried = soltero
unmarried woman = solterona
unpleasant = bronco, brusko
unrest = molestia
unroll = devanar
until = a que, hasta que
untroubled = sereno
unwind = devanar
upon = contra, en cuanto a, por lo tocante a, respecto de, en, sobre
upset = indispuesta, trastornar
upstairs = arriba
up-to-date = actual
urban = urbano
urge = animar, espolear, incitar, inpulsar
urgency = insistencia, instancia, prisa
urgent = urgente
urgently = urgentemente
urge on = animar, incitar
urinate = mear, orinar
urine = orina
Uruguay = Uruguay
USA = Estados Unidos
US citizen = americano
use = hacer uso de, usar, uso
used = usado
use up = usar, acabar, consumir
USSR = Unión soviética
usual = común, general, universal
uterus = útero
utilize = explotar, aprovechar