#setName = words_en_pt_w
#sideOneTitle = ENG
#sideTwoTitle = POR
wadding = <algodão carvado e comprido em camadas moles>
wade = chafurdar, patinhar, vadear
waffle = folhado
wage = salário, ordenado
wager = apostar, aposta
wages = salário, ordenado
wage war = combatar, fazer campanha, guerrear
waggon = carruagem, vagão
wail = lamentar-se, queixar-se
wainscot = painel
waist = cintura, talhe, tálio
waistcoat = colete
waistline = cintura, talhe, tálio
wait = aguardar, esperar, estar à espera de
waiter = criado, garçom
wait for = aguardar, esperar, estar à espera de
waiting-room = sala de espera
waiting room = sala de espera
wake = acordar, despertar
wake up = acordar, despertar
Wales = Gales, País de Gales
walk = andar, caminhar, marchar, passeio
wall = muro, parede, tabique
Wallachia = Valáquia
wall covering = forro
wallet = bolsa, carteira
wallpaper = papel de parede
walnut = noz
walnut-tree = nogueira
wand = vara, verga, vergasta
wander = correr terras, transmigrar, errar, perambular, vadiar, vagabundear, vagar
wander about = correr terras, transmigrar
want = precisão, anseio, desejo, pretensão, querer, ter vontade de
want to know = desejar muito saber
war = guerra
warehouse = armazém, casa comercial, loja
wares = fazenda, mercadoria
warlike = belicoso
warm = cordial, do coração, cardíaco, acalorado, calmoso, quente, vivo
warmly = calorosamente
warmth = calor
warn = advertir, avisar, lembrar, prevenir
warning = advertência, aviso
warrant = afiançar, garantir, caução, fiança, garantia
Warsaw = Varsóvia
wart = verruga
wash = lavar
washing-bear = prócion
wasp = vespa
watch = relógio de pulso, pêndulo, relógio, observar, mirar, olhar, assistir a
watchmaker = relojeiro
watch out for = atender, fixar a atenção em, prestar a atenção
watch over = guardar, velar, vigiar
watchword = cambial, divisa, lema
water = aquático, aquoso, água, irrigar, aspergir, borrifar, jogar água, benta, orvalhar, regar, espargir, molhar
water- = aquático, aquoso
water-colour = aquarela
waterfall = cachoeira, cascata
water-melon = melancia
water-plaintain = alisma
watt = watt
wave = onda, vaga, agitar, bater, mexer, vibrar
wave about = agitar, bater, mexer, vibrar
waver = hesitar, vacilar
wax = graxa, cera
way = costume, hábito, forma, maneira, modo, caminho, estrada, via, rumo
way out = porta, saída
weak = débil, fraco
weaken = adulterar
wealth = riqueza
wealthy = rico
weapon = arma
wear = carregar, levar, calçar
wear away = tornar-se consumido
wear down = desgastar, esmerilar
wear off = tornar-se consumido, desgastar, esmerilar
wear out = puir, safar, tornar-se consumido, desgastar, esmerilar
weary = aborrecido, enfadonho
weather = tempo
weave = tecer, urdir, entretecer
wed = casar
Wednesday = quarta-feira
weed = mondar, sachar
weed out = mondar, sachar
week = semana
weekly = semanalmente
weep = derramar lágrimas, lacrimejar, chorar
weever = traquino
weigh = tomar o peso, pesar
weighing machine = balanço, báscula, gangorra
weight = peso
weird = barroco, bizarro, excêntrico, esquisito
welcome = dar as boas vindas, bem-vindo
weld = caldear, soldar
well = bem, tinteiro, então, pois bem, cisterna, poço, bom, são, sadio
well-being = saúde
well-beloved = amada, namorada, amado
well-known = conhecido
well-mannered = cavalheiro, cortês, gentil, polido
well-off = rico
well then = bem, então, pois bem
well up = jorrar de uma fonte
Welsh = galês
Welshman = galês
wench = garota, menina, moça, rapariga
west = ocidente, oeste
western = ocidental
wet = molhado
whale = baleia, cetáceo
wharf = cais, plataforma
what = que, que coisa, o que
what a = qual, que, que espécie de, como, na qualidade de
what a pity = deploravelmente, lamentavelmente
whatever = qualquer coisa
what for = por que, por que causa
what kind of = como, qual, que, que espécie de
what number = quantos
what's more = aliás, além disso
what sort of = como, qual, que, que espécie de
wheat = trigo
wheel = roda
wheelbarrow = carrinho de mão
wheeziness = asma
wheezy = asmático
when = ao tempe que, quando
whence = donde
where = aonde, para onde, em que lugar, onde
whereas = durante
where ... to = aonde, para onde
wherever = não importa o lugar
which = qual, o qual, que, quem
whichever = quem quer que seja, seja lá quem for
which one's = cujo, de que, de quem, do qual
while = durante, tempo
whilst = durante
whim = capricho, caprichoso, fantasia, impertinência
whimstone = basalto
whinny = relinchar, rinchar
whip = bater, fazer molinete, mexer, chicotear, vergastar, chicote, relho, taca
whirl = bater, fazer molinete, mexer
whiskers = barba, suíças
whiskey = uísque
whisky = uísque
whisper = cochichar, segredar
whist = whist
whistle = apitar, assobiar, silvar, apito, assobio, gaita
white = branco
white man = branco, homem da raça branca
whiten = alvejar, branquear, corar, embranquecer
White Russian = bielo-russo, russo-branco
White Sea = Mar Branco
white-tailed eagle = halieto
white-wash = caiar
whither = aonde, para onde
Whitsunday = Pentecostes
who = quem, qual, o qual, que
whoever = quem quer que seja, seja lá quem for
whole = inteiro, todo, total, soma
wholesale = por atacado
wholly = totalmente, absolutamente
whore = puta, prostituta
whose = cujo, de que, de quem, do qual
why = por que, por que causa
wick = mecha, pavio
wide = amplo, espaçoso, extenso, grande, lato
widely = vastamente
widow = viúva
widower = viúvo
width = largura
wife = esposa, mulher
wig = peruca
wild = bravio, gentio, selvagem
wild animal = animal selvagem, fera
wild boar = javali, javardo, porco-montês
will = testamento, vontade, querer
willing = espontâneo, voluntário
willingly = de boa vontade, voluntariamente, de bom grado
willingness = vontade, querer
will-lessness = abulia
willow = salgueiro, vimeiro
willowherb = epilóbio, epílobo
willy-nilly = obrigatoriamente, quer queira quer não
win = auferir, ganhar, lucrar
wind = dobar, enrolar em bobina, vento, sopro, enfaixar, envolver, pensar, vendar, enrolar
wind-instrument = instrumento de sopro
wind instrument = instrumento de sopro
wind off = desenrolar
window = janela, bilheteira, bilheteria, guichê
wind up = alçar, içar, levantar, armar, dar corda, esticar, retesar, enrolar
wine = vinho
wing = asa
win over = debelar, derrotar, levar de vencida, sobrepujar, superar
winter = invernal, invernoso, hibernal, inverno
winter- = invernal, invernoso, hibernal
wipe = enxugar, limpar
wipe off = enxugar, limpar
wipe out = abolir, eliminar, exterminar, extinguir, suprimir
wire = arame, fio de metal
wireless = rádio
wireless telegraph = radiofonia
wisdom = juízo, sensatez, senso
wise = ajuizado, prudente, sábio, sensato
wish = desejar, pretender, anseio, desejo, pretensão, ter vontade de, vontade, querer
wit = engenho, espírito, graça
witch = feiticeira
with = com, em companhia de, através de, por, por intermédio de, por meio de, a, ao pé de, em, entre, junto a
with difficulty = dificilmente
withdraw = andar, decorrer, passar-se, retirar, retrair
with effort = penosamente
wither = definhar, engelhar, estiolar, fanar, murchar
within = dentro de, em
with one accord = unanimemente
without = menos, sem
without delay = directamente, imediatamente, sem delonga, diretamente
without fail = absolutamente, impreterivelmente, infalivelmente, sem falta
with reference to = em relação a, relativamente a
withstand = afrontar, arrostar, fazer frente a, relutar, resistir
with the exception of = à excepcão de, com excepção de, fora, menos, salvo
with young = grávida
witness = testemunha, assistir, estar presente
witty = engraçado, espirituoso
woe = ai
wolf = lobo
woman = mulher
woman-chaser = dom-joão
womb = útero
wonder = admirar-se, estranhar, desejar muito saber
wonderful = admirável
wonted = usual
woo = galantear, namorar
wood = lenha, madeira, pau
wooden cloth = fazenda, pano, tecido de lã
woodpecker = fuinho, pica-pau
woodpile = monte de lenha
woods = floresta, mata
wool = de lã, lanígero, lã
word = palavra, vocábulo, termo
word-for-word = literalmente, palavra por palavra
work = estar em exercício, exercer funções, funcionar, lidar, trabalhar, labor, trabalho, composição, obra
workbench = banco, bastidor, cavalete, mesa
worker = obreiro, operário, trabalhador
workhouse = asilo
working man = obreiro, operário, trabalhador
workman = obreiro, operário, trabalhador
work of art = coisa artística, objecto de arte
work out = elaborar, calcular, computar, orçar
workplace = laboratório, oficina
work-room = atelier
works = <obras completas de um autor>
workshop = atelier, ateliê, oficina
world = mundo
worldglobe = globo terrestre
worldwar = guerra mundial
worldwide = universal, mundial, ecumênico
worm = bicho, verme
worm-eaten = picada de vermes
worry = acurar, cuidar, preocupar-se, tutelar, zelar, afligir, magoar, molestar
worship = adoração, adorar, idolatrar, reverenciar
worshipper = adorador
worship service = culto, ofício divino
worth = valimento, valor
worthless = nulo, sem valor, vão
worth seeing = digno de ser visto
worthy = digno
wound = ferir, vulnerar, ferida, ferimento, lesão, chaga
wrangle = beijar-se, bicar reciprocamente, altercar, porfiar, querelar
wrapper = cinta, faixa
wreath = coroa de flores, grinalda
wreathe = trançar, entrançar
wreck = fazer abortar
wrench = chave
wrestle = lutar, pugnar
wretched = miserável
wrinkle = encrespar, enrugar, franzir, sulcar, calha, rego, sulco
wrist = pulso
wrist-watch = relógio, relógio de pulso
write = escrever, compor
write down = escrever nota sobre, tomar nota de
writer = autor
write shorthand = estenografar, taquigrafar
write upon = sobrescrever
writhe = debater-se, espernear, estrebuchar
writing-desk = carteira, escrivaninha
writing desk = carteira, escrivaninha
wrong = errôneo, que não tem razão, impreciso, incorrecto, incorreto, inexacto, inexato
Xanthippe = megera
xerographic = xerográfico
xerographic copy = cópia xerográfica
xerography = fotocópia, xerografia
X-rays = raios-X
Y = ípsilon, Y
yacht = iate
yam = batata doce
Yangtse-Kiang = Iangtze Kiang, Rio Azul
Yangtze = Iangtze Kiang, Rio Azul
Yangtze River = Iangtze Kiang, Rio Azul
yard = jarda, pátio, quintal, terreiro, verga
yarrow = aquiléia, milfólio, mil-folhas, mil-em-rama
yawn = escancarar-se, abrir a boca, bocejar, bocejo
ye = vós, tu, você, vocês, vossemecê, vossemecês, o senhor, a senhora
year = ano
yearly = anual, anualmente
yearn = dar ais, suspirar, ter saudades de
yeast = fermento
yell = berrar, urrar
yellow = amarelo, cor amarela
yellow fever = febre amarela
yes = bem, sim
yesterday = ontem, de ontem, hesterno
yet = ainda, até agora, mais, também, já, contudo, embora, entretanto, todavia, porém
yew-tree = teixo
Yiddish = iídiche
yield = abdicar, alhear, ceder, submeter-se, transigir
yodel = cantar à tirolesa
yoga = ioga
yoghourt = iogurte
yoghurt = iogurte
yoke = cangar, jungir, canga, jugo
yon = acolá, aí, além, ali, nesse, nesses, lugar, lugares, naquele
yonder = para aí, para lá, acolá, aí, além, ali, nesse, nesses, lugar, lugares, naquele, aquela, aquele, essa, esse
you = a gente, o, os, a, as, vos, te, vós, tu, você, vocês, vossemecê, vossemecês, o senhor, a senhora
young = jovem
youngster = jovem, moço
young woman = moça
your = teu, tua, seu, vosso
you're welcome = de nada, não há de que, não importa, pouco importa
youth = juventude, jovem, moço
Yugoslav = jugoslavo
Yugoslavia = Iugoslávia
Yugoslavian = jugoslavo
Yule = Natal
Zaïre = Zaire
Zambia = Zâmbia
Zanzibar = Zanzibar
zeal = ardor, fervor, zelo
Zealand = Zelândia
zealous = fervoroso, zeloso
zebra = zebra
zen = zen
zenith = zênite
zephyr = aragem, brisa, zefir, zéfiro
zero = nada, zero
zest = vivacidade, animação
zeta = zeta
Zeus = Zeus
zigzag = <que faz ou descreve ziguezagues>, ziguezaguear
zilch = nada, zero
Zimbabwe = Zimbabve
zinc = zinco
zipper = zíper
zirconium = zircônio
zither = cítara
zodiac = zodíaco
zone = zona, cinta, cinto, cintura, cós
zoo = zôo
zoology = zoologia
Zulu = zulo
Zululand = Zululândia
Zurich = Zurique