#setName = words_en_pt_nn
#sideOneTitle = ENG
#sideTwoTitle = POR
naïf = cândido, ingênuo
nail = cravar, pregar, cravo, prego, unha
naïve = cândido, ingênuo
naked = despido, nu
name = nome
nap = cochilar, dormitar
nape = cerviz, nuca
napkin = guardanapo
Naples = Nápoles
narrate = contar, descrever, narrar
narrative = conto, narrativa
narrow = estreito
nasal = nasal
nasturtium = tropéolo, chagas, capuchinha, barba-de-barata
nasty = repugnante, antipático, desagradável, enjoado, detestável, odioso, feio, hediondo, abominável, horrível, horrendo, mau, ruim, desonesto, malicioso, malvado, perverso
Natal = Natal
nation = gente, povo, nação
national = nacional
nationality = nacionalidade
nationalize = estatizar
native = aborígene, autóctone, aborígena, indígena
natural = natural
naturally = naturalmente
nature = carácter, índole, temperamento, natureza
naught = nada, zero
naughty boy = rapazola de má conduta
nausea = náusea
nauseate = causar náuseas a, enjoar
nauseous = nauseante
nave = cubo, cubo de roda
navel = umbigo
navigate = navegar
navigation = navegação
navy = armada, forças navais, marinha
Nazi = nazista, nazi
near = ao pé de, junto a, junto de, perto de, próximo a, junto, próximo
nearby = ao pé de, junto a, junto de, perto de, próximo a, juntamente, junto, próximo
nearly = perto de, por pouco, quase
near-sighted = míope
near to = ao pé de, junto a, junto de, perto de, próximo a
neat = bem acabado, distinto, limpo, líquido, polido
necessary = preciso, necessário
neck = pescoço
necklace = colar, coleira
necktie = gravata
need = necessitar, ter necessidade de, precisar, ter precisão de, precisão
needle = agulha, alfinete
needless = desnecessariamente, inútil, vão
negative = negativo
negatively = negativamente
neglect = distrair, não prestar atenção, descuidar, desleixar, negligenciar
negligent = distraído
negotiate = agenciar, negociar
Negro = negro
neigh = balar, berrar, bramir, gritar, grunhir, mugir, ornear, uivar
neighborhood = vizinhança
neighbour = vizinho
neighbourhood = anexo, bairro, vizinhança
neighbouring = próximo, adjacente
neither = nem, nenhum, nenhuma, nenhuma pessoa, ninguém
neither ... nor = nem ... nem
neologism = neologismo
neon = de neônio, neónio, neônio
nephew = sobrinho
Neptune = Netuno
nerve = nervo
nervous = nervoso
ness = -dade
nest = fazer seu ninho, ninho
net = bem acabado, distinto, limpo, líquido, polido, rede, trama
nettle = urtiga
network = rede, trama
neutral = neutro
never = jamais, não ... nunca, nunca, em tempo algum
never mind = não importa, pouco importa
nevertheless = não obstante, contudo, embora, entretanto, todavia, porém
new = novo
New Amsterdam = Nova Iorque
New Delhi = Nova Deli
Newfoundland = Terra Nova
newness = novidade
news = coisa nova, inovação, notícia
newspaper = gazeta, folha, jornal
New York = Nova Iorque
New York City = Nova Iorque
New Zealand = Nova Zelândia
next = atrás, depois, em seguida, logo, junto, seguinte, seguinte, próximo
next to = ao pé de, junto a, junto de, perto de, próximo a, ao lado de
nibble = roer
nice = agradável, ameno, aprazível, bom, agradável ao paladar, saboroso
nice guy = bom, virtuoso
niche = nicho
niece = sobrinha
niggard = avarento
night = noite
nightingale = rouxinol
nightmare = íncubo, pesadelo
nightmarish = pesadelar
night-shirt = camisola
Nile = Nilo
nimbus = nimbo
nine = nove
nineteen = dezenove
ninety = noventa
ninth = nono
nip = aperitivo
nipple = bico de mamadeira, mamilo
nitrogen = azote, azoto
no = não
nobleman = nobre
nobody = nenhum, nenhuma, nenhuma pessoa, ninguém
nocturnal = noturno
nod = afirmar com a cabeça
node = encruzilhada, laço, nó, vínculo
no doubt = sem dúvida, sem dúvida alguma
noise = barulho, ruído
noisy = barulhento, ruidoso
no longer = já não, não mais, já ... não, não ... mas
nomad = nômade
nomadic = nômade
none = nenhum, nenhuma, nenhuma pessoa, ninguém
non-military = civil
nonsense = coisa absurda, absurdo, disparate, insensatez
noodles = talharim
noon = meio-dia
no-one = nenhum, nenhuma, nenhuma pessoa, ninguém
no-one's = de pessoa alguma, de ninguém
nor = nem
norm = norma, padrão
normal = regular, habitual, natural, normal
north = norte
North Africa = África Setentrional
North America = América do Norte
northern = boreal, setentrional
Norway = Noruega
Norwegian = norueguês
nose = nariz
nostalgia = nostalgia
nostril = narina
not = não
not an ace = nada, nenhuma quantidade
notary = notário
not at all = de forma nenhuma, de modo nenhum, de nenhuma maneira, de nenhum modo
note = bilhete, cupom, ficha, passagem, escrever nota sobre, tomar nota de, apontamento, nota
not easily = dificilmente
notebook = caderno, fascículo, agenda, livro de notas
not fitting = inoportuno, mal adequado
nothing = coisa alguma, nada, nenhuma coisa
notice = cartaz, edital, papeleta, anúncio, aviso, comunicação, assinalar, notar, observar, nota, observação, reparo
notice-board = quadro de avisos
notification = anúncio, aviso, comunicação
notify = anunciar, avisar, comunicar
notion = noção
not on any account = de forma nenhuma, de modo nenhum, de nenhuma maneira
notwithstanding = a despeito de, apesar de, não obstante
not yet = ainda não
nought = nada, zero
noun = nome, substantivo
nourish = alimentar, nutrir, sustenar
nourishment = alimento
novel = novo, romance
novelty = coisa nova, inovação, notícia
November = Novembro
now = bem, então, pois bem, ora, agora
nowadays = actualmente, atualmente, presentemente
now and then = de quando em quando, de tempo a tempo, de vez em quando
nowhere = em nenhum lugar, em parte alguma, nenhures
nuance = matiz, nuança
nuclear = nuclear
nucleus = âmago, caroço, cerne, núcleo
nude = despido, nu
null = nada, zero
number = número
number sign = diese, sustenido
numeral = algarismo, cifra, número
nun = freira
nurse = cuidar, tratar, zelar, enfermeira, cuidar de criança, aia, ama-seca
nut = noz, parafuso, porca, tarraxa
nuts = ai, bah, insano, louco
nutty = aromática, fragrante
nylon = de náilon, náilon