#setName = words_en_de_bb
#sideOneTitle = ENG
#sideTwoTitle = GER
baboon = Pavian
Babylonia = Babylonien
Babylonian = babylonisch
bachelor = Hagestolz, Junggeselle
back = Rücken, Hinterseite, Rückseite, zurück
back and forth = hin und her
back of the neck = Genick, Nacken
backpack = Tornister
backside = After, Arsch, Gesäß
back street = Armenviertel, Hinterviertel
backward = rückwärts, zurück
backwards = rückwärts, zurück, zurück
back wheel = Hinterrad
bacon = Speck
bacterium = Bakterie
bad = böse, schlecht, faul, faulig
badge = Insignien, Insignum, Wappen
badger = Dachs
bag = Sack, Beutel, Sack
bagasse = Bagasse
baggage = Bagage, Gepäck, Verpackung
Bahrein = Bahrain
bairn = Kind
bait = Köder
bake = backen
baked goods = Backwerk, Gebäck
baker = Bäcker
bakery = Bäckerei, Backstube
baking oven = Backofen
balance = Saldo
balance sheet = Bilanz, Schlußrechnung
balcony = Altan, Balkon
baldachin = Baldachin
Balkans = Balkan
ball = Globus, Kugel, Ball, Sphäre
ballad = Ballade
ballade = Ballade
ballast = Ballast
ball-bearing = Globus, Kugel
ballet = Ballett
ballgame = Ballspiel
ballistics = Ballistik
balloon = Ärostat, Luftballon, Ballon
balm = Balsam
balsam = Balsamine, Balsam
Baltic = Ostsee, baltisch
Baltic Sea = Baltisches Meer, Ostsee
balustrade = Balustrade, Geländer, Schranke
bamboo = Bambus
ban = Bann, Fluch, Bannfluch
banana = Banane, Pisang
band = Bande, Horde, Rotte, Troß
bandage = Bandage, Verband, wickeln, einwickeln
bandit = Bandit, Räuber
bang = zuschlagen
Bangkok = Bangkok
Bangladesh = bengalisch
banisters = Balustrade, Geländer, Schranke
bank = Bank, Bord, Gestade, Küste, Strand, Ufer
bank clerk = Bankier
banker = Bankier
bank manager = Bankier
banknote = Banknote, Schein
bank-note = Banknote, Bon, Schein
bank note = Banknote, Schein
bank official = Bankier
bankruptcy = Bankerott, Fallissement, Fallit
banner = Banner, Fahne, Flagge
banquet = Bankett, Festessen, Gastmahl, Gelage, Zeche
Bantu = Bantu-, Bantu
baptism = Taufe
baptize = taufen
bar = sperren, versperren, Schranke, Brikett, behelligen, hindern, behindern, inhibieren, stören, verhindern
barbarian = Barbar
barbarism = Barbarismus, Sprachwidrigkeit
barber = Barbier, Friseur, Frisör
bard = Barde, Sänger
bare = bloß, nackt
barefoot = barfuß, barfüßig
barely = kaum
bargain = dingen, feilschen, markten
barge = Kahn
baritone = Bariton
barium = Barium
bark = Baumrinde, Barke, Nachen, bellen, anschlagen, Borke, Hülse, Rinde, Schale
barking dear = Muntjak
barley = Gerste
barn = Lagerhütte, Baracke, Bude, Hütte, Scheune
barometer = Barometer
baron = Baron, Freiherr
baroness = Freifrau
barque = Barke, Nachen
barrack = Baracke, Lagerhütte
barracks = Kaserne
barrel = Faß, Tonne, Rohr, Röhre, Schlauch
barrel-organ = Drehorgel, Leierkasten
barren = fruchtlos, steril
barricade = Barrikade, Verhau
barrier = Barriere, Hecke, Sperre, Zaun, Schranke
barrister = Advokat, Anwalt, Rechtsanwalt
barrister-at-law = Advokat, Anwalt, Rechtsanwalt
basalt = Basalt
base = Base, Basis, Grundlage, gemein, infam
Basel = Basel
basement = Keller
basilica = Basilika
basin = Bassin, Wasserbecken, Becken, Schale
basis = Base, Basis, Grundlage
basket = Korb
Basle = Basel
Basque = Baskisch, Baske
Basque language = Baskisch
bas-relief = Basrelief
bass = Baß, Barsch
bass-viol = Baßgeige
bass voice = Baß
bast = Bast
bastard = Bastard, Mischling
bastion = Bastei, Bastion, Bollwerk
bat = Fledermaus
Batavian = batavisch, Bataver
bath = Bad
bathe = baden
bathing-suit = Badeanzug
bathing suit = Badeanzug
bathroom = Bad, Badestube
batiste = Batist
baton = Stab, Stecken, Stock
battalion = Bataillon
battery = Akku, Akkumulator, Stromspeicher, Batterie
battle = Kampf, Schlacht
battlefront = Front, Vorderseite
Bavaria = Bayern
Bavarian = bayerisch, bayrisch, Bayer
bay = Bai, Bucht
bayonet = Bajonett
bazaar = Basar, Markt, Warenhaus
be = werden
be able to = dürfen, können, vermögen
be about = umlaufen, zirkulieren
beach = Strand
be acquainted with = kennen
be afraid of = fürchten, befürchten, sich ängsten, sich ängstigen, zagen
beak = Schnabel
be alive = leben
be allowed to = dürfen
beam = Strahl, Balken
bean = Bohne
be angry = grollen, zürnen
be answerable = verantworten
be appropriate = behagen, fügen, ziemen, geziemen
bear = austragen, gebären, zur Welt bringen, erzeugen, hervorbringen, produzieren, aushalten, dulden, erdulden, ertragen, leiden, erleiden, Bär
beard = Bart
beardless = bartlos
bear's-ear = Alpen-Aurikel, Gamsblume
bear witness of = beglaubigen, bescheinigen, bezeugen
be ashamed = sich schämen
be asleep = schlafen
beast = Tier
beat = hauen, schlagen
beautiful = hübsch, schön
beaver = Biber
be aware of = bei Bewußtsein sein, sich ... bewußt sein
be bankrupt = fallieren
be bored = sich langweilen
be born = entstehen
be called = heißen
because = weil, da, denn, weil
because of = anläßlich, halber, um ... willen, wegen
Bechuanaland = Botswana
be closed = zufallen
become = geschehen, vorkommen, zu stande kommen, werden
becoming = angemessen, füglich, geeignet, zeitgemäß
be conscious of = bei Bewußtsein sein, sich ... bewußt sein
bed = Beet, Bett, Bettstelle
bedbug = Wanze
be delirious = delirieren, irre reden
be detained = zurückbleiben
be different = abweichen, differieren, sich unterscheiden
Bedouin = Beduine
bedroom = Schlafzimmer
bee = Biene
beech = Buche
beef = Rindfleisch
be effective = wirken, einwirken, erwirken
beefsteak = Beefsteak
beehive = Bienenkorb, Bienenstock
bee-keeper = Imker, Bienenzüchter, Zeidler
bee-keeping = Bienenzucht
bee-master = Imker, Bienenzüchter, Zeidler
beer = Bier
beet = Beete, Mangold, Runkelrübe
beetle = Käfer
befit = gehören, schicken, sich gehören, ziemen
be fitting = gehören, schicken, sich gehören, ziemen
be fond of = mögen
before = jüngst, vor, bevor, ehe
be found = sich aufhalten, sich befinden
be full = gesättigt sein, satt sein
beg = bitten, ersuchen
beggar = Bettler
begin = anbrechen, anfangen, beginnen
beginning = Anfang, Beginn
be glad = frohlocken, sich freuen
beguine = Beguine
behave = sich aufführen, sich benehmen, sich betragen, sich verhalten
behavior = Aufführung, Benehmen, Betragen, Gebahren, Verhalten
behaviour = Aufführung, Benehmen, Betragen, Gebahren, Verhalten
behead = enthaupten
behind = hinten, hinter, nach
behold = da, hier, hier ist, siehe
be in command = befehlen, befehligen, gebieten, kommandieren
be indignant = aufgebracht sein, entrüstet sein, sich entrüsten
be in labour = entbinden
be in opposition = opponieren
be interested = sich interessieren
be in the habit of = sich gewöhnen
be kept in = zurückbleiben
be lacking = fehlen, mangeln, ermangeln
be late = sich verspäten
belch = aufstoßen, rülpsen
be lenient with = nachsichtig sein, schonen, verschonen
Belgian = belgisch, Belgierin, Belgier
Belgian woman = Belgierin
Belgium = Belgien
Belgrade = Belgrad
be liable = verantworten
belief = Glaube, Glauben
believe = glauben
bell = Glocke, Klingel, Schelle
belladonna = Belladonna, Tollkirsche
belles-lettres = Belletristik
bellflower = Glockenblume
bellow = blöken, brüllen, quaken, wiehern
belly = Hinterleib, Bauch, Unterleib
be located = sich aufhalten, sich befinden
belong to = gehören, angehören, zugehören
beloved = beliebt, Geliebte
below = unter, unten, unterhalb
belt = Gurt, Gürtel
be lucky = Glück haben
be married = sich verehelichen, sich verheiraten
be missing = fehlen, mangeln, ermangeln
bench = Arbeitsbock, Bank, Gestell, Staffel, Staffelei, Werkstuhl
bend = beugen, flektieren, sich beugen, neigen, hinneigen, biegen, sich beugen, Kurve
beneath = unter, unterhalb
Benedictine = Benediktiner
Benedictine monk = Benediktiner
benefit = Gewinn, Überschuß, Verdienst, Interesse, Nutzen, Vorteil
benefit performance = Benefiz
Benelux = Benelux
Bengal = Bengalen, bengalisch
bengal-light = bengalisches Feuer
bengal-lights = bengalisches Feuer
bent = gebogen, krumm
be obstinate = sich eigensinnig in den Kopf setzen, trotzen
be on duty = den Dienst haben, Posten stehen
be painful = Schmerz verursachen, schmerzen, wehe tun
be proud = stolzieren
bequeath = testieren, vererben
be quiet = schweigen
Berber = Berber
be responsible = verantworten
beret = Barett
bergamot = Bergamotte
Berlin = Berlin, berliner
Berliner = Berlinerin, Berliner
Berlin lady = Berlinerin
Berlin woman = Berlinerin
Berne = Bern
berry = Beere
beryl = Beryll
beryllium = Beryllium
beseech = beschwören, flehen
beside = neben, an, bei, zu
besides = übrigens, ausgenommen, außer, zudem, außerdem, fort, weiter
besiege = belagern
be similar = ähneln, gleichen
be situated = liegen
be sorry about = bedauern
Bessarabia = Bessarabien
best = best
be stubborn = sich eigensinnig in den Kopf setzen, trotzen
be succesful = gedeihen, gelingen, geraten, glücken, prosperieren
be suitable = behagen, fügen, ziemen, geziemen, taugen
bet = wetten, Wette
be taken ill = erkranken, krank werden
be thirsty = dürsten
Bethlehem = Bethlehem
be tired of something = sich langweilen
betray = verraten
betrayal = Treubruch, Verrat
betrothal = Verlobung
better = besser
between = unter, mitten unter, zwischen
be vacant = leerstehen, offen sein, vakant sein
be valid = gelten
beverage = Getränk, Trank
bevy = Ar, Bande, Horde, Rotte, Troß
be willing to = wollen
bewitch = bezaubern, verhexen, verzaubern, hexen, Zauberei treiben, zaubern
be worth = aufwiegen, gelten, sich verlohnen, wert sein
be worthy of = verdienen
beyond = weiter, danach, über ... hinaus, vorbei, vorüber, jenseits, quer, über, hinüber
Bhutan = Bhutan
biased = parteiisch
bible = Bibel
bibliography = Bibliographie
bicolour = zweifarbig
bicoloured = zweifarbig
bicycle = Rover, Rad, Fahrrad
bid = bitten, ersuchen
big = groß
bike = Rover, Rad, Fahrrad
bile = Galle
bill = Schnabel, Billett, Fahrkarte, Karte, Faktura, Rechnung, Warenrechnung
bill-board = Anschlagbrett, Anschlagebrett
billiards = Billard
bill of exchange = Wechsel
billow = Sturzwelle, Woge
bind = einbinden, binden, verbinden
binding = Binde, Streifen, Einband
binocular = Fernrohr, Perspektiv
binoculars = Binokel, Fernglas, Fernrohr, Perspektiv
birch = Birke
bird = Vogel
birds = Geflügel
birth = Geburt
birthday = Geburtstag
Biscay = Biskaya
biscuit = Biskuit, Bisquit, Zwieback
bishop = Bischof
bismuth = Wismut
bison = Bison
bit = Fleck, Stück
bite = beißen, Biß
bite off = abbeißen
bit-player = Statist
bitter = bitter
black = Schwarz
blackberry = Brombeere
blackbird = Amsel
Black Forest = Schwarzwald
blackness = Schwärze
black radish = Rettich
bladder = Blase
blade = Klinge, Halm, Stengel, Stiel
blame = imputieren, zur Last legen, zuschreiben, anklagen, beschuldigen, verklagen, Vergehen, schelten, vorwerfen, Vorwürfe machen
blanch = bleichen, weißen
blank = weiß, Formular
blanket = Bettdecke, Decke
blaspheme = lästern
blasphemy = Fluch, Frevel
bleak = widerwärtig, dunkel, düster, trübe, wehmütig, kahl
bleat = blöken, brüllen, quaken, wiehern
bleed = bluten
blend = mengen, mischen
bless = segnen
blind = blind, Blinder
blindness = Blindheit
blink = blinzeln, zwinkern
block = blockieren, Block, Holzscheit, Klotz, Scheit, pfropfen, stopfen, verstopfen, zustopfen
blockade = Blockade, blockieren
blond = blond
blood = Blut
blood-relationship = Verwandtschaft
bloody = Blut-, blutig
bloom = Blume
blot = Fleck, Flecken, Klecks
blotter = Löschpapier
blotting paper = Löschpapier
blouse = Bluse
blow = Hieb, Schlag, Streich, blasen, wehen
blow up = übertreiben, dick auftragen
blue = blau
Bluebeard = Blaubart
blueberry = Blaubeere, Heidelbeere
bluebottle = Aasfliege
blunt = stumpf, abstumpfen
blush = erröten, rot werden
blushing = rot
boa = Riesenschlange, Riesenschlange, Boa
board = Brett, Tafel
boarding house = Fremdenheim, Pension
boarding school = Fremdenheim, Pension
board of directors = Behörde, Vorstand
boast = ausposaunen, brüsten, prahlen, renommieren
boat = Boot, Schaluppe
bobbin = Haspel, Spule
body = Körper, Leib
Boer = Bure
Bohemia = Böhmen
Bohemian = böhmisch, Böhme
boil = brausen, kochen, sieden, wallen
boiled egg = Spiegelei
boiler = Kessel
bold = dick
Bolivia = Bolivien
bolt = verriegeln, zuriegeln, Verschluß
bomb = Bombe
bombard = beschießen, bombardieren
bonbon = Bonbon
bon-bon = Bonbon
bond = Band, Obligation, Schuldverschreibung, Verpflichtung
bondwoman = Sklavin
bone = Gebein, Knochen
bonnet = Kapotte, Haube, Kappe
book = Buch, bestellen
bookcase = Bücherschrank
book-keeper = Buchhalter
bookseller = Buchhändler
bookshop = Buchhandlung
bookstore = Buchhandlung
boot = Stiefel
booty = Beute, Raub
booze = Spirituosen
borax = Borax
Bordeaux = Bordeaux
border = Bord, Gestade, Küste, Strand, Ufer, Grat, Kante, Saum, Rand
bore = bohren, Bohrer, verdrießen
boring = überdrüssig, verdrießlich
Borneo = Borneo
boron = Bor
borrow = borgen, leihen, darleihen, entlehnen, verleihen
borscht = Beetensuppe
borstch = Beetensuppe
Bosnia = Bosnien
Bosnia-Hercegovina = Bosnien und Herzegowina
Bosnian = bosnisch, Bosniake, Bosnier
bosom = Brust, Busen
boss = Befehlshaber, Häupling, Herr, Oberhaupt, Vorsteher, Wirt, Chef, Haupt
botany = Botanik, Pflanzenkunde
botch = pfuschen
both = beide
bother = beengen, behindern, belästigen, genieren, lästig werden, stören
Botswana = Botswana
bottle = Flasche, anzapfen
bottom = Boden, Grund
bottom of the sea = Meeresboden
bough = Ast, Zweig
bouillon = Bouillon, Brühe, Fleischbrühe
boulder = Fels, Felsen
boulevard = Boulevard
bound = abgrenzen
boundary = Grenze, Schranke
bouquet = Blumenstrauß, Bouquet, Bukett, Strauch
bourgeois = bürgerlich
bourgeoisie = Bürgerschaft
boutique = Butike, Geschäft, Kramladen, Laden
bovine = Rind
bovine animal = Rind
bow = Bogen, Bügel, Bug, biegen, sich verneigen, Reverenz, Verbeugung
bowl = Becken, Schale
box = boxen, Kasten, Kiste, Truhe, Dose, Büchse, Schachtel, Behälter, Besteck, Krug
boxer = Boxer
box-room = Gewahrsam
box-tree = Buchsbaum
boy = Junge, Knabe, Bursche, Diener, Gehilfe
Brabant = Brabant
Brabantine = brabantisch, Brabanter
brace = Armatur, Klammer, Krampe
bracelet = Armband
braces = Hosenträger
bracket = Klammer, Krampe
brag = ausposaunen, brüsten, prahlen, renommieren
braid = Binde, Verband, flechten, schlingen, winden
brain = Gehirn, Hirn
brake = Bremse
branch = Ast, Zweig, Abteilung, Fach, Filiale, Nebengeschäft, Zweigniederlassung
brandish = schlingen, schwingen
brandy = Branntwein, Schnaps, Kognak
brass = Latun, Messing
brat = Bube, Bursche
brave = brav, tüchtig, wacker, beherzt, dreist, getrost, mutig, tapfer
bray = iahen
Brazil = Brasilien
Brazilian = brasilianisch, Brasilianer
Brazilian woman = Brasilianerin, Brasilierin
breach = Bresche, Lücke
bread = Brot
break = Pause, abbrechen, aufbrechen, brechen
break down = verderben
breakfast = Frühstück
break into = anbrechen
break of a habit = abgewöhnen, entwöhnen
break off = abbrechen
break oneself of a habit = abgewöhnen
break up = auseinandergehen
bream = Brasse, Brassen
breast = Busen, Brust, Mutterbrust
breath = Atem, Hauch
breathe = atmen
breed = tierzüchten, aufziehen, bilden, erziehen, züchten, Rasse
breeze = Brise
Bretagne = Bretagne, die Bretagne
Breton = Bretone
bribe = korrumpieren, verderben, bestechen, erkaufen
brick = Backstein, Ziegel, Ziegelstein
bride = Braut
bridge = Brücke
bridle = zügeln, Zaum, Zäumung
brief = kurz
brigade = Brigade
bright = blank, licht, lichtvoll, hell
brilliant = blank
brim = Grat, Kante, Saum, Rand
brimstone = Schwefel
bring = bringen, anbringen, eintragen, heranbringen, überbringen
bring along = mitbringen, mitnehmen
bring away = abtragen, fortbringen, wegtragen
bring up = aufziehen, bilden, erziehen, züchten
brinjal = Eierfrucht, Eierpflanze, Aubergine, Eierfrucht
brink = Grat, Kante, Saum, Rand
brisk = aufgeweckt, flink, frisch, gewandt, hurtig, munter, wach
bristly = struppig
Britain = Britannien
British = britisch
Briton = Brite
Brittany = Bretagne, die Bretagne
broach = anbrechen
broad = breit, weit
broken = defekt
broker = Makler
bronze = ehern, Bronze, Erz
brooch = Brosche
broom = Besen
brothel = Bordell, Freudenhaus, Puff
brother = Bruder
brother-in-law = Schwager
brothers and sisters = Geschwister
brow = Augenbraue
brown = braun
brownie = Gnom
Bruges = Brügge
bruise = quetschen, wundstoßen
Brunhild = Brünnhilde
Brunswick = Braunschweig
brush = Bürste
Brussels = Brüssel, brüsseler
Brussels-sprouts = Rosenkohl
brutal = brummig, unwirsch
brute = brutal
bubble = Blase
Bucharest = Bukarest
bucket = Eimer
buckle = Schnalle, Spange
bud = Knospe, Sproß, Sprößling
Budapest = Budapest
Buddha = Buddha
buddy = Genosse, Kamerad
budget = Budget
buffalo = Bison, Büffel
buffer = Puffer
buffet = Büfett, Schankraum
buffoon = Hanswurst, Harlekin
bug = Wanze, Insekt
build = bauen, aufbauen, erbauen, konstruieren, mauern, zimmern
build from wood = zimmern
building = Anbau, Bau, Bauwerk, Gebäude
bulb = Birne, Zwiebel
Bulgar = Bulgare
Bulgaria = Bulgarien
Bulgarian = bulgarisch, Bulgare
Bulgarian woman = Bulgarin
bulk = Ausdehnung, Bereich, Dimension, Fassung, Gehalt, Umfang
bull = Stier
bullet = Kugel
bulletin = Bericht, Bulletin
bumblebee = Hummel
bump = Buckel, Höcker
bumper = Puffer
bumpy = uneben
bunch = Bund, Bündel, Büschel, Fascikel
bundle = Bund, Bündel, Büschel, Fascikel
bungle = pfuschen
buoy = Boje
burden = beauftragen, belasten, laden, aufladen, beladen, Belastung, Bürde, Fuhre, Ladung, Last
bureau = Amt, Büro
burglar = Einbrecher
burgomaster = Bürgermeister, Dorfschulze
Burgundian = burgundisch, Burgunder
burial = Begräbnis, Beisetzung
Burma = Birma
Burmese = birmanisch
burn = brennen, verbrennen, entbrennen, zünden
burp = aufstoßen, rülpsen
burst = bersten, platzen, zerplatzen, zerspringen
Burundi = Burundi
bury = vergraben, beerdigen
bus = Autobus, Bus
bush = Gebüsch, Staude, Strauch
Bushman = Buschmann
business = Angelegenheit, Ding, Sache, Werk, Handel, Geschäft, Unterhandlung
business deal = Angelegenheit, Ding, Sache, Werk
businessman = Händler, Kaufmann
busy = besetzt
but = ausgenommen, allein, dagegen, sondern, aber, doch, dennoch, jedoch
butcher = erschlagen, schlachten, Fleischer
butter = Butter
buttercup = Hahnenfuß, Ranunkel
butterfly = Falter, Schmetterling
button = Knopf, knöpfen, zuknöpfen
buy = sich kaufen, sich kaufen, sich kaufen, sich kaufen, sich kaufen, kaufen, sich kaufen
buzz = summen
by = an, bei, neben, von, um, gemäß, nach, durch, kraft, mit, mittelst, vermittels, über ... hinaus, vorbei, vorüber
by chance = zufällig
by day = tags
bye = adieu, auf Wiedersehen, lebe wohl
by heart = auswendig, aus dem Kopfe
by marriage = Schwieger-
by means of = durch, kraft, mit, mittelst, vermittels
by night = nachts, nächtlich, nächlicherweile
by no means = auf keiner Weise, gar nicht, in keiner Weise, keineswegs
by now = bereits, schon
by twos = zu zweien
Byzantine = byzantinisch
Byzantium = Byzanz