#setName = words_en_de_ef
#sideOneTitle = ENG
#sideTwoTitle = GER
each = à, je, zu, aller, jeder, ein jeder, jedermann, jeglicher
each other = einander
each time = allemal, jedesmal
eager = begierig, habgierig, lüstern
eagerness = Gelüst, Gierde, Habsucht
eagle = Adler, Aar
eagle owl = Uhu
ear = Ohr, Ähre
earl = Graf
early = früh, zeitig
earmark = ausersehen, bestimmen, festsetzen
earn = erringen, gewinnen
earnest = ernst, ernsthaft, gesetzt
earth = Boden, Erdboden, Erde, Grund, Land, Terrain
earth connection = Erdleitung
earthen = irden, irdisch, terrestrisch, erdhaft
earthenware = Fayence, Steingut
earthing = Erdleitung
earthly = irdisch, terrestrisch, erdhaft
earthquake = Erdbeben
earthquake shock = Erdstoß, Erderschütterung
earth's axis = Erdachse
earth's crust = Erdrinde, Erdkruste
earth wire = Erdleitung
earthworm = Regenwurm
easel = Arbeitsbock, Bank, Gestell, Staffel, Staffelei, Werkstuhl
east = nach Osten, ostwärts, Orient, Osten
East Asia = Ostasien
Easter = Ostern
eastern = östlich
East Friesland = Ostfriesland
East Germany = Deutsche Demokratische Republik, DDR
eastward = nach Osten, ostwärts
eastwards = nach Osten, ostwärts
easy = geläufig, leicht, mühelos, nicht schwierig
eat = essen, fressen, genießen, speisen
eat up = aufessen, aufzehren
eavesdrop = belauschen
ecclesiastic = geistlich
echo = Echo, Widerhall
economy = Ökonomie, Wirtschaft
ecstasy = Ekstase, Entzückung
Ecuador = Ecuador
edelweiss = Edelweiß
Eden = Eden
edge = Bord, Gestade, Küste, Strand, Ufer, Grat, Kante, Saum, Rand
edging = Grat, Kante, Saum, Rand
edible = eßbar, genießbar
edify = erbauen, erheben
edit = redigieren, stilisieren
edition = Auflage, Ausgabe, Herausgabe, Verlag
editor = Redakteur, Schriftleiter
editorial office = Redaktion
educate = aufziehen, bilden, erziehen, züchten
educated = gebildet, gesittet
education = Zucht, Züchtung, Erziehung, Unterricht
eel = Aal
eelworm = Aaltierchen
effect = Effekt, Wirkung, Wirksamkeit, Erfolg, Ergebnis, Resultat
effective = drastisch, zweckdienlich
effectual = drastisch, zweckdienlich
efficacious = drastisch, zweckdienlich
effort = Bemühung, Versuch, Mühe, Mühsal
efforts = Anstrengung
egg = Ei
eggfruit = Eierpflanze, Aubergine, Eierfrucht
eggplant = Eierfrucht, Aubergine, Eierpflanze
Egypt = Ägypten
Egyptian = egyptisch, Ägypter
eight = acht
eighteen = achtzehn
eighteenth = achtzehnte
eighth = achte
eight hundred = achthundert
eighty = achtzig
either ... or = entweder ... oder
elastic = elastisch, federnd
Elbe = Elbe
elbow = Ellbogen
elder = Holunder
elderly = bejahrt
elect = auslesen, wählen, auswählen, erwählen
election = Auslese, Wahl
electric fan = Ventilator
electricity = Elektrizität
electric plug = Pfropfen, Spund, Stöpsel
elegant = elegant, geschmackvoll
elegy = Elegie, Klagelied
element = Element, Fundament, Grundlage
elemental = elementar
elementary = elementar
elements = Alphabet
elephant = Elefant
elevator = Aufzug, Fahrstuhl, Lift
eleven = elf
elf = Elf
eliminate = ausschalten, ausstoßen, eliminieren, wegschaffen
elk = Elch, Elen, Elentier
elm = Rüster, Ulme
eloquent = beredsam, beredt, eloquent
Elsass = Elsaß
else = anderer, andernfalls, anders, sonst, ferner, fürder, mehr, weiter
elsewhere = anderswo
Elysium = Elysium
embalm = balsamieren
embankment = Damm, Deich, Wehr
embarrass = verhindern
embarrassment = Hemmnis, Lästiges, Verlegenheit
embassy = Botschaft, Gesandtschaft
embassy building = Botschaft, Gesandtschaft
embellish = verschönern
emblem = Abzeichen, Emblem, Sinnbild
embody = verkörpern
embrace = umarmen, umfassen, umschlingen
embroider = sticken
emerald = Smaragd
emerge = erscheinen
emergency = Krisis, Krise
emigrate = auswandern
eminent = ansehnlich, eminent, hervorragend
emissary = Bote, Botschafter, Gesandter
emmet = Ameise
emotion = Empfindung, Bewegung, Rührung
emperor = Imperator, Kaiser
emphasis = Begeisterung, Emphase, Schwung
emphasize = unterstreichen
empire = Kaiserreich, Kaisertum
employ = anwerben, dingen, heuern, mieten, anwenden, benutzen, brauchen, gebrauchen, verwenden, verwerten
empty = leer, ausleeren, entleeren
enamel = Emaille
enchanter = Zauberer
enchantment = Zauber, Zaubern
encore = noch einmal
encounter = antreffen, begegnen, Begegnung
encourage = anspornen, antreiben, aufhetzen, herausfordern, ermannen, ermutigen, aufmuntern, ermuntern
encouragement = Ermutigung, Ermunterung
encyclopaedia = Encyklopädie
end = beschließen, beenden, beendigen, erledigen, enden, endigen, Endung, Ende
endeavour = trachten nach, sich abmühen, sich anstrengen, sich bemühen, sich Mühe geben
ending = Ende
endive = Endivie
endorsement = Giro
endow = ausstatten, dotieren
end up = ankommen, eintreffen, gelangen, zukommen, herzukommen, enden, endigen, hingeraten
endure = dauern, währen, austragen, ausstehen, aushalten, erdulden, ertragen, leiden, erleiden, dulden
energetic = forsch, tüchtig
energy = Energie, Tatkraft, Willenskraft
engage in a controversy = polemisieren
engagement = Verlobung
engine = Lokomotive, Maschine, Motor
engineer = Ingenieur
England = England
English = Englisch, englische Sprache, Engländerin
English language = Englisch, englische Sprache
Englishman = Engländer
Englishwoman = Engländerin
engrave = gravieren
engraving = Gravüre, Stahlstich
engulf = verschlingen
enhance = vermehren
enigma = Rätsel
enjoy = frohlocken, sich freuen, genießen, sich freuen an
enjoyable = behaglich, herrlich, genehm, angenehm
enlargement = Anwuchs, Vergrößerung, Vermehrung, Zunahme
enlighten = illuminieren
ennumeration = Zählung
enormously = außerordentlich, höchst, überaus, ungemein
enough = auskömmlich, zulänglich, genug, genügend, hinlänglich, ziemlich
entangle = einwickeln, hineinziehen, verwickeln
enter = stecken, eintreten, buchen, einschreiben, eintragen, verschreiben, hereinkommen, hineinkommen
enterprise = Unternehmung
entertain = zerstreuen, beherbergen, gastieren, bewirten, regalieren, traktieren
entertaining = amüsant, unterhaltend, unterhaltsam, ergötzlich
enthusiasm = Begeisterung, Enthusiasmus
entice = verführen, verlocken, in Versuchung führen, versuchen
entire = ganz, total
entirely = völlig, ganz, gänzlich, gar
entrance = Eingang
entrust = beauftragen, betrauen, betrauen mit, vertrauen mit, Vertrauen setzen in, zutrauen
envelop = einhüllen, einschlagen, einwickeln, umhüllen, umschlagen
envelope = Briefumschlag, Kuvert, Umschlag
environment = Milieu, Umgebung
environs = Umgebung
envoy = Bote, Botschafter, Gesandter
envy = beneiden
epaulet = Achselklappe, Epaulette
epic poem = Epik, Epopöe, Heldengedicht
epilepsy = Epilepsie, Fallsucht
Epiphany = Dreikönigsfest
episode = Episode, Zwischenfall, Zwischenhandlung
epistle = Epistel, Sendschreiben
epoch = Epoche, Zeitabschnitt
equal = egal, gleich, entsprechen
equality = Gleichheit
equally = gleich, gleichfalls
equator = Äquator
equilibrium = Gleichgewicht
equip = ausrüsten, equipieren
equivalent = gleichwertig, Äquivalent, Ersatz
era = Epoche, Zeitabschnitt, Ära
eradicate = ausreißen, entwurzeln
eraser = Gummi
erect = etablieren, fundieren, gründen, begründen
erecting = Zusammenstellung
erotic = erotisch
err = sich irren
errand = Auftrag, Bestellung, Kommission
erroneous = falsch, irrig
error = Fehler, Irrtum, Versehen
eryngo = Mannstreu
erysipelas = Rose, Rotlauf
escort = Geleit, eskortieren, geleiten, Eskorte
Eskimo = Eskimo
especially = zunächst, zuvörderst, besonders, eigens, insbesondere, vornehmlich, vorzüglich, zumal
Esperantist = Esperantist
Esperanto = Esperanto
essay = These
essence = Essenz, Wesen
establish = etablieren, fundieren, gründen, begründen, als Tatsache feststellen, konstatieren
establishment = Etablissement
estate = Bauernhof, Besitzung, Gut, Landgut
esteem = achten, hochschätzen, Achtung, Verehrung, berücksichtigen, betrachten, erwägen, sich überlegen, Ansehen
estimate = bewerten, schätzen, abschätzen, einschätzen
Estonia = Estland
Estonian = estisch, Este
etc. = u.s.w.
etching = Scheidewasser
eternal = ewig
ether = Äther
ethic = Ethik, Sittenlehre
ethics = Ethik, Sittenlehre
Ethiopia = Äthiopien
Ethiopian = äthiopisch
ethnic group = Abkunft, Geschlecht, Gezücht, Sippe, Stamm
etiquette = Etikette
eunuch = Entmanntner, Eunuch, Verschnittener
Europa = Europa
Europe = Europa
European = europäisch, Europäer
European bizon = Wisent
European Union = Europäische Union
evade = ausweichen, entgegen, entweichen, meiden, vermeiden
evangelic = evangelisch
even = eben, glatt, flach, ebnen, egal, gleich, gar, ja, selbst, sogar, ausgeglichen, quitt, Paar-, gepaart, paarig, paarweise
evening = Abend
evening dress = Frack, Rock
evening meal = Abendessen, Abendmahl, Souper
evening paper = Abendzeitung
Evening Star = Venus
evening twilight = Dämmerung, Abenddämmerung
event = Begebenheit, Begebenheit, Gelegenheit, Geschehnis, Fall, Vorfall, Ereignis
eventual = etwaig, eventuell
ever = ehemals, einmal, einst, einstens, einstmals, irgendwann, je, jemals, allemal, allzeit, fortwährend, immer, jederzeit, stets
ever = auch immer, auch nur
everlasting = endlos, unendlich
ever since = seit
every = aller, jeder, ein jeder, jedermann, jeglicher
everybody = aller, jeder, ein jeder, jedermann, jeglicher
everyday = üblich, verständlich, vulgär
every kind of = allerhand, jeglicher
every one = aller, jeder, ein jeder, jedermann, jeglicher
everyone's = jedermanns, jedes
everything = alles
every time = allemal, jedesmal
everywhere = allenthalben, allerorten, überall
evident = anschaulig, augenscheinlich, ersichtlich, evident, offenbar
evoke = herausfordern, hervorrufen
ex- = Ex-
exact = exakt, genau, requirieren, recht, richtig, zutreffend
exaction = Erpressung
exactly = bündig, gerade
exactness = Genauigkeit
examination = Examen
examine = examinieren, inspizieren, nachsehen, prüfen, forschen, ausforschen, erforschen, unterforschen, untersuchen
example = Beispiel, Exempel
exceed = bewältigen, überflügeln, übersteigen, überragen, übertreffen
exceedingly = ungemein
excellency = Eminenz, Erlaucht, Exzellenz, Hoheit, Majestät
except = ausnehmen, ausschließen, ausgenommen, außer
except for = ausgenommen, außer
exception = Ausnahme
excess = Ausschreitung, Exzeß
exchange = Wechsel
excise = Akzise, Verbrauchssteuer
excise-duty = Akzise, Verbrauchssteuer
excitation = Anregung, Erregung
excite = anfeuern, aufregen, anregen, ermutigen, erregen, anreizen, aufhetzen, reizen, aufreizen
excitement = Anregung, Erregung
exclude = ausnehmen, ausschließen
exclusively = ausschließlich, exklusive, allein, bloß, erst, lediglich, nur
excommunication = Bann, Fluch, Bannfluch
excursion = Ausflug, Exkursion
excuse = entschuldigen
execute = exekutieren, hinrichten, vollstrecken
executioner = Henker
exercise = exerzieren, üben, einüben, Exerzitium, Übung
exercise-book = Heft
exert = praktizieren
exhibition = Ausstellung
exhortation = Ermahnung, Zuspruch
exile = bannen, ins Exil schicken, verbannen, Acht, Exil, Verbannung
exist = bestehen, da sein, existieren, vorhanden sein
existence = Bestehen, Dasein, Existenz
exit = Ausgang, ausgehen, ausrücken
Exodus = Exodus
expansion = Ausdehnung, Expansion
expect = gewärtigen, harren, warten, erwarten
expectation = Anwartschaft
expel = austreiben, ausweisen, fortjagen, vertreiben, wegjagen
expenses = Aufwand, Ausgabe, Auslage, Spesen
expensive = teuer
experience = Erfahrung, Erlebnis
experienced = geübt, bewandert, erfahren, gewiegt, kundig
experiment = Experiment, Versuch
expert = geübt, bewandert, erfahren, gewiegt, kundig
expertness = Geschicklichkeit, Gewandtheit
expire = enden, endigen, sterben
explain = darlegen, einleuchten, erklären, erläutern
explanation = Aufklärung, Aufschluß, Erläuterung
explode = explodieren, platzen
exploit = ausbeuten, ausnutzen, exploitieren
exploration = Untersuchung
explore = forschen, ausforschen, erforschen, unterforschen, untersuchen
explosion = Explosion
export = ausführen, exportieren
exposition = Ausstellung
express = Expreß, ausschließen, aussondern, ausdrücken
express condolences = Beileid bezeigen, kondolieren
expression = Ausdruck, Äußerung, Aussehen, Äußere, Gesicht, Miene
extend = Ausdehnung, Bereich, Dimension, Fassung, Gehalt, Umfang, ausbreiten, ausrecken, strecken, ausstrecken, erstrecken
extension = Suffix
extensive = ausgedehnt, geräumig, weit
exterior = Äußere, Habitus
exterminate = austilgen, ausrotten, tilgen, vertilgen
extinguish = auslöschen, dämpfen
extort = erzwingen
extortion = Erpressung
extra = besonders, extra
extract = ausziehen, extrahieren
extraordinarily = ungemein
extraordinary = außerordentlich
extreme = äußerster, extrem
extremely = außerordentlich, höchst, überaus, ungemein
eye = Auge
eyebrow = Augenbraue
eyelid = Augenlid
fable = Fabel
fabric = Gewebe, Gewirk
fabricate = anfertigen, fabrizieren, herstellen, verfertigen
façade = Fassade
face = Angesicht, Antlitz, Gesicht
face-ache = Gesichtsreißen
facile = geläufig, leicht, mühelos, nicht schwierig
facilitate = erleichtern
fact = Tatsache
faction = Fraktion, Partei
factory = Fabrik
factual = faktisch, wirklich
faculty = Fakultät
fade = erblassen, verblassen, welken, verwelken
fag out = strapazieren
fail = abortieren, unterlassen
failure = Bankerott, Fallissement, Fallit, Fiasko, Mißerfolg
faint = flau, gelinde, schwach, in Ohnmacht fallen, ohnmächtig werden
fair = Basar, Warenhaus, blond, Markt, Messe, billig, gerecht
fairly = ziemlich
fairy = Fee
fairy tale = Märchen
faith = Zuversicht
faithful = gläubig, treu, bieder, loyal
falcon = Falke
fall = entfallen, verfallen, fallen, Fall
fall ill = erkranken, krank werden
fall off = entfallen, verfallen
false = falsch
false acacia = Robinie
falsify = fälschen
fame = Fama, Gerücht, Ruf, Berühmtheit, Glorie, Renommee
familiarity = Bekanntschaft
family = Familie
family tree = Genealogie, Geschlechtsregister
famous = berühmt, glorreich
fan = antreiben, anfeuern, fächeln, wedeln, Fächer
fanatical = fanatisch, leidenschaftlich
fancier = Amateur, Liebhaber
fancy = erdichten, sich einbilden, sich vorstellen, schwärmen, träumen, wähnen
fanfare = Fanfare, Tusch
fantasy = Einbildungskraft, Phantasie
far = entlegen, fern, entfernt, weit
far away = weit
fare = sich befinden
farewell = adieu, auf Wiedersehen, lebe wohl, Abschied, Valet
farm = Bauernhof, Besitzung, Gut, Landgut, pachten, verpachten
farm- = agrarisch
farmer = Bauer
farming = Ackerbau
farther = weiter
fashion = Mode, Weise
fast = fasten, fest, feststehend, firm, gediegen, stabil, wiederstandsfähig, hurtig, rasch, flugs, geschwind, schnell
fasten = anschließen, befestigen, festsetzen, fixieren, verriegeln, zuriegeln
fast train = Eilzug
fat = dick, feist, fettig, geil, Fett, wohlbeleibt
fate = Bestimmung, Fügung, Geschick, Los, Schicksal, Verhängnis
fateful = fatal, verhängnisvoll
father = Vater, Pater
father-in-law = Schwiegervater
fatherland = Heimat, Vaterland
fatty = feist, fett, fettig, geil
faucet = Hahn, Kran, Zapfen
fault = Vergehen
favour = begünstigen, Gnade, Gunst, Huld, Vergünstigung, Gefallen, Gefälligkeit
favourable = gewogen, gnädig, günstig, hold
fawn = Spießer
fear = fürchten, befürchten, sich ängsten, sich ängstigen, zagen, Angst, Furcht
feast = Bankett, Festessen, Gastmahl, Gelage, Zeche
feather = Feder
feature = Gesichtszug, Zug
February = Februar
federation = Bundesgenossenschaft, Föderation
fee = Honorar
feed = essen, fressen, genießen, speisen, beköstigen, hegen, nähren, ernähren, weiden
feel = befühlen, tasten, antasten, betasten, tappen, empfinden, fühlen, Sinn
feeling = Sinn
feign = erheucheln
feldspar = Feldspat
felloe = Felge
fellow = aneinander-, Mann
felly = Felge
felspar = Feldspat
felt = Filz
female ambassador = Botschafterin
female cat = Mieze
female cook = Köchin
female slave = Sklavin
female teacher = Lehrerin
fence = Hecke, Schranke, Sperre, Zaun, Einzäunung, Palisade, Pfahlreihe, Pfahlwerk, Planke, Umzäunung, fechten
fennel = Fenchel
ferment = gären
fern = Farn, Farnkraut, Farrenkraut
ferry = Fähre, Prahm
fertile = fruchtbar, ergiebig
fertilize = düngen
fertilizer = Dünger, Mist
fervor = Eifer, Inbrunst
fervour = Eifer, Inbrunst
festival = Feier, Fest
fetch = bringen, anbringen, eintragen, heranbringen, überbringen, holen
fever = Fieber
fewer = weniger
fiancé = Bräutigam
fiancée = Braut
fiasco = Fiasko, Mißerfolg
fiber = Faser, Fiber
fibre = Faser, Fiber
fief = Lehen
field = Feld, Feld, Land, Feld, Land, Acker, Feld, Flur, Land
field hospital = Krankenwagen, Sanitätsauto, Rettungsauto, Sanka, Ambulanzwagen
fifteen = fünfzehn
fifty = fünfzig
fig = Feige
fight = kämpfen
fig-tree = Feigenbaum
figure = Zahl, Zahlzeichen, Ziffer, Abbild, Figur, Gestalt, erachten, kalkulieren, rechnen, berechnen
file = Datei, feilen, Feile, Kette, Reihe, Reihenfolge, Tour
files = Archiv
fill = ausfüllen, erfüllen
fillet = Binde, Verband
fill in = ausfüllen, erfüllen
fill up = ausfüllen, erfüllen
film = Film
filter = durchseihen, filtrieren
filthy = unlauter
fin = Flosse
finally = endlich
find = auffassen, perzipieren, wahrnehmen, finden, befinden, erachten, ermitteln, vorfinden
find oneself = sich aufhalten, sich befinden
find out = erfahren, vernehmen
fine = hübsch, schön, ausgezeichnet, gediegen, trefflich, vortrefflich, vorzüglich, delikat, fein, gelinde, zart, Geldstrafe
finger = Finger
finish = ausarbeiten, beschließen, enden, beenden, endigen, beendigen, erledigen, zurichten
finished = bereit, erbötig, fertig
fir = Fichte, Tanne
fire = abfeuern, abschießen, abdanken, verabschieden, Feuer, entlassen, entladen, feuern, schießen, antreiben, anfeuern
firebox = Herd
fire off = abfeuern, abschießen, entladen
fireplace = Kamin
firing-cap = Kapsel
firm = feststehend, firm, gediegen, stabil, Firma, fest, befestigt, haltbar, wiederstandsfähig, gesetzt, solide
first = erste, erster, erstes, erst, erstens, zuerst
first aid = Erste Hilfe, Unfallhilfe
first instalment = Anzahlung, Angeld
firstly = erst, erstens, zuerst
first name = Vorname
first of all = erst, erstens, zuerst
fish = fischen, Fisch
fishing rod = Angelrute
fission = Kernspaltung
fist = Faust
fit = adaptieren, anpassen, Schlag, Schlagfluß, Anwandlung, taugen
fitness = Brauchbarkeit, Tauglichkeit
fit out = besetzen, einfassen, garnieren, verzieren
fitting = gehörig, gleich, entsprechend, konform
fitting up = Zusammenstellung
fit together = kongruieren
five = fünf
fix = adaptieren, anpassen, anberaumen, determinieren, befestigen, festsetzen, fixieren, reparieren
fixed = fest, fix
fix up = arrangieren, einrichten, ordnen, anorden, veranstalten
fjord = Fjord
flag = Flagge, Banner, Fahne, Standarte
flame = Flamme
flan = Fladen
Flanders = Flandern
flannel = Flanell
flare = flackern
flare up = flackern
flash on = entbrennen, zünden
flask = Feldflasche
flat = Appartement, Etagenwohnung, Gemach, eben, glatt, Kulisse, flach, platt
flat-iron = Bügeleisen
flatter = schmeicheln
flavour = Aroma, Duft
flax = Flachs, Lein, Leinpflanze
flay = abdecken, häuten
flea = Floh
fleet = Flotte
Flemmish = flämisch, flandrisch
flesh = Fleisch
flexible = gefügig, geschmeidig
flight = Flug
fling = schlingen, schwingen
flint = Flint, Kiesel, Kieselstein
flirt = flirten, herumflattern, liebeln, tändeln
flit = flirten, herumflattern, liebeln, tändeln
float = schwimmen
flog = stäupen
flood = Flut, Zufluß, überschütten
floor = Etage, Geschoß, Stock, Stockwerk, Boden, Diele, Dielung, Fußboden
Florence = Florenz
flounder = sich sträuben, zappeln
flour = Mehl
flourish = Fanfare, Tusch
flow = fließen, rinnen, strömen, Strömung
flow down = verfließen
flower = Blume
flowerpot = Blumentopf
flow off = verfließen
flu = Grippe
fluent = flüssig, geläufig
fluff = Daune, Flaum, Flaumfeder
fluid = flüssig, dünnflüssig
fluorine = Fluor
flute = Flöte
flutter = flirten, herumflattern, liebeln, tändeln, Vibration, Vibrieren
fly = fliegen, huschen, Fliege
fly away = abfliegen, fortfliegen
foam = schäumen, Gischt, Schaum
focus = Brennpunkt, Fokus
fog = Nebel
fold = falten, zusammenlegen, Falte
folder = Heft
folk = Volk
follow = befolgen, folgen
followers = Gefolge
following = Anhang, folgend, umgehend, Gefolge, nächst
fondle = streicheln
food = Gericht, Speise, Ätzung, Ernährung, Futter, Nahrung, Nahrungsmittel
fool = Tor, narren, mystifizieren, zum besten halten
foolish = albern, dumm
foot = Bein, Pfote, Bein, Fuß, Pfote
football = Fußball
fop = Dandy, Geck, Gigerl, Stutzer
for = während, anläßlich, halber, um ... willen, wegen, da, denn, weil
for a long time = lange
forbid = untersagen, verbieten
force = anmuten, zwingen, Stärke, Gewalt, Kraft, vergewaltigen, aufdrängen, aufnötigen, dringen, aufdringen
fore- = ur-
forecast = prophezeien, weissagen, prognostizieren, Prognose
forefather = Ahn, Vorfahr, Urahn
forehead = Stirn
foreign = ausländisch, fremd
foreign country = Ausland
foreigner = Ausländer, Fremder, Fremdling
foreseeable = absehbar
forest = Forst, Wald
foretell = prophezeien, weissagen
forever = fortwährend
for ever = fortwährend
for every reason = aus jedem Grunde
foreward = hervor, vorwärts
foreword = Vorrede, Vorwort
for example = zum Beispiel
forge = schmieden
forget = vergessen
forgetful = vergeßlich
forget-me-not = Vergißmeinnicht
forgive = entschuldigen, verzeihen
for instance = zum Beispiel
forks, knives and spoons = Gedeck, Service
form = bilden, formen, gestalten, Form, Gestalt, Formular
form a group = gruppieren
former = vorig, Ex-
formerly = früher, zuvor
formidable = außerordentlich
form of application = Anforderungsformular, Anfrageformular, Antragsformular
formula = Formel
for no reason = aus keinem Grunde, grundlos, um nichts, wegen nichts
for nothing = gratis, umsonst
forsake = entäußern, fortlassen, überlassen, unterlassen
for sake of = anläßlich, halber, um ... willen, wegen
for sale = feil, käuflich, verkäuflich, gangbar
for some reason = aus irgend einem Grunde
for the reason that = da, weil
for the rest = außerdem, übrigens, zudem
for the time being = einstweilig
fortification = Befestigung, Blockhaus, Festung, Fort
fortify = bestärken
for ... together = hinter einander
fortunate = glücklig
fortune = Fügung, Geschick, Los, Schicksal, Verhängnis
forty = vierzig
forum = Forum
fossil = Fossil
found = fundieren, gründen, begründen
foundation = Fundament, Grundlage, Boden, Grund
fountain = Brunnen, Fontäne, Springbrunnen, Born, Quelle
fountain-pen = Füller, Füllfeder
fountain pen = Füller, Füllfeder
four = vier
fourteen = vierzehn
fowl = Geflügel, Henne, Huhn
fox = Fuchs
fraction = Fraktion
fragment = Bruch, Bruchstück, Fragment, Stück
fragrant = aromatisch, wohlriechend
frame = einrahmen, Einfassung, Rahmen
framework = Einfassung, Rahmen
France = Frankreich
Frankfort = Frankfurt
Frankfort upon the Main = Frankfurt am Main
freckle = Sommersprosse
free = frei, geläufig, unentgeltlich, gratis, umsonst
free and easy = zwanglos
freedom = Freiheit
freemason = Freimaurer
freeze = frieren
freezing cold = Frost
French = Französisch, französische Sprache
French language = Französisch, französische Sprache
Frenchman = Franzose
frequent = häufig
frequently = häufig, oft
fresh = frisch, neu, unberührt
fresh water = Süßwasser
Friday = Freitag
friend = Freundin, Freund
friendly = freundlich, freundschaftlich
friendship = Freundschaft
Friesland = Friesland
frieze = Flaus, Flausch, Fries
fright = Angst
frighten = in Schrecken setzen, entsetzen, Entsetzen verbreiten, abschrecken, ängstigen, einschüchtern, verscheuchen
frindge = Frange, Franse
fringe = Grat, Kante, Saum, Rand
Frisian = Flaus, Flausch, Fries, Friese, Friesländer
frivolous = frivol, leichtfertig, eitel, hinfällig
frog = Frosch
frolic = ausgelassen, mutwillig, schalkhaft, schelmisch, übermütig, herumtollen, mutwillig sein, tändeln, übermütig sein
frolicsome = ausgelassen, mutwillig, schalkhaft, schelmisch, übermütig
from = ab, seit, von, aus, aus ... heraus
from there = daher
from where = woher
front = Front, Vorderseite
frontage = Front, Vorderseite
frontier = Grenze, Schranke
frost = Frost
froth = quirlen, schäumen, Gischt, Schaum
fruit = Frucht
fruitful = ergiebig
fruit-tree = Obstbaum
fry = backen, braten
frying-pan = Pfanne
frying pan = Pfanne
ful = -sam
full = voll, satt
full-grown = volljährig, ausgewachsen, erwachsen
full of zeal = eifrig
fully = völlig
fume = Ausdünstung, Dunst
fun = Unterhaltung, Amüsement, Freude, Genuß, Vergnügen, Wohlgefallen
function = Funktion, Tätigkeit, Wirksamkeit, Amt, Anstellung, Dienst
fund = Geldkasten, Kasse
fundamental = gründlich, triftig
funeral = Begräbnis, Beisetzung
fungus = Erdschwamm, Pilz
funnel = Trichter
funny = amüsant, unterhaltend, unterhaltsam, ergötzlich, drollig, komisch, spaßhaft
fur = Balg, Fell, Tierhaut, Pelz
fur coat = Pelz
furious = rasend, stürmisch, toll, wütend
furlough = Urlaub
furnace = Herd, Ofen
furnish = liefern, möblieren
furniture = Hausgerät, Mobilär
fur piece = Pelz
furrow = Falte, Furche, Runzel
further = ferner, fürder, mehr, weiter
furthermore = fort, weiter
fuse = Docht
futile = vergebens, vergeblich
future = Futur, Futurum, Zukunft
fuzzy = nebelig